172.25.28.80,56827,172.30.1.136,7680,10,639,6,411,4,228,1889.14771,3.85669400000006,852.543655265351,472.943925548662
172.25.29.44,60518,172.30.1.136,7680,9,585,6,411,3,174,1079.355361,0.310619000000088,10585.3151288204,4481.37428811375
172.30.1.136,50120,52.229.170.171,443,34,11513,15,1680,19,9833,99.406215,6.69359399999999,2007.88993177656,11752.1319637851
172.30.1.136,50121,13.107.4.52,80,11,1550,4,339,7,1211,99.757642,2.69599699999999,1005.9358374657,3593.47580876389
172.30.1.136,50122,52.230.84.0,443,100,24668,52,13792,48,10876,101.697218,1067.571918,103.352287691029,81.5008324338483
172.30.1.136,50123,52.230.84.0,443,41,9955,23,3829,18,6126,102.221531,1715.608345,17.8548910007779,28.5659603736656
172.30.1.136,50124,23.8.187.10,443,34,10479,15,2289,19,8190,102.451696,9.986164,1833.73715873282,6561.07790739267
172.30.1.136,50125,204.79.197.213,443,58,25260,29,5488,29,19772,102.651879,85.964453,510.722728614349,1840.01636118129
172.30.1.136,50126,74.125.24.188,443,40,7973,21,2167,19,5806,103.97241,279.526115,62.0192499724042,166.166942934831
172.30.1.136,50127,74.125.24.188,443,9,535,5,295,4,240,104.090819,57.905658,40.7559482356629,33.1573816154546
172.30.1.136,50128,172.217.161.5,443,1227,919084,493,69470,734,849614,105.980934,259.445052,2142.1106153915,26197.8864025512
172.30.1.136,50129,172.217.161.5,443,11,666,6,360,5,306,106.202418,12.936166,222.631651449123,189.236903731755
172.30.1.136,50130,104.17.39.113,443,747,409582,376,31512,371,378070,112.462096,284.700303,885.478509659331,10623.6627363196
172.30.1.136,50131,104.17.39.113,443,7,402,4,228,3,174,112.712801,19.512935,93.4764554896533,71.337294978946
172.30.1.136,50132,119.81.119.5,80,11,1667,6,1039,5,628,112.760285,34.528283,240.730186322905,145.503904726453
172.30.1.136,50133,119.81.119.5,80,9,534,5,294,4,240,112.760681,19.463724,120.840184540225,98.6450486042651
172.30.1.136,50134,119.81.119.5,80,7,402,4,228,3,174,112.824707,19.399698,94.022082199424,71.7536943100867
172.30.1.136,50135,104.17.162.9,443,160,76846,75,6092,85,70754,113.048923,269.089082,181.114743258145,2103.51157985667
172.30.1.136,50136,104.17.162.9,443,7,402,4,228,3,174,113.301284,18.882932,96.5951685892848,73.7173655023489
172.30.1.136,50137,104.17.161.9,443,9,534,5,294,4,240,113.564657,18.621475,126.305784047719,103.106762487934
172.30.1.136,50138,104.17.161.9,443,17,5881,9,1091,8,4790,113.816643,18.237452,478.575625586294,2101.17071178584
172.30.1.136,50139,172.217.161.14,443,68,13518,33,3889,35,9629,114.857615,250.420691,124.23893519246,307.61036435284
172.30.1.136,50140,172.217.161.14,443,9,534,5,294,4,240,114.920345,17.263303,136.24275725219,111.218577348726
172.30.1.136,50141,104.17.39.113,80,13,1823,7,1098,6,725,115.382119,52.057891,168.73522594298,111.414425144499
172.30.1.136,50142,104.17.39.113,80,7,402,4,228,3,174,115.632744,16.632487,109.664898580711,83.691633127385
172.30.1.136,50143,172.217.161.14,443,78,18200,38,8064,40,10136,117.293916,248.132072,259.990574696849,326.793708473123
172.30.1.136,50144,172.217.161.14,443,9,534,5,294,4,240,117.544081,14.640713,160.647913800373,131.141154122753
172.30.1.136,50145,23.58.57.98,443,45,17053,26,10171,19,6882,119.666073,245.895928,330.904218958843,223.89960032197
172.30.1.136,50146,23.58.57.98,443,8,456,4,228,4,228,119.916453,36.014609,50.6461141921602,50.6461141921602
172.30.1.136,50147,172.217.167.34,443,18,5466,9,1790,9,3676,120.470621,11.583835,1236.20545354798,2538.71019399016
172.30.1.136,50148,172.217.194.154,443,19,5287,10,1597,9,3690,121.474407,10.579885,1207.57456248343,2790.20046059102
172.30.1.136,50149,172.217.161.3,443,22,7037,11,1333,11,5704,132.055408,13.834874,770.805718938965,3298.33144848301
172.30.1.136,50150,172.217.24.234,443,18,4647,10,1186,8,3461,140.669979,25.023183,379.168389568985,1106.49392605249
172.30.1.136,50151,172.217.24.234,443,11,642,6,348,5,294,140.921164,26.944745,103.322558814344,87.2897479638424
172.30.1.136,50152,172.217.24.234,443,16,4722,9,1285,7,3437,142.13203,23.562446,436.287472022217,1166.94166641273
172.30.1.136,50153,172.217.24.234,443,16,4722,9,1285,7,3437,142.132294,23.561795,436.299526415539,1166.97390839705
172.30.1.136,50154,172.217.24.234,443,11,618,6,336,5,282,142.38379,25.511507,105.364218585754,88.4306834559009
172.30.1.136,50155,172.217.194.189,443,19,5470,11,1417,8,4053,145.89121,19.802408,572.455632668512,1637.37662611537
172.30.1.136,50156,172.217.194.189,443,9,534,5,294,4,240,146.142593,21.297419,110.435917140946,90.1517690946495
172.30.1.136,50157,184.29.24.99,80,33,5347,20,2263,13,3084,147.400034,21.525329,841.055669811133,1146.18457167368
172.30.1.136,50158,52.109.124.21,443,22,11030,11,2598,11,8432,147.403928,1.77509799999999,11708.6493252768,38001.2821827305
172.30.1.136,50159,180.149.59.201,80,21,18315,6,515,15,17800,148.077866,1.097463,3754.11289492218,129753.804911873
172.30.1.136,50160,180.149.59.201,80,21,18305,6,505,15,17800,149.240718,0.195559000000003,20658.7270337849,728168.992477963
172.30.1.136,50161,180.149.59.201,80,44,37941,15,1192,29,36749,149.490378,3.98951,2390.26847908641,73691.2553170691
172.30.1.136,50162,180.149.59.201,80,22,19525,6,505,16,19020,153.609072,0.229761999999994,17583.4124006586,662250.50269411
172.30.1.136,50163,180.149.59.201,80,57,58925,14,1138,43,57787,154.039841,1.44609600000001,6295.57097177499,319685.553379579
172.30.1.136,50164,172.217.161.3,443,14,1535,7,977,7,558,165.695971,18.569379,420.907990514922,240.395761215278
172.30.1.136,50165,172.217.161.3,443,7,402,4,228,3,174,165.948122,18.331485,99.5009405948291,75.9349283486854
172.30.1.136,50166,172.217.161.5,443,43,8785,21,3609,22,5176,184.214318,197.930646,145.869275847258,209.204591794239
172.30.1.136,50167,23.21.249.197,443,29,8160,16,2032,13,6128,184.387617,197.187556,82.4392792819036,248.616094212355
172.30.1.136,50168,23.21.249.197,443,12,688,7,394,5,294,184.593444,196.873824,16.0102543647448,11.9467380285152
172.30.1.136,50169,104.237.191.1,443,57,9567,26,3275,31,6292,196.301901,187.037451,140.078897888744,269.122572676635
172.30.1.136,50170,104.237.191.1,443,3,198,3,198,0,0,196.534676,9.00164000000001,175.967934731893,0
172.30.1.136,50171,52.114.158.52,443,19,7076,10,2383,9,4693,236.093814,1.945063,9801.22494746954,19302.2025507657
172.30.1.136,50172,119.81.21.130,443,130,56122,71,9568,59,46554,263.310394,187.944464,407.269245238317,1981.60665163301
172.30.1.136,50173,172.217.161.2,443,20,5086,10,1340,10,3746,263.999943,61.0581810000001,175.570248317748,490.810559849465
172.30.1.136,50174,161.202.24.162,443,67,16442,34,9502,33,6940,265.309889,116.839626,650.601192441338,475.181254003672
172.30.1.136,50175,172.217.161.3,443,30,9472,15,2444,15,7028,346.748532,19.088676,1024.27219153387,2945.41119562195
172.30.1.136,50176,172.217.161.3,443,2,132,2,132,0,0,347.000317,9.00066900000002,117.324612203826,0
172.30.1.136,50177,172.217.161.3,443,23,3016,12,2054,11,962,347.537306,28.56923,575.164258889722,269.380728847085
172.30.1.136,50184,172.217.161.3,443,177,109761,81,15501,96,94260,353.056413,30.314867,4090.66614080807,24874.923581225
172.30.1.136,50185,172.217.161.5,443,26,5548,14,3192,12,2356,353.057341,13.194093,1935.41155121462,1428.51804970603
172.30.1.136,50186,172.217.161.5,443,111,31302,51,18712,60,12590,353.058017,30.445132,4916.9108545826,3308.24645463846
172.30.1.136,50187,172.217.161.3,443,200,48346,87,15008,113,33338,353.091146,30.235485,3970.96325724558,8820.89372801527
172.30.1.136,50188,172.217.161.3,443,27,7460,14,1861,13,5599,353.356201,16.048058,927.713496548927,2791.11653260475
172.30.1.136,50189,172.217.161.3,443,28,7524,15,1927,13,5597,353.356569,16.047209,960.665496411245,2790.26714240464
172.30.1.136,50190,172.217.161.3,443,26,7335,14,1861,12,5474,353.356892,14.848041,1002.69119677135,2949.34530420546
172.30.1.136,50191,172.217.161.3,443,29,7794,16,2252,13,5542,353.357199,22.09107,815.533154346983,2006.96480523578
172.30.1.136,50192,172.217.161.3,443,30,8104,16,2498,14,5606,353.357507,22.090936,904.624412473967,2030.15390565615
172.30.1.136,50178,172.217.161.4,443,50,15647,24,3179,26,12468,356.574018,25.86517,983.252768104753,3856.30560324947
172.30.1.136,50179,172.217.161.3,443,1,66,1,66,0,0,356.790394,0,0,0
172.30.1.136,50180,172.217.161.4,443,13,774,7,414,6,360,356.824005,19.424106,170.509777901748,148.269372088476
172.30.1.136,50181,172.217.161.3,443,22,2950,11,1988,11,962,356.839986,19.215956,827.645525416482,400.500500729706
172.30.1.136,50182,172.217.161.3,443,1,66,1,66,0,0,356.840064,0,0,0
172.30.1.136,50183,172.217.161.4,443,25,6680,13,1889,12,4791,356.874619,8.61008900000002,1755.15026615869,4451.52192968039
172.30.1.136,50193,119.81.21.130,443,18,1997,11,1222,7,775,356.917607,18.530271,527.569186656794,334.58765929543
172.30.1.136,50194,172.217.161.14,443,25,6811,14,1450,11,5361,357.848765,17.598816,659.13525091688,2436.982124252
172.30.1.136,50195,172.217.161.1,443,1856,1545255,791,47443,1065,1497812,357.869895,523.698568,724.737517326952,22880.5208419054
172.30.1.136,50196,172.217.161.1,443,25,7465,13,1561,12,5904,357.871025,7.93642700000004,1573.50404659426,5951.29269128284
172.30.1.136,50197,52.95.120.67,80,10,580,6,348,4,232,358.034583,20.940934,132.94535955273,88.6302397018203
172.30.1.136,50198,52.95.120.67,80,10,580,6,348,4,232,358.034997,20.818589,133.726642088952,89.1510947259681
172.30.1.136,50199,172.217.161.1,443,14,864,8,492,6,372,358.080285,18.167825,216.646736744767,163.806069246044
172.30.1.136,50200,172.217.161.1,443,14,864,8,492,6,372,358.080541,18.16757,216.649777598215,163.808368427918
172.30.1.136,50201,172.217.161.14,443,14,864,8,492,6,372,358.100301,18.043098,218.144356362749,164.938415786469
172.30.1.136,50202,52.95.120.67,80,18,3670,10,2282,8,1388,358.142245,25.141748,726.122941014284,441.655846681782
172.30.1.136,50203,23.58.57.98,443,22,3127,12,2079,10,1048,358.97587,22.69537,732.836697529055,369.414554598581
172.30.1.136,50204,23.58.57.98,443,17,1026,9,546,8,480,359.227873,48.06239,90.8818724994741,79.8961516478894
172.30.1.136,50205,172.217.161.14,443,14,864,8,492,6,372,359.92938,16.31873,241.195240070765,182.367132736432
172.30.1.136,50206,172.217.161.14,443,68,16015,33,6628,35,9387,360.181404,23.072599,2298.13728397048,3254.76986792862
172.30.1.136,50207,172.217.161.14,443,149,55295,69,13829,80,41466,363.44149,18.674133,5924.34465364468,17764.037559334
172.30.1.136,50208,52.95.120.67,443,21,8148,10,2087,11,6061,368.206086,14.321243,1165.82059252818,3385.73963167862
172.30.1.136,50209,52.95.120.67,443,8,452,4,228,4,224,368.457075,13.7158030000001,132.985287117349,130.652211904764
172.30.1.136,50210,52.84.109.5,443,162,124224,67,5432,95,118792,369.455128,13.916993,3122.51360620789,68286.0155207379
172.30.1.136,50211,52.84.103.186,443,432,325922,189,15489,243,310433,370.268848,190.449373,650.629603280448,13040.0219275072
172.30.1.136,50212,52.84.103.186,443,20,7272,11,1399,9,5873,370.444959,11.129369,1005.62754276545,4221.62298689171
172.30.1.136,50213,52.84.103.186,443,24,8420,13,1531,11,6889,370.497478,11.077071,1105.70745642057,4975.32244760371
172.30.1.136,50214,52.84.103.186,443,24,8420,13,1531,11,6889,370.536008,11.03874,1109.5469229278,4992.59879297818
172.30.1.136,50215,52.84.103.186,443,18,4766,10,1138,8,3628,370.537846,103.960216,87.5719611817659,279.183721588266
172.30.1.136,50216,52.84.103.186,443,9,534,5,294,4,240,370.570885,12.046277,195.247046037543,159.385343704117
172.30.1.136,50217,13.107.4.52,80,15,2768,7,710,8,2058,380.256373,1.31159000000002,4330.62161193658,12552.703207557
172.30.1.136,50218,172.217.161.4,443,18,3666,12,3282,6,384,385.106312,45.563692,576.24829875507,67.4221044247248
172.30.1.136,50219,52.84.103.186,443,18,3666,12,3282,6,384,385.106606,45.548382,576.441990848325,67.4447667537345
172.30.1.136,50220,52.84.103.186,443,29,5147,14,3503,15,1644,385.106825,57.463724,487.681584994387,228.874828926855
172.30.1.136,50221,52.84.103.186,443,1654,1169925,705,59047,949,1110878,385.107043,105.736367,4467.48846591258,84048.8873615262
172.30.1.136,50222,52.84.103.186,443,27,4968,11,3278,16,1690,385.107261,187.423056,139.918751511554,72.1362690831378
172.30.1.136,50223,52.84.103.186,443,18,3666,12,3282,6,384,385.107439,45.55934,576.303344166092,67.4285448384458
172.30.1.136,50224,172.217.161.14,443,86,32134,39,19097,47,13037,385.107726,138.765506,1100.96524996637,751.598887983012
172.30.1.136,50225,172.217.161.14,443,3,198,3,198,0,0,385.334579,9.00248999999997,175.951320134763,0
172.30.1.136,50226,172.217.161.4,443,3,198,3,198,0,0,385.334781,9.00228799999996,175.955268260692,0
172.30.1.136,50227,74.125.68.188,5228,3,198,3,198,0,0,385.590509,9.00142799999998,175.972079096784,0
172.30.1.136,50228,74.125.68.188,5228,3,198,3,198,0,0,385.838386,9.00041399999998,175.991904372399,0
172.30.1.136,50229,172.217.161.14,443,2,132,2,132,0,0,387.361395,3.00610899999998,351.284667322445,0
172.30.1.136,50230,104.237.191.1,443,3,198,3,198,0,0,428.892261,9.000676,175.986781437305,0
172.30.1.136,50231,104.237.191.1,443,3,198,3,198,0,0,428.95403,9.00129100000004,175.974757398688,0
172.30.1.136,50232,52.84.109.5,443,742,461827,315,39739,427,422088,431.611453,177.323453,1792.83673209319,19042.6248918128
172.30.1.136,50233,52.84.108.5,80,14,804,8,456,6,348,431.657555,30.403793,119.985029499444,91.5675225127338
172.30.1.136,50234,54.194.87.27,443,141,54166,66,40593,75,13573,431.675436,260.661772,1245.84436570162,416.570481996109
172.30.1.136,50235,74.125.68.188,443,9,535,5,295,4,240,432.823906,58.698609,40.2053820389509,32.7094633537228
172.30.1.136,50236,74.125.68.188,443,30,3791,17,2587,13,1204,433.074769,318.294196,65.0216066145297,30.2613120849995
172.30.1.136,50237,172.217.161.14,443,49,10981,24,8250,25,2731,433.120893,197.883406,333.529735181534,110.40844930676
172.30.1.136,50238,104.17.161.9,443,17,954,11,618,6,336,433.621602,41.183183,120.049001554834,65.2693600686475
172.30.1.136,50239,104.17.162.9,443,15,5749,8,1025,7,4724,433.62242,17.508249,468.350661451067,2158.52538994619
172.30.1.136,50240,104.17.161.9,443,16,2816,8,1604,8,1212,433.873753,22.329429,574.667628088475,434.22516536361
172.30.1.136,50241,104.17.162.9,443,7,426,4,240,3,186,433.874661,17.934748,107.054752037776,82.9674328292764
172.30.1.136,50242,104.17.38.113,443,59,24727,35,7484,24,17243,435.628228,403.495732,148.383229986681,341.872265454347
172.30.1.136,50243,172.217.161.3,443,25,1446,14,804,11,642,437.228338,44.598411,144.220384892188,115.161053607941
172.30.1.136,50244,172.217.161.3,443,56,11539,22,3340,34,8199,437.432933,43.119834,619.668433788497,1521.15613432092
172.30.1.136,50245,23.58.57.98,443,53,11369,27,6246,26,5123,437.947932,191.966456,260.295475788749,213.495632799514
172.30.1.136,50246,23.58.57.98,443,8,456,5,282,3,174,438.199623,40.8365920000001,55.2445708495948,34.0870756306011
172.30.1.136,50247,52.84.103.186,443,686,494602,287,22116,399,472486,439.734255,192.269039,920.21055974592,19659.3690781385
172.30.1.136,50248,52.94.220.15,443,3,198,3,198,0,0,451.786234,9.00114600000001,175.977592186595,0
172.30.1.136,50249,52.94.220.15,443,3,198,3,198,0,0,451.884068,9.00062600000001,175.987759073646,0
172.30.1.136,50250,172.217.161.14,443,3,198,3,198,0,0,451.916024,8.999933,176.001310231976,0
172.30.1.136,50251,172.217.161.14,443,3,198,3,198,0,0,451.916761,8.99928799999998,176.013924657151,0
172.30.1.136,50252,172.217.161.14,443,3,198,3,198,0,0,452.167346,9.00074699999999,175.985393212364,0
172.30.1.136,50253,172.217.161.14,443,3,198,3,198,0,0,452.217376,9.00115399999999,175.977435782123,0
172.30.1.136,50254,104.17.161.9,443,1,66,1,66,0,0,460.704742,0,0,0
172.30.1.136,50255,104.17.162.9,443,1,66,1,66,0,0,460.705075,0,0,0
172.30.1.136,50256,104.17.161.9,443,1,66,1,66,0,0,460.95694,0,0,0
172.30.1.136,50257,104.17.162.9,443,1,66,1,66,0,0,460.95724,0,0,0
172.30.1.136,50258,104.17.38.113,443,1,66,1,66,0,0,461.651445,0,0,0
172.30.1.136,50259,104.17.38.113,443,1,66,1,66,0,0,461.651963,0,0,0
172.30.1.136,50260,104.17.38.113,443,1,66,1,66,0,0,461.652319,0,0,0
172.30.1.136,50261,104.17.38.113,443,1,66,1,66,0,0,461.652643,0,0,0
172.30.1.136,50262,104.17.38.113,443,229,108660,111,10375,118,98285,461.903362,169.279271,490.314020787578,4644.86877427538
172.30.1.136,50263,172.217.161.5,443,57,9537,29,5992,28,3545,474.257815,159.743078,300.081860198036,177.53507917257
172.30.1.136,50264,172.217.161.5,443,17,1026,9,546,8,480,474.460287,21.750028,200.827327670567,176.551496853246
172.30.1.136,50265,172.217.161.3,443,89,10288,41,5672,48,4616,474.9255,124.784211,363.635748756708,295.934875927532
172.30.1.136,50266,52.94.220.15,443,43,12835,20,2288,23,10547,481.528461,28.662138,638.612513832708,2943.81389134334
172.30.1.136,50267,104.17.161.9,443,11,1688,6,1394,5,294,481.707055,9.40364299999999,1185.92337033637,250.115832768216
172.30.1.136,50268,104.17.162.9,443,15,3062,8,2660,7,402,481.708066,9.73021600000004,2187.00180962066,330.516814837408
172.30.1.136,50269,52.94.220.15,443,31,7838,14,1447,17,6391,481.779512,28.447551,406.924307825303,1797.27246116898
172.30.1.136,50270,104.17.161.9,443,8,492,4,252,4,240,481.958587,9.22285599999998,218.587387681213,208.178464458298
172.30.1.136,50271,104.17.162.9,443,8,492,4,252,4,240,481.96065,9.22079300000002,218.636292995624,208.225040948213
172.30.1.136,50272,52.94.220.15,443,43,12324,20,1771,23,10553,482.407033,28.809999,491.773706760628,2930.37150053355
172.30.1.136,50273,54.194.87.27,443,322,126920,172,111014,150,15906,482.441982,148.838132,5966.9655085432,854.942199892699
172.30.1.136,50274,104.17.37.113,443,20,3044,10,1750,10,1294,482.652201,9.68076200000002,1446.16715089163,1069.33731043073
172.30.1.136,50275,104.17.37.113,443,11,1752,6,1458,5,294,482.652491,8.78578399999998,1327.59922165171,267.705192843349
172.30.1.136,50276,104.17.37.113,443,11,1752,6,1458,5,294,482.652739,8.78554200000002,1327.6357907116,267.71256685131
172.30.1.136,50277,104.17.37.113,443,8,492,4,252,4,240,482.65299,8.54897499999998,235.817744232496,224.588327840473
172.30.1.136,50278,52.94.220.15,443,33,7952,15,1501,18,6451,482.701208,29.036817,413.543950082408,1777.32979479121
172.30.1.136,50279,52.94.220.15,443,35,8069,16,1555,19,6514,483.456289,28.281944,439.85660957394,1842.58903843385
172.30.1.136,50280,52.94.220.15,443,29,7638,13,1393,16,6245,483.806043,27.880335,399.708253146886,1791.94403510575
172.30.1.136,50281,52.84.103.186,443,586,393575,273,23569,313,370006,484.002677,147.055107,1282.18600391757,20128.8351039723
172.30.1.136,50282,52.84.103.186,443,33,9939,17,2288,16,7651,484.003102,23.375075,783.05631104927,2618.51566251659
172.30.1.136,50283,52.84.103.186,443,14,864,8,492,6,372,484.253502,25.599847,153.750918901977,116.250694779543
172.30.1.136,50284,52.84.103.186,443,14,864,8,492,6,372,484.253785,25.599519,153.752888872639,116.252184269556
172.30.1.136,50285,52.84.103.186,443,14,1603,9,1090,5,513,487.362917,20.014759,435.678491057524,205.048684323403
172.30.1.136,50286,52.84.103.186,443,20,1858,10,1144,10,714,487.363181,8.30760099999998,1101.64173748836,687.563112383469
172.30.1.136,50287,52.84.103.186,443,7157,5578208,3240,219196,3917,5359012,487.363398,149.636119,11718.8818563251,286509.007895347
172.30.1.136,50288,52.84.103.186,443,14,1603,9,1090,5,513,487.363606,20.014406,435.686175247969,205.052300827714
172.30.1.136,50289,52.84.103.186,443,14,1603,9,1090,5,513,487.363809,20.014035,435.694251558969,205.056101880506
172.30.1.136,50290,172.217.161.4,443,61,12401,27,3059,34,9342,490.391142,106.525294,229.729476268801,701.579852011486
172.30.1.136,50291,172.217.161.4,443,12,696,6,348,6,348,490.641333,17.587276,158.296259181922,158.296259181922
172.30.1.136,50292,119.81.119.12,443,31,3867,16,2481,15,1386,492.254352,138.911602,142.882233839618,79.8205465948049
172.30.1.136,50293,119.81.119.12,443,9,534,5,294,4,240,492.505294,15.782856,149.02245829272,121.650986361404
172.30.1.136,50294,172.217.161.4,443,11,618,6,336,5,282,496.658428,15.340728,175.219846150717,147.059513733638
172.30.1.136,50295,172.217.161.4,443,62,15697,29,4052,33,11645,496.908867,133.614018,242.609274724453,697.232232025236
172.30.1.136,50296,172.217.161.3,443,184,48199,80,18728,104,29471,499.543267,112.384758,1333.13451633717,2097.86455205963
172.30.1.136,50297,172.217.161.3,443,22,1308,11,654,11,654,499.794602,20.324334,257.425409363968,257.425409363968
172.30.1.136,50298,119.81.119.5,443,44,13668,23,7655,21,6013,508.166133,122.604017,499.494237615396,392.352560520101
172.30.1.136,50299,119.81.119.5,443,11,618,7,390,4,228,508.383629,23.116998,134.965621401187,78.9029786653093
172.30.1.136,50300,52.213.11.166,443,31,12411,15,3178,16,9233,511.959128,8.16175500000003,3115.01631695633,9050.01436578282
172.30.1.136,50301,52.213.11.166,443,9,522,5,282,4,240,511.959463,21.37531,105.542328976749,89.8232587036164
172.30.1.136,50302,52.213.11.166,443,145,37477,71,16505,74,20972,512.054493,119.676995,1103.30310349119,1401.90685770477
172.30.1.136,50303,54.239.35.198,443,44,12970,21,2262,23,10708,512.47578,39.787328,454.818177284989,2153.04732200162
172.30.1.136,50304,54.239.35.198,443,11,641,6,348,5,293,512.682365,18.894651,147.343287790815,124.05627391583
172.30.1.136,50305,172.217.161.14,443,225,78116,96,35893,129,42223,517.922033,98.227366,2923.25867722036,3438.79728995278
172.30.1.136,50306,172.217.161.14,443,11,642,5,294,6,348,518.17244,13.4112369999999,175.37532145618,207.587115193029
172.30.1.136,50307,104.17.162.9,443,19,7093,10,1209,9,5884,552.263568,14.3884780000001,672.20452364732,3271.50654850358
172.30.1.136,50308,104.17.162.9,443,9,522,5,282,4,240,552.514731,16.363456,137.868186280453,117.334626621662
172.30.1.136,50309,104.17.161.9,443,20,7600,10,1662,10,5938,552.593201,14.0585629999999,945.758111977736,3379.00822438255
172.30.1.136,50310,104.17.161.9,443,9,534,5,294,4,240,552.844348,16.163754,145.510752019611,118.784287362948
172.30.1.136,50311,104.244.42.1,443,30,9558,16,2234,14,7324,561.877039,3.245317,5507.01210390233,18054.3225823548
172.30.1.136,50312,104.244.42.1,443,107,60646,48,5750,59,54896,561.877338,68.069338,675.781509730563,6451.774218812
172.30.1.136,50313,117.18.237.29,80,12,1698,7,628,5,1070,563.395569,66.189833,75.9028958420245,129.324997692621
172.30.1.136,50314,157.240.16.39,443,431,281901,186,12630,245,269271,567.130568,85.5897729999999,1180.51487296269,25168.5210100978
172.30.1.136,50315,157.240.16.35,443,25,5813,7,971,18,4842,567.153539,132.213744,58.7533471557995,292.980130719239
172.30.1.136,50316,157.240.16.39,443,13,726,6,336,7,390,567.153824,28.985842,92.7349290043048,107.638756879997
172.30.1.136,50317,157.240.16.35,443,10,564,5,282,5,282,567.404824,28.7352080000001,78.5099589326096,78.5099589326096
172.30.1.136,50318,157.240.16.20,443,39,10967,15,1551,24,9416,567.438847,118.149771,105.019247138448,637.563656386605
172.30.1.136,50319,157.240.16.20,443,35,8934,11,1804,24,7130,567.439653,157.105989,91.8615521398105,363.066999310892
172.30.1.136,50320,104.244.46.103,443,809,633650,349,22983,460,610667,568.128394,257.518436,713.983832986621,18970.8204037089
172.30.1.136,50321,104.244.46.103,443,27,8340,18,3755,9,4585,568.128657,40.971721,733.188630275013,895.251629776548
172.30.1.136,50322,104.244.46.103,443,29,11235,16,2486,13,8749,568.128904,40.661735,489.108494755573,1721.32349984574
172.30.1.136,50323,104.244.46.103,443,16,996,9,558,7,438,568.129129,27.9068239999999,159.960875519193,125.560687235495
172.30.1.136,50324,104.244.46.103,443,29,11235,16,2486,13,8749,568.129355,40.66939,489.016432260233,1720.99950355783
172.30.1.136,50325,104.244.46.103,443,29,11235,16,2486,13,8749,568.373026,36.631015,542.92789866729,1910.73056534196
172.30.1.136,50326,157.240.16.20,443,759,587133,330,26429,429,560704,568.726045,156.030632,1355.06725371721,28748.4062744808
172.30.1.136,50327,157.240.16.20,443,29,9167,15,1667,14,7500,568.978272,27.88558,478.240007918071,2151.64970569018
172.30.1.136,50328,157.240.16.20,443,23,6965,13,2870,10,4095,569.032744,45.247109,507.435734733903,724.024158095935
172.30.1.136,50329,157.240.16.20,443,27,7229,15,3002,12,4227,569.035403,45.2437090000001,530.814129319061,747.418828991229
172.30.1.136,50330,157.240.16.20,443,27,7228,15,3002,12,4226,569.035767,45.2429560000001,530.822963910669,747.254445531808
172.30.1.136,50331,157.240.16.20,443,24,7019,14,2924,10,4095,569.036183,45.242042,517.041206937565,724.105247062014
172.30.1.136,50332,172.217.161.4,443,29,5042,13,1864,16,3178,595.378753,35.7659500000001,416.932864917609,710.843693512962
172.30.1.136,50333,172.217.161.3,443,139,79473,65,8230,74,71243,595.794499,36.455316,1806.04661333891,15634.043605602
172.30.1.136,50334,172.217.161.3,443,34,3562,15,2180,19,1382,596.095865,19.065956,914.719408772368,579.881753634593
172.30.1.136,50335,172.217.161.3,443,31,3252,14,2126,17,1126,596.09653,19.460973,873.954246789204,462.875109070858
172.30.1.136,50336,172.217.161.3,443,28,3090,13,2072,15,1018,596.09712,19.3856979999999,855.063356501275,420.103521678715
172.30.1.136,50337,172.217.161.3,443,31,3252,14,2126,17,1126,596.098743,19.458764,874.05345992171,462.92765563116
172.30.1.136,50338,172.217.161.3,443,28,3102,13,2072,15,1030,596.188353,19.369149,855.793922593089,425.418793567028
172.30.1.136,50339,172.217.161.3,443,62,8715,31,4600,31,4115,597.927188,32.976191,1115.95666097397,998.296013023458
172.30.1.136,50340,104.244.46.103,443,61,36097,30,3244,31,32853,599.659625,30.287302,856.860739857252,8677.69601927568
172.30.1.136,50341,104.244.46.103,443,12,732,7,426,5,306,599.910305,16.331863,208.671845949234,149.891044273394
172.30.1.136,50342,104.121.241.30,443,36,11093,19,1854,17,9239,608.608945,87.438488,169.627818815897,845.302814476847
172.30.1.136,50343,104.113.230.86,443,292,197110,135,10767,157,186343,608.799849,120.812104,712.974918473401,12339.3596389978
172.30.1.136,50344,104.113.230.86,443,14,864,8,492,6,372,608.899053,22.023428,178.71877166443,135.128827356032
172.30.1.136,50345,172.217.161.14,443,70,18144,35,6943,35,11201,614.281533,246.908723,224.957625332662,362.919539298739
172.30.1.136,50346,172.217.161.14,443,9,534,5,294,4,240,614.532702,15.3797500000001,152.928363594986,124.839480485703
172.30.1.136,50347,172.217.161.14,443,18,2105,10,1256,8,849,615.558696,9.40254299999992,1068.64706707537,722.357770658433
172.30.1.136,50348,172.217.161.3,443,10,600,6,360,4,240,618.12603,12.8246809999999,224.566989229597,149.711326153064
172.30.1.136,50349,172.217.161.3,443,16,5540,9,1556,7,3984,618.377668,11.5347810000001,1079.17090060053,2763.12138045792
172.30.1.136,50350,13.107.4.52,80,16,3481,7,568,9,2913,628.013569,2.505943,1813.28944832344,9299.49324465879
172.30.1.136,50351,172.217.161.14,443,145,40239,74,27220,71,13019,632.585698,137.63348,1582.17317472464,756.734480592948
172.30.1.136,50352,172.217.161.4,443,43,5099,21,2970,22,2129,632.587927,194.865995,121.929944729454,87.4036539828306
172.30.1.136,50353,74.125.24.188,5228,38,8663,19,2502,19,6161,632.603402,194.329299,103.000423008782,253.631337392927
172.30.1.136,50354,52.84.103.186,443,338,193391,167,20022,171,173369,639.9231,202.197467,792.176095855839,6859.39354522181
172.30.1.136,50355,52.84.103.186,443,11,1405,7,958,4,447,640.174202,10.76069,712.221985764856,332.320696906984
172.30.1.136,50356,52.84.103.186,443,11,654,6,348,5,306,640.228989,14.694836,189.454308983101,166.589133761003
172.30.1.136,50357,52.84.103.186,443,13,786,7,414,6,372,640.547934,14.3758879999999,230.385768169592,207.013298934996
172.30.1.136,50358,104.244.42.8,443,43,10565,25,4150,18,6415,650.260604,175.373455,189.310292141989,292.632656407436
172.30.1.136,50359,104.244.42.131,443,19,1110,12,696,7,414,650.261094,41.2351660000001,135.030376742026,80.3197930620674
172.30.1.136,50360,104.244.42.8,443,21,1242,13,762,8,480,650.353881,41.11987,148.249495924963,93.3855092440711
172.30.1.136,50361,104.244.42.131,443,53,11189,30,4317,23,6872,650.354229,175.277955,197.035616943386,313.650396023847
172.30.1.136,50362,172.217.161.14,443,32,7043,15,1927,17,5116,650.935375,270.295136,57.0339526938435,151.419668905918
172.30.1.136,50363,172.217.161.14,443,21,1206,12,684,9,522,651.186039,44.005184,124.348985792219,94.8979102098517
172.30.1.136,50364,52.84.108.177,80,42,20117,22,2469,20,17648,652.665916,130.79803,151.011448719832,1079.40463629307
172.30.1.136,50365,52.84.108.177,80,15,858,9,510,6,348,652.723684,37.4961969999999,108.811034889752,74.2475296894777
172.30.1.136,50366,52.94.220.16,443,57,22388,28,6343,29,16045,653.370727,174.568245,290.682878779013,735.299825005401
172.30.1.136,50367,52.94.220.16,443,17,958,10,564,7,394,653.463201,38.966332,115.792269079882,80.8903440026124
172.30.1.136,50368,157.240.16.20,443,298,130015,125,13873,173,116142,655.401034,117.906723,941.28644386122,7880.26311273191
172.30.1.136,50369,157.240.16.20,443,34,10030,19,2476,15,7554,655.401403,39.5149190000001,501.27902324689,1529.34642229685
172.30.1.136,50370,172.217.161.3,443,3,198,3,198,0,0,668.774615,9.00475999999992,175.906964760861,0
172.30.1.136,50371,172.217.161.3,443,3,198,3,198,0,0,668.953861,9.00240800000006,175.952922817983,0
172.30.1.136,50372,157.240.16.20,443,3,198,3,198,0,0,671.387453,8.99944099999993,176.01093223457,0
172.30.1.136,50373,157.240.16.20,443,3,198,3,198,0,0,671.638751,9.00206300000002,175.959666134307,0
172.30.1.136,50374,157.240.16.20,443,3,198,3,198,0,0,671.726736,9.00093100000004,175.981795660915,0
172.30.1.136,50375,172.217.161.3,443,9,534,6,360,3,174,681.223792,19.865545,144.974628181608,70.0710702877772
172.30.1.136,50376,172.217.167.2,443,49,9347,23,2783,26,6564,689.612371,137.541572,161.871059609527,381.790023455599
172.30.1.136,50377,172.217.167.2,443,9,534,5,294,4,240,689.696792,11.392545,206.450797429371,168.53126320765
172.30.1.136,50378,157.240.16.20,443,26,6784,8,2059,18,4725,690.136986,97.478561,168.980746443313,387.777575009545
172.30.1.136,50379,157.240.16.20,443,28,6944,9,2125,19,4819,690.137277,127.667296,133.158612523602,301.972401765288
172.30.1.136,50380,157.240.16.20,443,29,7032,10,2179,19,4853,690.1375,100.886333,172.788518341726,384.829132405873
172.30.1.136,50381,157.240.16.20,443,26,6783,8,2059,18,4724,690.137713,97.790206,168.442226208216,386.45996921205
172.30.1.136,50382,157.240.16.20,443,27,6424,8,1606,19,4818,690.137919,125.206916,102.61413994096,307.842419822879
172.30.1.136,50383,157.240.16.20,443,1082,789710,471,34592,611,755118,690.138127,137.015735,2019.73882780689,44089.4179051771
172.30.1.136,50384,157.240.16.39,443,90,33758,45,16178,45,17580,695.496038,103.906254,1245.58431295194,1353.52776744314
172.30.1.136,50385,157.240.16.39,443,15,834,3,174,12,660,695.625521,133.295849,10.4429358486625,39.6111359776852
172.30.1.136,50386,172.217.161.3,443,20,5080,14,4696,6,384,700.937975,38.5955929999999,973.375379930038,79.594579619492
172.30.1.136,50388,172.217.161.3,443,49,6322,28,3985,21,2337,722.806,45.820473,695.758858709294,408.027215258123
172.30.1.136,50389,172.217.161.3,443,3,198,3,198,0,0,734.367054,9.00045399999999,175.991122225612,0
172.30.1.136,50390,172.217.161.3,443,3,198,3,198,0,0,734.617696,9.00269600000001,175.947294010594,0
172.30.1.136,50391,157.240.16.20,443,3,198,3,198,0,0,743.403371,9.00196100000005,175.961659909434,0
172.30.1.136,50392,172.217.161.14,443,3,198,3,198,0,0,753.967332,8.99937799999998,176.012164396251,0
172.30.1.136,50393,172.217.161.14,443,3,198,3,198,0,0,754.219577,9.000541,175.989421080355,0
172.30.1.136,50394,172.217.161.3,443,77,20545,38,6774,39,13771,755.673527,70.142303,772.600808388057,1570.63562626394
172.30.1.136,50395,172.217.161.3,443,13,798,8,492,5,306,755.924174,22.431575,175.466947817976,109.131882179473
172.30.1.136,50396,172.217.161.3,443,47,6640,26,3742,21,2898,759.962347,49.811688,600.983447900822,465.432932126291
172.30.1.136,50397,74.125.128.94,443,19,5631,11,1252,8,4379,769.159088,14.266898,702.044691144496,2455.47420329213
172.30.1.136,50398,74.125.128.94,443,9,534,5,294,4,240,769.409808,14.692324,160.083591949102,130.680483223757
172.30.1.136,50399,157.240.16.20,443,2142,1642903,964,60427,1178,1582476,777.136579,52.370579,9230.67892757114,241735.116199498
172.30.1.136,50400,157.240.16.20,443,24,5681,8,1025,16,4656,777.387296,118.303544,69.3132236173753,314.851091865853
172.30.1.136,50401,157.240.16.39,443,428,209592,187,36990,241,172602,777.691169,122.906734,2407.67930583852,11234.6651404796
172.30.1.136,50402,157.240.16.20,443,26,5801,10,1145,16,4656,778.07688,119.016721,76.9639755072734,312.964427914293
172.30.1.136,50403,157.240.16.16,443,40,8669,19,2792,21,5877,783.495566,68.051069,328.224087119043,690.892893982312
172.30.1.136,50404,157.240.16.16,443,10,564,7,390,3,174,783.676742,31.660988,98.543987319663,43.9657789580035
172.30.1.136,50405,172.217.161.14,443,2,132,2,132,0,0,795.950231,3.00031799999999,351.962691954654,0
172.30.1.136,50406,172.217.161.14,443,2,132,2,132,0,0,796.201163,3.00023300000009,351.972663456461,0
172.30.1.136,50407,172.217.161.3,443,29,3601,15,2128,14,1473,808.954806,18.5338260000001,918.536733861639,635.810436549903
172.30.1.136,50408,52.84.103.186,443,540,341454,248,18169,292,323285,821.365107,188.187392,772.379055021922,13743.1098465938
172.30.1.136,50409,13.107.4.52,80,15,2626,7,568,8,2058,822.699992,2.77818400000001,1635.60080973758,5926.17335640834
172.30.1.136,50410,74.125.24.188,5228,26,3341,15,2147,11,1194,827.097032,36.3005429999999,473.160966214749,263.136559692785
172.30.1.136,50411,52.84.103.186,443,175,122930,77,5654,98,117276,827.09735,192.612732,234.83390495702,4870.95525959312
172.30.1.136,50412,52.84.103.186,443,95,38674,47,4202,48,34472,827.097614,192.608486,174.530212547333,1431.79568941734
172.30.1.136,50413,172.217.161.4,443,7,402,4,228,3,174,827.299063,4.10456399999998,444.383374214657,339.134680321712
172.30.1.136,50414,74.125.24.188,5228,17,942,9,498,8,444,827.347419,27.577042,144.467996241221,128.802791829523
172.30.1.136,50415,172.217.161.4,443,35,6017,16,2637,19,3380,827.347993,4.054258,5203.4182333734,6669.53114478654
172.30.1.136,50416,52.84.103.186,443,17,2054,10,1157,7,897,827.397663,2.700827,3427.09844058875,2656.96395955757
172.30.1.136,50417,52.84.103.186,443,14,1798,7,970,7,828,827.398281,1.940609,3998.74472395007,3413.36147570171
172.30.1.136,50418,172.217.161.14,443,32,4483,16,2631,16,1852,827.491908,3.96638500000006,5306.59530025443,3735.39129459187
172.30.1.136,50419,172.217.161.14,443,7,402,4,228,3,174,827.599789,3.80187699999999,479.763022317662,366.134938084531
172.30.1.136,50420,172.217.161.4,443,3,198,3,198,0,0,833.104053,9.00144699999998,175.971707659891,0
172.30.1.136,50421,74.125.24.188,5228,3,198,3,198,0,0,833.104392,8.99983100000009,176.003304950947,0
172.30.1.136,50422,52.84.103.186,443,3,198,3,198,0,0,833.10469,8.99953300000004,176.009132918341,0
172.30.1.136,50423,74.125.24.188,5228,3,198,3,198,0,0,833.354728,9.00183400000003,175.964142418089,0
172.30.1.136,50424,172.217.161.4,443,3,198,3,198,0,0,833.355197,9.00136400000008,175.973330264167,0
172.30.1.136,50425,52.84.103.186,443,3,198,3,198,0,0,833.404685,9.00097300000004,175.980974501311,0
172.30.1.136,50426,52.84.103.186,443,3,198,3,198,0,0,833.405289,9.00012299999992,175.997594699541,0
172.30.1.136,50427,52.84.103.186,443,3,198,3,198,0,0,833.405814,8.99975800000004,176.004732571697,0
172.30.1.136,50428,157.240.16.16,443,3,198,3,198,0,0,834.846671,9.00073899999995,175.985549630981,0
172.30.1.136,50429,172.217.161.3,443,3,198,3,198,0,0,834.994234,9.00132099999996,175.974170902249,0
172.30.1.136,50430,172.217.161.3,443,2,132,2,132,0,0,835.244047,3.00008600000001,351.98990962259,0
172.30.1.136,50434,52.84.103.186,443,153,81191,78,6647,75,74544,853.820486,173.141086,307.125253909982,3444.31246087945
172.30.1.136,50435,52.84.103.186,443,157,101965,72,10292,85,91673,854.087659,187.568356,438.96530180176,3909.95589895771
172.30.1.136,50436,54.72.236.219,443,152,61959,82,49736,70,12223,854.093916,349.941452,1137.01305668698,279.429600126366
172.30.1.136,50437,157.240.16.20,443,351,223192,171,12775,180,210417,854.429835,100.325652,1018.68263961046,16778.7197635157
172.30.1.136,50438,157.240.16.17,443,644,444359,281,37387,363,406972,855.256114,99.653636,3001.3556153636,32670.9203064101
172.30.1.136,50439,157.240.16.17,443,24,5758,6,917,18,4841,855.372517,122.944624,59.6691401488202,315.003606827087
172.30.1.136,50440,104.113.230.86,443,8,468,4,228,4,240,855.378659,24.607742,74.1230138059802,78.0242250589265
172.30.1.136,50441,157.240.16.17,443,24,5758,6,917,18,4841,855.425633,141.544891,51.8280804638862,273.609310278815
172.30.1.136,50442,157.240.16.17,443,15,4922,7,971,8,3951,855.430625,0.214838999999984,36157.3084961324,147124.12550795
172.30.1.136,50443,157.240.16.17,443,27,6482,7,983,20,5499,855.434705,157.914537,49.7990884778391,278.581065655786
172.30.1.136,50444,104.113.230.86,443,60,6379,26,3450,34,2929,855.435133,99.260167,278.057158618321,236.066497853061
172.30.1.136,50445,157.240.16.17,443,27,6482,7,983,20,5499,855.435521,155.837779,50.4627315049196,282.293550911041
172.30.1.136,50446,172.217.161.3,443,45,5949,21,3374,24,2575,855.998501,282.592602,95.515593150595,72.896458910131
172.30.1.136,50447,157.240.16.16,443,45,14688,24,7555,21,7133,856.740754,106.85383,565.632509382209,534.037946978597
172.30.1.136,50431,52.84.103.186,443,25,3146,14,1640,11,1506,856.954681,37.6795249999999,348.199718547408,319.749253739266
172.30.1.136,50448,157.240.16.39,443,3,198,3,198,0,0,857.214471,9.00050799999997,175.990066338478,0
172.30.1.136,50449,172.217.161.14,443,3,198,3,198,0,0,857.228583,9.00239099999999,175.953255085233,0
172.30.1.136,50432,52.84.103.186,443,1,66,1,66,0,0,857.229911,0,0,0
172.30.1.136,50433,52.84.103.186,443,1,66,1,66,0,0,857.260505,0,0,0
172.30.1.136,50450,157.240.16.20,443,3,198,3,198,0,0,857.311632,9.00730099999998,175.857340617351,0
172.30.1.136,50451,157.240.16.20,443,3,198,3,198,0,0,857.412631,9.00922900000001,175.819706658583,0
172.30.1.136,50452,172.217.161.14,443,3,198,3,198,0,0,857.446656,9.00228000000004,175.955424625761,0
172.30.1.136,50453,157.240.16.20,443,3,198,3,198,0,0,857.463514,9.00541999999996,175.894072680675,0
172.30.1.136,50454,157.240.16.20,443,3,198,3,198,0,0,857.463983,9.00486000000001,175.905011293901,0
172.30.1.136,50455,157.240.16.20,443,3,198,3,198,0,0,857.487726,9.00210200000004,175.958903820463,0
172.30.1.136,50456,157.240.16.20,443,3,198,3,198,0,0,857.488028,9.00186800000006,175.963477802606,0
172.30.1.136,50457,157.240.16.39,443,3,198,3,198,0,0,857.557753,9.002072,175.959490215142,0
172.30.1.136,50458,157.240.16.39,443,2,132,2,132,0,0,857.946677,3.00063299999999,351.925743668087,0
172.30.1.136,50459,157.240.16.39,443,2,132,2,132,0,0,857.976207,3.00107099999991,351.874380846048,0
172.30.1.136,50460,157.240.16.39,443,2,132,2,132,0,0,857.994475,3.00082000000009,351.903812957781,0
172.30.1.136,50463,52.94.220.15,443,41,9451,17,2130,24,7321,877.138729,116.75732,145.94374040103,501.621654214057
172.30.1.136,50464,52.94.220.15,443,14,832,2,120,12,712,877.266049,116.559481,8.23613825116466,48.867753623577
172.30.1.136,50465,52.84.103.186,443,1984,1588863,751,47633,1233,1541230,878.133462,181.312759,2101.69434352935,68003.156909658
172.30.1.136,50466,157.240.16.39,443,75,37590,44,30434,31,7156,878.216134,162.20876,1500.97935524567,352.927918319578
172.30.1.136,50467,157.240.16.20,443,48,7259,22,2427,26,4832,878.319867,76.507762,253.778172206893,505.255924228969
172.30.1.136,50468,157.240.16.20,443,26,6352,7,983,19,5369,878.423307,140.433549,55.9980151181681,305.852841474511
172.30.1.136,50469,157.240.16.16,443,35,8256,21,5500,14,2756,880.150198,43.7389489999999,1005.9683875806,504.081613849479
172.30.1.136,50470,74.125.24.188,443,21,4862,14,4424,7,438,881.086318,73.032187,484.608245402811,47.9788452727015
172.30.1.136,50471,74.125.24.188,443,2,132,2,132,0,0,881.33673,2.99965499999996,352.04048465574,0
172.30.1.136,50461,157.240.16.16,443,1,66,1,66,0,0,881.834757,0,0,0
172.30.1.136,50462,157.240.16.16,443,1,66,1,66,0,0,882.084895,0,0,0
172.30.1.136,50472,157.240.16.20,443,25,6687,11,1223,14,5464,899.668083,67.0213729999999,145.983282079286,652.209855503856
172.30.1.136,50473,157.240.16.20,443,152,55626,71,5821,81,49805,899.967729,54.859916,848.85292204968,7262.8620138609
172.30.1.136,50474,157.240.16.20,443,25,6688,11,1223,14,5465,899.967814,66.721635,146.639092402337,655.259721977736
172.30.1.136,50475,172.217.161.3,443,32,8604,21,6878,11,1726,900.918202,21.7815440000001,2526.17537122253,633.93118504363
172.30.1.136,50476,157.240.16.16,443,1,66,1,66,0,0,902.27894,0,0,0
172.30.1.136,50477,157.240.16.39,443,95,59888,54,56623,41,3265,912.873018,54.986216,8238.13735427802,475.028141598251
172.30.1.136,50478,157.240.16.39,443,24,6015,13,1355,11,4660,913.174338,40.96183,264.636614135648,910.115588097505
172.30.1.136,50479,157.240.16.16,443,181,16262,89,9200,92,7062,920.454985,686.862886,107.153846131672,82.2522240632463
172.30.1.136,50480,172.217.161.3,443,67,24267,27,14050,40,10217,922.694567,162.290403,692.585623809191,503.640378537972
172.30.1.136,50481,172.217.161.3,443,43,5862,18,3372,25,2490,922.694841,32.00044,842.988408909377,622.491440742689
172.30.1.136,50482,172.217.161.3,443,32,1752,15,822,17,930,922.696666,31.998659,205.508612095276,232.509743611443
172.30.1.136,50483,172.217.161.3,443,53,10276,24,7566,29,2710,922.709577,31.7403860000001,1906.97113765409,683.041472778559
172.30.1.136,50484,172.217.161.3,443,87,23388,47,18875,40,4513,945.413177,95.924539,1574.15403372436,376.37918697738
172.30.1.136,50485,172.217.161.3,443,19,1938,11,1233,8,705,945.714787,9.42225399999995,1046.88326169089,598.582886854889
172.30.1.136,50486,172.217.161.3,443,18,1884,10,1179,8,705,945.715042,9.42206999999996,1001.05390853603,598.594576351059
172.30.1.136,50487,172.217.161.3,443,18,2089,11,1434,7,655,948.981846,16.382876,700.243351655716,319.846161321126
172.30.1.136,50488,172.217.161.3,443,52,6126,28,3788,24,2338,949.233162,77.9643639999999,388.690402194521,239.904477384052
172.30.1.136,50489,172.217.161.3,443,14,864,8,492,6,372,950.226853,15.278915,257.609915363755,194.778228689668
172.30.1.136,50490,157.240.16.17,443,335,245398,146,11825,189,233573,955.13786,71.8511980000001,1316.60991929459,26006.3026367354
172.30.1.136,50491,157.240.16.17,443,14,4868,7,971,7,3897,955.15531,0.266218999999978,29178.9842197613,117106.592692492
172.30.1.136,50492,157.240.16.17,443,15,4922,8,1025,7,3897,955.158479,10.4585089999999,784.050575469223,2980.92204156445
172.30.1.136,50493,172.217.161.14,443,61,21389,31,12603,30,8786,958.915254,282.947237,356.334986936098,248.41380585738
172.30.1.136,50494,172.217.161.14,443,24,1392,14,804,10,588,959.165884,43.810704,146.813436278038,107.37102056155
172.30.1.136,50495,74.125.68.188,5228,21,2481,11,1475,10,1006,963.940426,65.4587110000001,180.266305580016,122.947731127794
172.30.1.136,50496,74.125.68.188,5228,18,1021,10,565,8,456,964.125238,62.5642200000001,72.2457660304882,58.308087274164
172.30.1.136,50497,157.240.16.39,443,27,6359,9,1596,18,4763,964.301583,146.434926,87.1923136697594,260.21114662222
172.30.1.136,50498,157.240.16.39,443,27,6360,9,1596,18,4764,964.302224,145.167383,87.9536417626266,262.538314133554
172.30.1.136,50499,157.240.16.39,443,140,69704,80,48659,60,21045,964.302568,90.222232,4314.59066541382,1866.05891106751
172.30.1.136,50500,172.217.163.133,443,36,7048,17,3829,19,3219,964.335289,62.7700329999999,488.003566925002,410.259462504983
172.30.1.136,50501,172.217.163.133,443,18,1020,11,618,7,402,964.454146,26.1465119999999,189.088318931413,122.999197751502
172.30.1.136,50502,157.240.16.20,443,16,2421,7,1488,9,933,965.483902,0.772283000000016,15414.0386360955,9664.85083835828
172.30.1.136,50503,157.240.16.20,443,138,86211,69,5323,69,80888,965.615586,61.8516370000001,688.486223897355,10462.1968210801
172.30.1.136,50504,157.240.16.20,443,23,1266,12,660,11,606,965.667442,54.0384049999999,97.7082872819805,89.7139728680003
172.30.1.136,50505,104.113.230.86,443,54,11297,26,4897,28,6400,965.940624,60.71987,645.192422184039,843.216561563784
172.30.1.136,50506,104.113.230.86,443,22,2805,9,1595,13,1210,966.118276,33.258824,383.657582120161,291.050579539433
172.30.1.136,50507,104.113.230.86,443,22,2805,9,1595,13,1210,966.12537,33.3309410000001,382.827475527918,290.420843503938
172.30.1.136,50508,104.113.230.86,443,13,762,9,510,4,252,966.230473,35.9316550000001,113.548902771108,56.1065166633709
172.30.1.136,50509,54.239.32.228,443,23,9463,11,2351,12,7112,968.214751,59.176669,317.82796020506,961.459997013351
172.30.1.136,50510,172.217.161.14,443,87,30486,45,22401,42,8085,989.579016,37.417006,4789.47994930433,1728.62574840969
172.30.1.136,50511,52.84.103.186,443,308,215379,130,11134,178,204245,990.319633,141.026084,631.599470634099,11586.2254247945
172.30.1.136,50512,52.84.103.186,443,28,2962,13,1393,15,1569,990.571249,198.926351,56.0207330199306,63.0987294388163
172.30.1.136,50513,52.84.103.186,443,11,654,6,348,5,306,990.621156,36.353772,76.5807740665809,67.3382668516488
172.30.1.136,50514,52.84.103.186,443,26,3110,13,1898,13,1212,992.592837,24.185481,627.814679393807,400.901681467489
172.30.1.136,50515,157.240.16.39,443,83,27364,39,22370,44,4994,999.128117,94.25044,1898.7709765599,423.891920292361
172.30.1.136,50517,54.229.103.82,443,34,11136,18,4136,16,7000,1023.675131,3.65286300000002,9058.10045435588,15330.4408076623
172.30.1.136,50518,13.107.4.52,80,11,1573,6,490,5,1083,1024.333006,0.171719999999823,22827.8593058703,50454.2278127704
172.30.1.136,50519,104.237.191.1,443,1,66,1,66,0,0,1025.76296,0,0,0
172.30.1.136,50520,104.237.191.1,443,1,66,1,66,0,0,1025.766775,0,0,0
172.30.1.136,50521,74.125.68.188,5228,21,2398,11,1392,10,1006,1029.604084,99.9396549999999,111.427240768442,80.5285949806411
172.30.1.136,50522,172.217.161.4,443,31,4285,15,2550,16,1735,1029.62024,98.4931550000001,207.120992316674,140.923498693894
172.30.1.136,50523,157.240.16.39,443,81,25749,39,15640,42,10109,1031.085885,97.029763,1289.50124303612,833.476219044253
172.30.1.136,50524,172.217.161.14,443,20,1188,11,654,9,534,1039.250943,31.0464709999999,168.521568844331,137.600180065555
172.30.1.136,50525,172.217.161.14,443,37,6145,19,3849,18,2296,1039.501856,88.6116509999999,347.493807558106,207.286511341494
172.30.1.136,50526,54.229.103.82,443,39,5743,21,3820,18,1923,1040.909813,87.5114980000001,349.211254502808,175.794042515419
172.30.1.136,50527,54.229.103.82,443,10,600,6,360,4,240,1041.160023,29.9519220000002,96.1540965551386,64.1027310367591
172.30.1.136,50528,52.84.103.186,443,73,37747,32,3512,41,34235,1047.917454,188.356814,149.163703735188,1454.04880335256
172.30.1.136,50529,52.84.103.186,443,113,61144,53,4852,60,56292,1069.816333,58.3996990000001,664.660959982002,7711.27262145648
172.30.1.136,50530,157.240.16.16,443,40,8539,19,3089,21,5450,1086.731111,65.895687,375.016956724345,661.651801277981
172.30.1.136,50531,13.107.4.52,80,10,1519,5,436,5,1083,1124.330271,0.207067000000052,16844.7893676884,41841.5295532259
172.30.1.136,50532,74.125.200.188,5228,29,2882,15,1612,14,1270,1130.695933,274.626774,46.9582765444421,36.9956645232267
172.30.1.136,50533,74.125.200.188,5228,7,403,4,229,3,174,1130.846327,55.4634940000001,33.0307354960363,25.0975894162023
172.30.1.136,50534,176.34.146.169,443,77,16401,42,7152,35,9249,1135.927602,267.922072,213.554633901159,276.169855837782
172.30.1.136,50535,157.240.16.16,443,61,7739,28,4274,33,3465,1137.820686,316.438417,108.052619919408,87.5999831588084
172.30.1.136,50536,157.240.16.39,443,94,18162,47,10909,47,7253,1151.101027,252.234959,345.99486267088,230.039484732963
172.30.1.136,50537,52.230.84.217,443,39,11654,23,5767,16,5887,1172.17771,620.276006,74.379791502043,75.9274896085534
172.30.1.136,50538,172.217.160.238,443,31,11237,16,1970,15,9267,1247.168886,78.0184100000001,202.003604021153,950.237258103567
172.30.1.136,50539,172.217.160.238,443,30,11183,15,1916,15,9267,1247.174,78.0137609999999,196.478157231774,950.293884690421
172.30.1.136,50540,172.217.161.14,443,17,5681,8,1219,9,4462,1325.188735,14.767077,660.387969806077,2417.26917249772
172.30.1.136,50541,172.217.161.14,443,9,534,5,294,4,240,1325.439232,11.6554740000001,201.793595009518,164.729465313893
172.30.1.136,50542,172.217.161.14,443,42,8254,20,4957,22,3297,1336.121244,67.523003,587.296154467537,390.622437215951
172.30.1.136,50543,172.217.161.14,443,27,3400,13,1881,14,1519,1339.942229,63.4675150000001,237.0976711472,191.468028959382
172.30.1.136,50544,13.107.4.52,80,10,1519,5,436,5,1083,1399.877994,0.05619999999999,62064.056939513,154163.701067644
172.30.1.136,50545,172.217.194.188,5228,23,2519,12,1447,11,1072,1406.116222,167.471728,69.122114748825,51.2086434075607
172.30.1.136,50546,157.240.16.16,443,54,9118,25,3946,29,5172,1439.438027,134.238946,235.162752246281,308.226496355238
172.30.1.136,50547,157.240.16.39,443,89,32280,46,11800,43,20480,1451.051513,120.374353,784.220206774445,1361.08727413056
172.30.1.136,50548,157.240.16.20,443,65,12238,29,2798,36,9440,1461.545501,82.5766779999999,271.069272125479,914.543934547719
172.30.1.136,50549,157.240.16.20,443,15,4922,8,1025,7,3897,1461.545757,10.1656009999999,806.641928991711,3066.8132656397
172.30.1.136,50550,157.240.16.20,443,15,4923,8,1025,7,3898,1461.545984,10.1656149999999,806.640818091192,3067.59600870192
172.30.1.136,50551,157.240.16.20,443,92,36392,43,5818,49,30574,1462.152997,82.0298420000001,567.403262827203,2981.74413160517
172.30.1.136,50552,104.113.230.86,443,34,5247,17,2847,17,2400,1471.781028,72.945119,312.234736363923,263.211579653465
172.30.1.136,50553,54.229.103.82,443,42,12072,23,4822,19,7250,1471.792099,100.268116,384.72848138485,578.449085450055
172.30.1.136,50554,54.229.103.82,443,38,16089,21,2743,17,13346,1471.96342,28.0423049999999,782.531963759757,3807.39029833675
172.30.1.136,50555,54.229.103.82,443,10,564,5,282,5,282,1472.037436,28.2126189999999,79.9642174305054,79.9642174305054
172.30.1.136,50556,184.29.24.13,443,119,62221,55,8117,64,54104,1472.19151,98.950396,656.248005313693,4374.23211525096
172.30.1.136,50557,184.29.24.13,443,12,708,5,294,7,414,1472.258335,27.7473970000001,84.764707839081,119.3625477734
172.30.1.136,50558,184.29.24.13,443,31,11537,13,1429,18,10108,1472.293131,17.3857150000001,657.551328777673,4651.17482945047
172.30.1.136,50559,184.29.24.13,443,13,762,6,348,7,414,1472.510086,27.495647,101.252390969378,120.455430635984
172.30.1.136,50560,52.84.103.186,443,14,864,7,426,7,438,1473.437828,26.20408,130.056082869538,133.719634499666
172.30.1.136,50561,52.84.103.186,443,56,24653,29,5604,27,19049,1473.554723,100.162752,447.591535823617,1521.44381975447
172.30.1.136,50562,184.29.24.13,443,3,198,3,198,0,0,1474.243862,9.00082900000007,175.98378993757,0
172.30.1.136,50563,184.29.24.13,443,3,198,3,198,0,0,1474.495342,9.00116400000002,175.977240276924,0
172.30.1.136,50564,184.29.24.13,443,3,198,3,198,0,0,1474.546257,9.00116900000012,175.977142524485,0
172.30.1.136,50565,184.29.24.13,443,31,8986,17,1653,14,7333,1495.263217,62.0364730000001,213.164923157382,945.637254393877
172.30.1.136,50566,184.29.24.13,443,1233,926665,569,41868,664,884797,1495.507454,196.2776,1706.48102483422,36063.0861596025
172.30.1.136,50567,184.29.24.13,443,20,1152,8,468,12,684,1495.55472,48.4392049999999,77.2927631657045,112.96634616526
172.30.1.136,50568,172.217.161.14,443,36,8988,16,2909,20,6079,1561.183314,10.3191809999998,2255.21773481833,4712.77710895862
172.30.1.136,50569,157.240.16.16,443,35,6076,17,4306,18,1770,1561.644431,105.102341,327.756733791496,134.72582879957
172.30.1.136,50570,122.15.34.32,80,14,1278,7,629,7,649,1563.170034,98.6402150000001,51.0136763185278,52.6357327992441
172.30.1.136,50571,122.15.34.32,80,15,1332,8,683,7,649,1563.17006,98.515609,55.4632921164807,52.7023083215168
172.30.1.136,50572,13.107.4.52,80,10,1519,5,436,5,1083,1568.148659,0.325230000000147,10724.7178919485,26639.6088921566
172.30.1.136,50573,172.217.194.188,5228,41,7736,25,6334,16,1402,1574.090819,223.116366,227.110188770285,50.2697323422702
172.30.1.136,50574,52.84.103.186,443,38,19010,23,6324,15,12686,1574.142624,33.6858099999999,1501.87868422936,3012.78193993258
172.30.1.136,50575,157.240.16.39,443,19,4765,14,4435,5,330,1574.152023,19.2437639999998,1843.71415072438,137.187298701025
172.30.1.136,50576,172.217.161.14,443,23,2800,13,1918,10,882,1585.856619,24.5046960000002,626.16569493455,287.944808619537
172.30.1.136,50577,172.217.161.14,443,21,1206,11,630,10,576,1586.107953,28.5560849999999,176.494782110363,161.366657929475
172.30.1.136,50578,172.217.161.4,443,37,4633,19,2791,18,1842,1586.161444,209.717124,106.467223916346,70.2660789874269
172.30.1.136,50579,172.217.161.4,443,16,936,9,534,7,402,1586.412792,25.7056909999999,166.188880119971,125.108482786944
172.30.1.136,50580,157.240.16.39,443,13,726,6,336,7,390,1593.396623,23.5777949999999,114.005571767844,132.327895801962
172.30.1.136,50581,52.84.103.186,443,4233,3219217,1955,138198,2278,3081019,1593.399657,202.446545,5461.11567376959,121751.408501439
172.30.1.136,50582,157.240.16.39,443,14,4632,7,720,7,3912,1593.64835,0.840456000000131,6853.42242782383,37236.9285245095
172.30.1.136,50583,172.217.161.3,443,51,8212,25,3077,26,5135,1593.913516,201.572256,122.119980638605,203.797887741059
172.30.1.136,50584,172.217.161.3,443,12,698,7,404,5,294,1593.94289,110.007765,29.3797442389635,21.3803089263744
172.30.1.136,50585,13.107.21.200,443,44,15476,23,3866,21,11610,1594.869797,131.771451,234.709413649851,704.856775084006
172.30.1.136,50586,104.113.230.86,443,508,357294,226,20456,282,336838,1595.136635,200.088695,817.877291867989,13467.5474793816
172.30.1.136,50587,104.113.230.86,443,23,2343,9,1090,14,1253,1595.388157,15.5878769999999,559.409084380127,643.063837365412
172.30.1.136,50588,104.113.230.86,443,18,1032,8,456,10,576,1595.629839,22.733962,160.464770724962,202.692341968373
172.30.1.136,50589,52.30.87.88,443,60,24674,31,16559,29,8115,1597.006889,153.9386,860.550894967215,421.726584495377
172.30.1.136,50590,52.30.87.88,443,20,7493,11,1285,9,6208,1597.243964,13.817873,743.963995037444,3594.18558847661
172.30.1.136,50591,52.30.87.88,443,15,846,8,444,7,402,1597.415033,55.6070480000001,63.8767948983732,57.8343953809595
172.30.1.136,50592,54.239.32.228,443,36,14850,18,3334,18,11516,1597.724748,202.76692,131.54019403165,454.354191502244
172.30.1.136,50593,54.239.32.228,443,18,992,8,444,10,548,1597.872069,55.188764,64.3609268002451,79.4364592039061
172.30.1.136,50594,157.240.16.39,443,1134,656528,537,136149,597,520379,1598.740589,197.015154,5528.46812991858,21130.5166911171
172.30.1.136,50595,157.240.16.39,443,17,5054,9,1091,8,3963,1598.991484,14.0434970000001,621.497622707501,2257.55735911075
172.30.1.136,50596,157.240.16.20,443,335,206218,150,20506,185,185712,1600.386276,91.39654,1794.90383333986,16255.4950110803
172.30.1.136,50597,157.240.16.20,443,13,1742,7,971,6,771,1600.395188,17.9972440000001,431.621641624681,342.719140775107
172.30.1.136,50598,157.240.16.20,443,15,834,8,444,7,390,1600.637505,52.3315460000001,67.8749295883594,59.6198705843698
172.30.1.136,50599,157.240.16.20,443,17,942,9,498,8,444,1600.646407,52.32257,76.1430487837275,67.8865736144077
172.30.1.136,50600,157.240.16.39,443,17,942,9,498,8,444,1600.932189,52.0370229999999,76.560874744891,68.2590931460474
172.30.1.136,50601,157.240.16.35,443,48,9218,28,2923,20,6295,1604.491965,211.69812,110.459176491506,237.885910370862
172.30.1.136,50602,157.240.16.35,443,25,1434,14,804,11,630,1604.743492,61.834683,104.019292861904,81.507654854477
172.30.1.136,50603,172.217.161.5,443,137,38814,67,21108,70,17706,1610.365196,185.705952,909.30849647727,762.754227715868
172.30.1.136,50604,172.217.161.5,443,32,7016,14,2852,18,4164,1610.365353,53.092224,429.742781165091,627.436514996999
172.30.1.136,50605,172.217.161.5,443,27,1566,15,858,12,708,1610.555732,61.418042,111.758691363036,92.2204586072607
172.30.1.136,50606,157.240.16.20,443,29,5683,13,3347,16,2336,1613.035406,103.710131,258.181141435449,180.194546278222
172.30.1.136,50607,157.240.16.20,443,31,11473,13,3347,18,8126,1613.286194,103.502449,258.699192711855,628.081756790122
172.30.1.136,50608,157.240.16.20,443,46,12465,24,4217,22,8248,1613.469739,78.2654170000001,431.046064700581,843.079900794497
172.30.1.136,50609,157.240.16.20,443,1915,1376137,830,59488,1085,1316649,1613.472728,182.548618,2606.99864624557,57700.7490683934
172.30.1.136,50610,157.240.16.20,443,42,11883,22,4033,20,7850,1613.929695,56.0847650000001,575.272090379624,1119.73367455493
172.30.1.136,50611,157.240.16.20,443,44,12293,24,4165,20,8128,1614.933744,71.9641530000001,463.008298034161,903.56097152981
172.30.1.136,50612,157.240.16.17,443,10,660,3,198,7,462,1618.364629,34.8855430000001,45.4056283429498,105.94646613355
172.30.1.136,50613,157.240.16.17,443,10,660,3,198,7,462,1618.364909,34.883495,45.4082940943847,105.952686220231
172.30.1.136,50614,157.240.16.17,443,10,660,3,198,7,462,1618.365131,34.8355489999999,45.4707919200586,106.098514480137
172.30.1.136,50615,52.94.220.15,443,6,384,3,198,3,186,1618.366238,34.6025049999998,45.7770326165694,43.002667003444
172.30.1.136,50616,157.240.16.17,443,10,660,3,198,7,462,1618.580012,34.6206670000001,45.7530179877815,106.75704197149
172.30.1.136,50617,52.94.220.15,443,6,384,3,198,3,186,1618.617092,34.3516500000001,46.1113221635641,43.3166965778936
172.30.1.136,50618,52.30.87.88,443,10,660,3,198,7,462,1629.281073,24.1246249999999,65.6590516951043,153.204453955243
172.30.1.136,50619,52.30.87.88,443,10,660,3,198,7,462,1629.582397,23.8221570000001,66.4927193620626,155.14967851148
172.30.1.136,50620,52.30.87.88,443,10,660,3,198,7,462,1629.583176,23.8225209999998,66.4917033759782,155.147307877282
172.30.1.136,50621,52.213.11.166,443,22,7602,13,1394,9,6208,1650.281594,62.47281,178.509658841983,794.969843680795
172.30.1.136,50622,52.213.11.166,443,24,8953,14,1460,10,7493,1650.585508,62.1687120000001,187.875856266734,964.214925347012
172.30.1.136,50623,52.213.11.166,443,30,12154,17,1670,13,10484,1650.585796,62.1681959999999,214.900879542975,1349.11426414883
172.30.1.136,50624,172.217.161.14,443,246,74247,109,50908,137,23339,1659.327324,136.850968,2975.96725804672,1364.34548274441
172.30.1.136,50625,157.240.16.16,443,99,28867,49,22945,50,5922,1659.800511,243.005203,755.374772778013,194.958788598448
172.30.1.136,50626,157.240.16.16,443,47,6813,23,3981,24,2832,1694.587348,124.010788,256.81636665352,182.693783060229
172.30.1.136,50627,52.214.173.82,443,125,48605,64,35786,61,12819,1714.762071,85.535942,3346.99067206158,1198.93459523717
172.30.1.136,50628,52.214.173.82,443,29,10015,15,2270,14,7745,1714.762317,21.8019040000001,832.954773124397,2841.95362019756
172.30.1.136,50629,52.214.173.82,443,33,13015,17,2402,16,10613,1714.762509,21.8019330000002,881.389737322825,3894.33358959498
172.30.1.136,50630,52.214.173.82,443,35,14527,18,2480,17,12047,1714.762726,21.801913,910.011887488955,4420.52951958848
172.30.1.136,50631,52.214.173.82,443,12,696,6,348,6,348,1714.765196,30.9764279999999,89.874791244491,89.874791244491
172.30.1.136,50632,157.240.16.17,443,367,262954,164,13035,203,249919,1724.734897,182.763539,570.573324255884,10939.5561660688
172.30.1.136,50633,157.240.16.17,443,12,696,6,348,6,348,1724.736299,21.045535,132.284591482231,132.284591482231
172.30.1.136,50634,172.217.161.3,443,13,1759,8,1236,5,523,1726.225641,13.3072070000001,743.05599965492,314.41609046887
172.30.1.136,50635,172.217.161.3,443,17,966,8,456,9,510,1726.47632,19.267566,189.333722796123,211.754821548295
172.30.1.136,50636,172.217.160.228,443,38,5601,18,2171,20,3430,1738.941542,56.8592759999999,305.455876715701,482.594959527801
172.30.1.136,50637,172.217.160.228,443,18,1080,10,600,8,480,1739.071267,36.042553,133.175915701643,106.540732561314
172.30.1.136,50638,172.217.161.3,443,12,1681,7,1170,5,511,1745.579874,29.5263459999999,317.005023242634,138.452621262381
172.30.1.136,50639,172.217.161.3,443,154,120544,61,5425,93,115119,1745.580437,51.103282,849.260523032551,18021.38657161
172.30.1.136,50640,157.240.16.20,443,922,571824,437,42089,485,529735,1746.037594,49.9374930000001,6742.6692805744,84863.6914952857
172.30.1.136,50641,157.240.16.20,443,11,1634,6,917,5,717,1746.176267,0.706676000000016,10380.9949679908,8116.87392808001
172.30.1.136,50642,157.240.16.20,443,19,5289,10,1209,9,4080,1746.241033,28.23696,342.529790742347,1155.9318000238
172.30.1.136,50643,157.240.16.20,443,19,5722,9,1155,10,4567,1746.333573,3.4598910000002,2670.60436296966,10559.8702386861
172.30.1.136,50644,157.240.16.20,443,19,5288,10,1209,9,4079,1746.376799,28.1013990000001,344.182152639445,1161.22332557179
172.30.1.136,50645,157.240.16.20,443,22,5968,11,1780,11,4188,1746.378941,28.09942,506.772025899467,1192.33777779043
172.30.1.136,50646,157.240.16.20,443,22,5944,10,1778,12,4166,1746.387818,3.55380800000012,4002.46721263488,9378.10934074066
172.30.1.136,50647,157.240.16.20,443,21,2905,11,1844,10,1061,1746.393847,28.084672,525.268730216968,302.228916898158
172.30.1.136,50648,157.240.16.20,443,23,5999,10,1778,13,4221,1746.398411,3.57821400000012,3975.16749976372,9437.11024550206
172.30.1.136,50649,157.240.16.20,443,24,6140,12,1898,12,4242,1746.400864,28.0778339999999,540.782454942929,1208.64023912956
172.30.1.136,50650,157.240.16.20,443,22,5720,10,1778,12,3942,1746.401685,3.58133099999986,3971.70772542402,8805.6647095734
172.30.1.136,50651,157.240.16.20,443,23,6509,10,1778,13,4731,1746.409445,3.5735709999999,3980.33227827302,10591.0866189593
172.30.1.136,50652,193.32.65.35,443,18,5489,11,1513,7,3976,1749.977782,16.1597430000002,749.021813032539,1968.34813523951
172.30.1.136,50653,193.32.65.35,443,18,5489,11,1513,7,3976,1749.978091,16.159173,749.048234089702,1968.41756691385
172.30.1.136,50654,193.32.65.35,443,8,456,4,228,4,228,1750.116712,27.7181720000001,65.8052053360515,65.8052053360515
172.30.1.136,50655,146.112.234.203,80,23,5102,13,1424,10,3678,1755.742917,70.9619109999999,160.536826580107,414.644977641598
172.30.1.136,50656,146.112.234.69,80,14,2392,7,1006,7,1386,1763.266899,61.100805,131.716758887219,181.470604192531
172.30.1.136,50657,180.149.59.225,80,16,6738,8,846,8,5892,1775.691673,19.8052949999999,341.726795788704,2379.96959903906
172.30.1.136,50658,52.94.220.15,443,34,8578,17,2050,17,6528,1782.216953,13.5615799999998,1209.29862154706,3850.87873241913
172.30.1.136,50659,52.94.220.15,443,7,405,4,228,3,177,1782.43479,12.8841520000001,141.569270527078,109.902460014442
172.30.1.136,50660,193.32.65.35,443,14,3660,7,1033,7,2627,1783.842621,1.31167600000003,6300.33636355303,16022.2493969543
172.30.1.136,50661,193.32.65.35,443,8,456,4,228,4,228,1784.093902,14.3717079999999,126.916021394257,126.916021394257
172.30.1.136,50662,172.217.161.3,443,26,3999,13,2020,13,1979,1790.571536,4.86794299999997,3319.67732572056,3252.29773643613
172.30.1.136,50663,13.107.4.52,80,10,1519,5,436,5,1083,1792.013302,0.399167000000034,8738.1972958679,21705.2010812499
172.30.1.136,50664,172.217.161.14,443,80,31406,43,16869,37,14537,1798.103044,35.6913570000002,3781.08347071251,3258.37989292476
172.30.1.136,50665,157.240.16.16,443,18,2998,9,1935,9,1063,1798.13213,108.367797,142.846864368757,78.4734970666608
172.30.1.136,50666,74.125.68.188,5228,14,1994,7,1174,7,820,1798.133477,0.341480999999931,27503.7264152381,19210.4392338119
172.30.1.136,50667,157.240.16.39,443,44,17630,26,13789,18,3841,1798.136014,121.009015,911.60150340865,253.931494277513
172.30.1.136,50668,172.217.161.4,443,24,3879,11,2331,13,1548,1798.172781,0.553752999999915,33675.664059613,22363.761460438
172.30.1.136,50669,172.217.161.3,443,54,17606,30,4620,24,12986,1798.346119,26.041426,1419.2771163914,3989.3360678482
172.30.1.136,50670,151.101.1.181,443,10,588,6,348,4,240,1802.016269,23.4718540000001,118.610144729086,81.8000998131631
172.30.1.136,50671,151.101.1.181,443,21,9119,10,1186,11,7933,1802.016657,1.75948700000004,5392.48087652811,36069.6043790029
172.30.1.136,50672,151.101.1.181,443,657,548415,270,18883,387,529532,1802.067805,157.428865,959.569898442702,26909.0169709348
172.30.1.136,50673,172.217.161.14,443,29,8432,14,1615,15,6817,1804.178873,130.459131,99.0348463995212,418.031299012716
172.30.1.136,50674,172.217.161.14,443,28,9111,13,1549,15,7562,1804.185498,146.062406,84.8404482670236,414.179128337787
172.30.1.136,50675,172.217.161.14,443,28,8735,14,1615,14,7120,1804.190526,140.377462,92.0375665432675,405.763141664436
172.30.1.136,50676,172.217.161.14,443,29,7859,17,2785,12,5074,1804.192511,24.519538,908.663124076807,1655.49611905412
172.30.1.136,50677,172.217.161.14,443,26,7423,16,2473,10,4950,1804.192868,24.520456,806.836544964744,1614.97812275596
172.30.1.136,50678,172.217.161.14,443,29,11777,17,2563,12,9214,1804.213023,24.680505,830.777166026383,2986.64877400199
172.30.1.136,50679,52.16.255.206,443,36,18546,22,7875,14,10671,1805.137605,19.657944,3204.81124577422,4342.67184808339
172.30.1.136,50680,52.16.255.206,443,10,588,6,348,4,240,1805.188254,22.4399600000002,124.064392271643,85.5616498425125
172.30.1.136,50681,151.101.0.188,443,15,2998,10,2668,5,330,1805.301274,15.6176780000001,1366.65642613453,169.039213127585
172.30.1.136,50682,151.101.0.188,443,37,20011,25,8109,12,11902,1805.416489,26.6449130000001,2434.68612564056,3573.51513964409
172.30.1.136,50683,151.101.0.188,443,30,13952,18,2050,12,11902,1805.552005,23.1675829999999,707.88566938554,4109.88060342766
172.30.1.136,50684,151.139.105.14,443,17,1038,9,546,8,492,1806.045903,20.6107930000001,211.927799187542,190.967906960202
172.30.1.136,50685,151.139.105.14,443,39,13955,22,4325,17,9630,1806.161301,19.356184,1787.54242055149,3980.12335489268
172.30.1.136,50686,151.101.0.188,443,29,12307,16,3602,13,8705,1806.180476,18.377152,1568.0340457542,3789.48816443374
172.30.1.136,50687,151.101.0.188,443,29,12307,16,3602,13,8705,1806.182571,18.4120889999999,1565.058695947,3782.29759806181
172.30.1.136,50688,151.101.0.188,443,29,12307,16,3602,13,8705,1806.183847,18.4058029999999,1565.59319905794,3783.58933864502
172.30.1.136,50689,172.217.161.4,443,3,198,3,198,0,0,1808.308716,9.00205899999992,175.959744320718,0
172.30.1.136,50690,172.217.161.4,443,3,198,3,198,0,0,1808.559729,9.00192399999992,175.962383152759,0
172.30.1.136,50691,172.217.161.14,443,44,10264,21,6174,23,4090,1822.315513,5.82876499999998,8473.8362243117,5613.53906016114
172.30.1.136,50742,13.107.4.52,80,15,2559,7,513,8,2046,1888.596776,0.908546999999999,4517.1025824751,18015.5787207487
172.30.1.136,50743,52.230.83.250,443,43,13109,23,7853,20,5256,1890.628197,75.272772,834.61786155557,558.608363725465
172.30.1.136,50744,52.230.83.250,443,53,16600,30,10420,23,6180,1891.20617,79.927758,1042.94180252122,618.558573856156
172.30.1.136,50745,204.79.197.213,443,48,22687,27,6260,21,16427,1893.134706,50.2017960000001,997.573871659889,2617.75495044042
172.30.1.136,50746,52.229.168.53,443,22,9733,12,1190,10,8543,1893.391112,16.3899549999999,580.843571565637,4169.87111923129
172.30.1.136,50747,157.240.16.16,443,15,3468,11,3216,4,252,1894.110208,66.013021,389.741290585686,30.5394294861918
172.30.1.136,50748,172.217.194.188,443,18,2802,11,2205,7,597,1894.110497,26.069925,676.641762490686,183.199606443056
172.30.1.136,50749,172.217.160.228,443,18,2953,11,2343,7,610,1894.110718,26.0538640000002,719.432633869581,187.304270875136
172.30.1.136,50750,172.217.194.188,443,13,798,7,426,6,372,1894.361535,14.9101020000001,228.569864914404,199.596220066099
172.30.1.136,50751,172.217.160.228,443,18,1104,9,546,9,558,1894.36177,26.9347640000001,162.169603565117,165.733770676438
172.30.1.136,50752,172.217.161.3,443,10,612,5,306,5,306,1900.318707,8.94039900000007,273.813282829992,273.813282829992
172.30.1.136,50753,172.217.161.14,443,16,5047,7,943,9,4104,1900.328759,7.35254499999996,1026.03928299657,4465.39259535306
172.30.1.136,50754,172.217.161.3,443,17,5113,8,1009,9,4104,1900.569613,7.25932200000011,1111.94957325214,4522.73642083923
172.30.1.136,50755,172.217.161.14,443,10,612,5,306,5,306,1900.579773,8.55922899999996,286.007069094659,286.007069094659
172.30.1.136,50758,23.9.209.92,443,26,9126,12,1695,14,7431,1906.796965,2.62843599999997,5158.96145084004,22617.2522366916
172.30.1.136,50759,172.217.161.3,443,15,1743,9,1101,6,642,1907.670477,6.91241300000002,1274.22941887297,743.011159778791
172.30.1.136,50760,172.217.161.3,443,11,654,6,348,5,306,1907.832615,18.308025,152.064463534433,133.711855866484
172.30.1.136,50761,172.217.161.3,443,68,14908,32,11182,36,3726,1907.883688,47.3062970000001,1890.99561100713,630.106389430565
172.30.1.136,50764,172.217.161.4,443,11,3030,8,2696,3,334,1911.335137,4.1689879999999,5173.43777434728,640.922929017801
172.30.1.136,50765,74.125.68.188,5228,13,3235,8,2512,5,723,1911.346152,52.724471,381.151287416426,109.702380892546
172.30.1.136,50762,74.125.68.188,5228,3,198,1,66,2,132,1914.245221,16.5786420000002,31.8482056612354,63.6964113224707
172.30.1.136,50763,172.217.161.4,443,3,198,1,66,2,132,1914.246151,16.5777109999999,31.8499942483014,63.6999884966028
172.30.1.136,50766,13.107.4.52,80,12,1639,6,502,6,1137,1916.227463,3.36133600000016,1194.76303469805,2706.06687340973
172.30.1.136,50767,172.217.161.4,443,33,4511,14,2530,19,1981,1917.589731,4.86063999999988,4164.06069982564,3260.47598670142
172.30.1.136,50768,74.125.68.188,443,20,2450,11,1510,9,940,1917.589923,42.518697,284.110305638012,176.86336907267
172.30.1.136,50769,74.125.68.188,443,10,588,5,294,5,294,1917.840105,5.88687800000002,399.532655509421,399.532655509421
172.30.1.136,50770,172.217.161.4,443,8,480,4,240,4,240,1917.84027,5.36427500000013,357.923484534248,357.923484534248
172.30.1.136,50773,13.107.4.52,80,10,1519,5,436,5,1083,1919.586936,0.156024000000116,22355.5350458738,55529.9184740397
172.30.1.136,50774,34.225.100.237,443,12,7050,5,799,7,6251,1921.117163,1.22480200000018,5218.80271260094,40829.4565162309
172.30.1.136,50775,151.101.129.181,443,53,22539,28,2864,25,19675,1921.277233,11.970724,1914.00286231643,13148.7452220935
172.30.1.136,50776,34.225.100.237,443,5,330,1,66,4,264,1921.366819,15.3341619999999,34.4329217338387,137.731686935355
172.30.1.136,50777,151.101.129.181,443,17,2441,9,1646,8,795,1921.487178,0.891245000000026,14774.837446493,7136.08491492217
172.30.1.136,50771,157.240.16.16,443,4,264,1,66,3,198,1921.669672,8.93850599999996,59.0702741599102,177.210822479731
172.30.1.136,50772,157.240.16.16,443,4,264,1,66,3,198,1921.843799,3.39378099999999,155.578689373298,466.736068119895
172.30.1.136,50778,151.101.129.181,443,62,27751,31,3176,31,24575,1925.106828,40.7953970000001,622.815363213647,4819.17114325421
172.30.1.136,50779,157.240.16.16,443,46,9870,24,4543,22,5327,1925.107504,67.096055,541.67119065346,635.149115696892
172.30.1.136,50780,74.125.68.188,5228,2,132,2,132,0,0,1925.108251,2.99968999999987,352.036377092314,0
172.30.1.136,50781,157.240.16.16,443,32,7412,17,2770,15,4642,1925.108742,8.13758000000007,2723.16831293822,4563.5188839925
172.30.1.136,50782,34.225.100.237,443,25,8660,12,1465,13,7195,1925.109201,68.609498,170.821829945469,838.950898605904
172.30.1.136,50787,157.240.16.16,443,19,1050,12,660,7,390,1925.391378,29.433503,179.38741440324,106.001653965551
172.30.1.136,50788,151.101.129.181,443,19,2830,12,2262,7,568,1925.406661,37.930744,477.080017201877,119.797281065723
172.30.1.136,50789,151.101.129.181,443,19,2861,11,2208,8,653,1925.407015,7.97001099999989,2216.30810798131,655.457062731792
172.30.1.136,50790,172.217.161.4,443,19,2686,11,1841,8,845,1925.545243,7.30379500000004,2016.48595011223,925.546240002624
172.30.1.136,50783,13.107.4.52,80,2,132,2,132,0,0,1928.204874,5.99986799999988,176.003872085189,0
172.30.1.136,50784,172.217.161.4,443,1,66,1,66,0,0,1928.294376,0,0,0
172.30.1.136,50786,34.225.100.237,443,1,66,1,66,0,0,1928.35605,0,0,0
172.30.1.136,50785,74.125.68.188,5228,1,66,1,66,0,0,1928.357053,0,0,0
172.30.1.136,50791,151.101.129.181,443,21,4005,13,3347,8,658,1931.585865,29.8448209999999,897.174085915948,176.379010616281
172.30.1.136,50792,34.225.100.237,443,10,564,7,390,3,174,1931.586011,28.532821,109.347757797941,48.7859227098505
172.30.1.136,50793,74.125.68.188,443,23,2686,13,1558,10,1128,1931.586141,43.1944820000001,288.5553761242,208.915573984658
172.30.1.136,50794,34.225.100.237,443,42,21616,23,12175,19,9441,1931.835491,30.9599409999998,3146.00082732717,2439.53953271424
172.30.1.136,50795,74.125.68.188,443,20,1140,12,672,8,468,1931.835722,31.3278539999999,171.604476961621,119.510260741129
172.30.1.136,50796,151.101.129.181,443,67,32337,31,3392,36,28945,1931.886671,26.093521,1039.95164163548,8874.23356932167
172.30.1.136,50797,151.101.129.181,443,20,1924,10,1132,10,792,1931.886919,29.6134849999999,305.806628297887,213.956580929264
172.30.1.136,50798,52.18.200.60,443,32,9434,19,2819,13,6615,1931.918906,28.9673919999998,778.530562917095,1826.88175725313
172.30.1.136,50799,52.18.200.60,443,15,834,10,552,5,282,1932.169052,38.8000690000001,113.814230588095,58.1442264960919
172.30.1.136,50800,172.217.161.14,443,1,66,1,66,0,0,1935.327243,0,0,0
172.30.1.136,50801,172.217.161.14,443,1,66,1,66,0,0,1935.377792,0,0,0
172.30.1.136,50802,74.125.68.188,5228,3,198,3,198,0,0,1938.608698,9.00136500000008,175.97331071454,0
172.30.1.136,50803,172.217.161.14,443,3,198,3,198,0,0,1938.608961,9.00110200000017,175.978452416156,0
172.30.1.136,50804,74.125.68.188,5228,3,198,3,198,0,0,1938.859277,9.01063199999999,175.792330660047,0
172.30.1.136,50805,172.217.161.14,443,3,198,3,198,0,0,1938.859959,8.99997700000017,176.000449778924,0
172.30.1.136,50806,157.240.16.16,443,12,696,7,414,5,282,1947.861319,34.8544869999998,95.0236335425053,64.7262431376486
172.30.1.136,50807,157.240.16.16,443,18,5119,11,1223,7,3896,1947.927081,32.6847699999998,299.344312350983,953.59398276323
172.30.1.136,50808,172.217.161.14,443,1194,903649,519,44715,675,858934,1952.394799,45.254557,7904.61831280329,151840.443383414
172.30.1.136,50809,172.217.161.14,443,29,4200,16,2591,13,1609,1952.395059,12.517167,1655.96576285992,1028.34770839121
172.30.1.136,50810,172.217.161.14,443,27,3864,15,2321,12,1543,1952.395273,12.5187159999998,1483.21920554794,986.043616613731
172.30.1.136,50811,172.217.161.14,443,27,3864,15,2321,12,1543,1952.395488,12.5181210000001,1483.28970458106,986.090484346647
172.30.1.136,50812,172.217.161.14,443,27,3864,15,2321,12,1543,1952.395716,12.5174810000001,1483.36554295548,986.140901671823
172.30.1.136,50813,172.217.161.14,443,27,3864,15,2321,12,1543,1952.395929,12.516869,1483.43807065488,986.18911806139
172.30.1.136,50814,172.217.161.14,443,47,13864,22,9318,25,4546,1952.429043,7.42732499999988,10036.4532318165,4896.51388622426
172.30.1.136,50815,157.240.16.16,443,28,4045,14,2327,14,1718,1955.211377,5.24276799999984,3550.79606803135,2621.51596256031
172.30.1.136,50816,172.217.161.3,443,24,2845,12,1693,12,1152,1956.370958,24.8338820000001,545.383923463916,371.105894761035
172.30.1.136,50817,172.217.161.3,443,12,708,7,414,5,294,1956.622488,24.6997220000001,134.090578023509,95.2237438137965
172.30.1.136,50818,172.217.161.3,443,20,2389,10,1357,10,1032,1956.672195,24.5035959999998,443.037013832586,336.93013874372
172.30.1.136,50819,172.217.161.3,443,20,2389,10,1357,10,1032,1956.672685,24.5031059999999,443.045873449678,336.936876492312
172.30.1.136,50820,172.217.161.3,443,20,2389,10,1357,10,1032,1956.673044,24.5027480000001,443.052346618426,336.941799344301
172.30.1.136,50821,172.217.161.3,443,20,2389,10,1357,10,1032,1957.450047,23.725745,457.56202808384,347.976428137452
172.30.1.136,50822,52.230.84.217,443,45,10225,23,3464,22,6761,1963.354136,3.96839599999998,6983.17405823414,13629.6881662012
172.30.1.136,50823,52.18.200.60,443,9,534,5,294,4,240,1965.903241,16.520982,142.364418773654,116.215852060126
172.30.1.136,50824,52.18.200.60,443,32,4901,17,3088,15,1813,1965.918906,31.58665,782.10256548257,459.181331353595
172.30.1.136,50825,52.230.84.217,443,34,12951,19,6727,15,6224,1973.553763,1.39132900000004,38679.5646464628,35787.3658926095
172.30.1.136,50826,52.114.75.78,443,40,15513,21,7791,19,7722,1976.19937,8.08345099999997,7710.56817193551,7642.28050618483
172.30.1.136,50827,172.217.161.14,443,43,13840,22,3445,21,10395,1980.613606,9.45005300000003,2916.38575995287,8799.95064577942
172.30.1.136,50828,172.217.161.14,443,7,426,4,240,3,186,1980.864667,10.7004549999999,179.431622300175,139.059507282635
172.30.1.136,50829,74.125.68.188,443,23,2915,12,1831,11,1084,1986.470898,4.38686200000006,3339.0610418107,1976.81167084806
172.30.1.136,50830,74.125.68.188,443,10,648,6,384,4,264,1986.72306,3.36510799999996,912.897892133041,627.617300841466
192.168.43.233,50068,74.125.68.188,5228,4,242,2,110,2,132,18.029421,45.282687,19.4334757564188,23.3201709077025
192.168.43.233,50104,13.107.129.254,443,1,54,0,0,1,54,40.803604,0,0,0
192.168.43.233,50116,13.107.21.200,443,1,54,1,54,0,0,44.741761,0,0,0
192.168.43.233,50113,131.253.61.80,443,1,54,0,0,1,54,50.214084,0,0,0
192.168.43.233,50692,151.101.152.188,443,14,8982,5,799,9,8183,1837.370152,0.664236999999957,9623.07128329258,98555.1843694407
192.168.43.233,50693,151.101.152.188,443,14,8982,5,799,9,8183,1837.370612,0.629139000000123,10159.9169658831,104053.317311416
192.168.43.233,50694,151.101.152.188,443,14,8982,5,799,9,8183,1837.370973,0.629741999999851,10150.1884898919,103953.682619256
192.168.43.233,50695,151.101.152.188,443,17,9673,6,1370,11,8303,1837.371318,0.858116999999993,12772.1511169224,77406.6939589829
192.168.43.233,50696,151.101.152.188,443,15,9036,5,799,10,8237,1837.371655,0.854273000000148,7482.38560740991,77136.9339777665
192.168.43.233,50697,151.101.152.188,443,18,9739,6,1370,12,8369,1837.371894,0.857542999999851,12780.7002097876,78074.2190187684
192.168.43.233,50698,13.107.4.52,80,10,1476,5,393,5,1083,1838.231658,0.263976000000184,11910.1736521419,32821.1655604826
192.168.43.233,50699,52.230.84.217,443,27,10564,14,5041,13,5523,1838.337953,1.4574990000001,27669.3157250861,30314.9436123092
192.168.43.233,50700,52.229.171.86,443,29,9433,14,1375,15,8058,1838.343996,1.65095999999994,6662.79013422517,39046.3730193356
192.168.43.233,50701,125.56.235.100,443,20,8012,10,1235,10,6777,1839.7969,0.880402000000004,11222.1462468281,61580.9596070883
192.168.43.233,50702,125.56.235.100,443,17,6654,8,1326,9,5328,1840.626112,0.731498000000101,14501.7484668427,58269.4689527437
192.168.43.233,50703,125.56.235.100,443,17,6383,8,1318,9,5065,1841.276459,0.70227900000009,15013.9759269445,57697.8665174309
192.168.43.233,50704,172.217.166.196,443,129,53711,57,7218,72,46493,1843.187767,4.15619900000002,13893.463715284,89491.3838341231
192.168.43.233,50705,151.101.152.188,443,3497,2547868,1650,108599,1847,2439269,1843.189411,26.301676,33031.8113568123,741935.685011099
192.168.43.233,50706,172.217.166.206,443,162,45951,71,26208,91,19743,1843.191687,39.9708619999999,5245.42102694709,3951.47845448018
192.168.43.233,50707,74.125.24.188,443,18,2707,9,1633,9,1074,1843.265303,1.3990040000001,9338.0719426099,6141.51210432519
192.168.43.233,50708,157.240.16.16,443,45,7306,22,4883,23,2423,1843.322775,34.3781919999999,1136.30175781205,563.84582412013
192.168.43.233,50709,204.79.197.213,443,50,21753,25,8021,25,13732,1843.355958,2.74403799999982,23384.5158121004,40034.4310100688
192.168.43.233,50710,172.217.166.206,443,23,7204,11,1663,12,5541,1843.412632,12.514878,1063.05470976226,3542.02414118621
192.168.43.233,50711,172.217.166.206,443,22,7148,11,1663,11,5485,1843.412888,11.5745039999999,1149.42290399658,3791.09117764357
192.168.43.233,50712,172.217.166.206,443,22,7469,11,1663,11,5806,1843.41307,10.4141549999999,1277.49202887801,4460.08341531313
192.168.43.233,50713,172.217.166.206,443,293,219116,129,10936,164,208180,1843.413238,5.91177799999991,14798.9318949394,281715.585395802
192.168.43.233,50714,172.217.166.206,443,22,7148,11,1663,11,5485,1843.413401,11.5742109999999,1149.45200152305,3791.1871487396
192.168.43.233,50715,172.217.166.206,443,22,7148,11,1663,11,5485,1843.413565,11.574237,1149.44941943041,3791.17863233662
192.168.43.233,50716,172.217.166.206,443,24,8638,12,1729,12,6909,1843.414004,11.574147,1195.07727005713,4775.47071071413
192.168.43.233,50717,172.217.166.206,443,25,8692,12,1729,13,6963,1843.414525,12.5228200000001,1104.54354530368,4448.19936723513
192.168.43.233,50718,172.217.166.208,443,3195,2962703,1146,63495,2049,2899208,1844.160431,12.793398,39704.854019237,1812940.08050089
192.168.43.233,50719,172.217.166.202,443,17,4787,9,1285,8,3502,1844.187729,13.0457630000001,787.995305448975,2147.51716706795
192.168.43.233,50720,172.217.166.208,443,18,5609,9,1285,9,4324,1844.209609,13.0240799999999,789.307190987776,2656.00334150283
192.168.43.233,50721,172.217.166.202,443,9,534,5,294,4,240,1844.438595,12.8605849999999,182.884371123088,149.293364182113
192.168.43.233,50722,172.217.166.202,443,18,4842,9,1285,9,3557,1844.586403,12.6946359999999,809.790843943855,2241.57667852785
192.168.43.233,50723,172.217.166.202,443,9,534,5,294,4,240,1844.838247,12.485537,188.377960835805,153.777927212902
192.168.43.233,50724,157.240.16.16,443,23,3655,11,2246,12,1409,1846.235324,2.62856899999997,6835.65848946716,4288.26483154908
192.168.43.233,50725,157.240.16.16,443,7,402,4,228,3,174,1846.439813,11.742023,155.339501549264,118.548566971807
192.168.43.233,50726,172.217.24.232,443,18,5316,9,1285,9,4031,1846.534395,12.0289710000002,854.603440310883,2680.8610645083
192.168.43.233,50727,172.217.24.232,443,9,534,5,294,4,240,1846.784914,12.09798,194.412620949944,158.704180367301
192.168.43.233,50728,54.173.195.251,443,7,402,4,228,3,174,1849.365799,14.6878650000001,124.184147934365,94.7721128972788
192.168.43.233,50729,54.173.195.251,443,47,22558,25,12688,22,9870,1849.394236,34.13636,2973.48633539136,2313.07614520119
192.168.43.233,50730,151.101.129.181,443,271,210462,103,8531,168,201931,1855.964487,15.6109329999999,4371.80788617825,103481.835454678
192.168.43.233,50731,151.101.129.181,443,9,534,5,294,4,240,1855.991867,13.4990150000001,174.234934919324,142.232599934142
192.168.43.233,50732,172.217.166.206,443,29,8099,13,2568,16,5531,1857.299723,0.654086000000007,31408.7138388527,67648.5966677158
192.168.43.233,50733,172.217.166.206,443,18,5747,8,1219,10,4528,1857.300236,0.334211999999979,29179.0839347498,108386.293729735
192.168.43.233,50734,172.217.166.202,443,17,4582,9,1120,8,3462,1858.564271,10.5325540000001,850.69585211715,2629.56164288355
192.168.43.233,50735,172.217.166.202,443,7,402,4,228,3,174,1858.814665,12.5978269999998,144.786874752291,110.495246521485
192.168.43.233,50736,151.139.105.14,443,16,4786,8,1087,8,3699,1861.615389,12.0583799999999,721.158231868629,2454.06099326776
192.168.43.233,50737,151.139.105.14,443,3,186,2,120,1,66,1861.866388,0.63694200000009,1507.20159763348,828.960878698414
192.168.43.233,50738,52.214.173.82,443,24,9017,12,2428,12,6589,1868.688089,2.42643900000007,8005.14663669658,21724.0161405246
192.168.43.233,50739,52.214.173.82,443,3,186,2,120,1,66,1868.688409,0.795315999999957,1207.06737950708,663.887058728893
192.168.43.233,50740,172.217.166.197,443,40,21715,17,4060,23,17655,1871.419404,1.9013480000001,17082.6171747614,74284.139463156
192.168.43.233,50741,172.217.166.197,443,9,510,5,282,4,228,1871.634897,11.428216,197.406139330933,159.604963714371
192.168.43.233,50861,74.125.130.188,443,4,217,2,109,2,108,0,45.490909,19.1686651062523,18.9928057933509
192.168.43.233,50865,172.217.166.206,443,4,216,2,108,2,108,0.010516,3.120991,276.83514627245,276.83514627245
192.168.43.233,50871,204.79.197.200,443,35,11774,19,3601,16,8173,2.902996,64.406537,447.283790463692,1015.17645638982
192.168.43.233,50854,172.217.166.206,443,3,162,2,108,1,54,3.006212,0.124562,6936.30481206146,3468.15240603073
192.168.43.233,50864,172.217.166.206,443,3,162,2,108,1,54,3.006518,0.124988,6912.6636157071,3456.33180785355
192.168.43.233,50848,172.217.166.195,443,2,108,2,108,0,0,3.006727,5.9999999999949E-05,0,0
192.168.43.233,50850,172.217.166.195,443,2,108,2,108,0,0,3.006908,5.89999999998092E-05,0,0
192.168.43.233,50853,172.217.166.196,443,3,162,2,108,1,54,3.00711,0.124396,6945.56095051288,3472.78047525644
192.168.43.233,50857,172.217.166.206,443,2,108,1,54,1,54,3.007337,0.124169,3479.1292512624,3479.1292512624
192.168.43.233,50856,172.217.194.189,443,2,108,1,54,1,54,3.007445,0.172924,2498.20730494322,2498.20730494322
192.168.43.233,50851,172.217.166.195,443,2,108,1,54,1,54,3.007611,0.123897,3486.76723407345,3486.76723407345
192.168.43.233,50858,172.217.166.196,443,2,108,1,54,1,54,3.007688,0.12382,3488.93555160716,3488.93555160716
192.168.43.233,50872,172.217.166.197,443,46,6050,24,3208,22,2842,3.132218,243.757601,105.284921966392,93.272988849279
192.168.43.233,50855,172.217.166.206,443,28,2391,14,1126,14,1265,3.384936,242.540256,37.1402263218523,41.7250322354735
192.168.43.233,50873,204.79.197.213,443,38,15859,19,5032,19,10827,10.928786,71.735422,561.173251340182,1207.4369618959
192.168.43.233,50862,157.240.16.16,443,13,828,6,372,7,456,20.896283,66.153603,44.9862118621113,55.1443887342009
192.168.43.233,50868,157.240.16.16,443,7,420,3,192,4,228,20.925619,0.37576,4087.7155631254,4854.16223121142
192.168.43.233,50874,157.240.16.39,443,39,9273,20,6182,19,3091,20.945462,66.279559,746.17273781197,373.086368905985
192.168.43.233,50875,172.217.166.197,443,82,47056,34,6241,48,40815,28.184042,242.742389,205.683070870659,1345.12971280018
192.168.43.233,50849,172.217.166.195,443,16,968,9,491,7,477,34.108912,197.340064,19.9047264928423,19.3371782832704
192.168.43.233,50852,172.217.194.189,443,16,980,8,437,8,543,34.535475,198.487171,17.613229018212,21.8855454391055
192.168.43.233,50876,172.217.166.206,443,180,111055,82,6826,98,104229,35.144709,244.774281,223.095334104975,3406.53436543033
192.168.43.233,50877,172.217.166.206,443,21,6002,10,1351,11,4651,35.395534,30.980296,348.866905597029,1201.02144924632
192.168.43.233,50878,172.217.166.206,443,20,5949,10,1351,10,4598,35.448663,30.048812,359.681440983424,1224.141573384
192.168.43.233,50879,172.217.166.206,443,22,6325,11,1663,11,4662,35.450495,30.047299,442.768582959819,1241.24301488796
192.168.43.233,50880,172.217.166.206,443,21,6002,11,1405,10,4597,35.450815,30.047233,374.077706256679,1223.93965527541
192.168.43.233,50881,172.217.166.206,443,18,5759,9,1285,9,4474,35.451179,30.047115,342.129352518536,1191.1958935159
192.168.43.233,50860,74.125.130.188,443,156,9597,79,4479,77,5118,35.644324,3236.544016,11.0710683441544,12.6505308741644
192.168.43.233,50863,172.217.166.206,443,21,1325,11,611,10,714,36.880779,197.203508,24.7865773259977,28.9650019816078
192.168.43.233,50847,23.9.184.115,80,4,216,2,108,2,108,49.112081,1.489393,580.102095283112,580.102095283112
192.168.43.233,50846,125.56.228.72,443,5,301,3,162,2,139,49.112232,0.370781000000001,3495.324733468,2999.07492562995
192.168.43.233,50882,104.237.191.1,443,30,7383,15,2184,15,5199,66.376885,49.353469,354.017667937384,842.737113372922
192.168.43.233,50883,104.237.191.1,443,7,427,4,241,3,186,66.499881,48.093389,40.088669983311,30.9398033896093
192.168.43.233,50884,104.16.92.188,80,12,1391,6,569,6,822,72.225143,47.766442,95.2970288220337,137.669872920407
192.168.43.233,50886,54.239.25.120,443,53,15944,24,5193,29,10751,115.704391,12.037109,3451.32705868162,7145.23728247372
192.168.43.233,50887,49.44.169.252,80,13,1509,7,780,6,729,116.033194,167.962777,37.1510885414808,34.7219789060763
192.168.43.233,50888,54.239.25.120,443,56,20837,29,12582,27,8255,120.746764,10.586203,9508.22499814145,6238.30848511029
192.168.43.233,50889,49.44.169.252,443,42,22359,19,2117,23,20242,121.106486,5.586687,3031.49254647701,28986.0520197391
192.168.43.233,50890,49.44.169.252,443,25,3708,13,2004,12,1704,125.491615,107.572729,149.03405490438,126.723567643245
192.168.43.233,50891,49.44.169.252,443,21,2901,11,1726,10,1175,125.551524,107.513018,128.430958937456,87.4312727413158
192.168.43.233,50892,54.239.25.120,443,22,7134,12,1454,10,5680,129.977881,15.212004,764.659278291012,2987.11464972005
192.168.43.233,50893,54.239.25.120,443,110,88604,75,78130,35,10474,144.978395,8.36560599999999,74715.4479902593,10016.2498688081
192.168.43.233,50894,54.239.25.120,443,81,57723,49,49174,32,8549,153.193638,15.996351,24592.6086518106,4275.47507553441
192.168.43.233,50895,54.239.25.120,443,1,66,1,66,0,0,168.198758,0,0,0
192.168.43.233,50896,54.239.25.120,443,98,68267,56,60769,42,7498,169.194437,12.723379,38209.3467466465,4714.47089644976
192.168.43.233,50897,104.214.119.36,443,19,6036,11,1711,8,4325,179.422505,148.594084,92.1167224934742,232.849108582277
192.168.43.233,50898,50.16.219.101,443,32,8435,17,2136,15,6299,216.655343,175.716746,97.2474188658149,286.779724454947
192.168.43.233,50899,50.16.219.101,443,13,765,7,405,6,360,216.732205,154.845648,20.9240623927642,18.5991665713459
192.168.43.233,50900,172.217.166.195,443,6,361,4,241,2,120,225.414794,49.82183,38.6978960829018,19.2686619499926
192.168.43.233,50901,172.217.166.195,443,19,6357,9,1121,10,5236,225.666327,63.67944,140.830384186796,657.794729350635
192.168.43.233,50845,52.230.3.194,443,17,2467,13,1453,4,1014,284.416738,57.943681,200.60858750068,139.998009446449
192.168.43.233,50902,172.217.166.195,443,20,5798,10,1339,10,4459,294.811627,40.182038,266.586776907632,887.759849313765
192.168.43.233,50903,172.217.166.195,443,20,5798,10,1339,10,4459,295.062492,39.936308,268.227098008158,893.222277832994
192.168.43.233,50904,172.217.166.195,443,11,642,6,348,5,294,295.11227,39.802108,69.9460440637969,59.0923475711387
192.168.43.233,50905,128.135.53.136,80,183,167591,65,3906,118,163685,334.917825,5.57437099999999,5605.65488016497,234910.808771071
192.168.43.233,50906,173.222.151.224,443,67,31470,30,3247,37,28223,334.999935,350.255374,74.1630305435371,644.626797360717
192.168.43.233,50907,128.135.53.136,80,11,690,6,372,5,318,335.115155,36.936117,80.5715446482911,68.8756752638617
192.168.43.233,50908,213.239.228.180,443,169,133665,66,4664,103,129001,335.159519,182.090645,204.908934228884,5667.55090575905
192.168.43.233,50909,213.239.228.180,443,7,402,4,228,3,174,335.316784,37.253592,48.9617215972086,37.3655243768171
192.168.43.233,50910,52.230.80.159,443,65,15207,41,7785,24,7422,338.635923,2148.253833,28.990987491002,27.6391919278377
192.168.43.233,50911,151.139.105.8,80,159,143846,56,3487,103,140359,371.804672,26.139283,1067.20601326364,42957.2609164528
192.168.43.233,50912,83.231.173.69,443,125,87198,47,3692,78,83506,371.956183,314.079228,94.0399662469879,2127.00471869474
192.168.43.233,50913,151.139.105.8,80,7,402,4,228,3,174,371.986204,26.578922,68.6258080745336,52.3723272147756
192.168.43.233,50914,66.77.51.230,80,237,218633,82,4853,155,213780,372.139163,135.983221,285.505812514913,12576.8457859959
192.168.43.233,50915,83.231.173.69,443,7,394,4,228,3,166,372.154574,26.798026,68.064714915942,49.5558889300279
192.168.43.233,50916,66.77.51.230,80,5,294,3,174,2,120,372.298709,25.868164,53.811318035559,37.1112538176269
192.168.43.233,50917,65.222.231.19,80,249,229469,87,5123,162,224346,398.081907,33.666608,1217.3486559739,53310.0334907514
192.168.43.233,50918,204.147.113.115,80,80,67711,29,1998,51,65713,398.138578,3.346205,4776.75456225784,157104.54081564
192.168.43.233,50919,65.222.231.19,80,7,402,4,228,3,174,398.171382,33.473248,54.4912761378878,41.5854475789144
192.168.43.233,50920,204.147.113.115,80,6,344,3,174,3,170,398.177171,33.439024,41.6280092385471,40.6710435089254
192.168.43.233,50921,83.212.248.207,80,35,25372,14,1158,21,24214,398.385421,134.015754,69.1262013867415,1445.44200378114
192.168.43.233,50922,83.212.248.207,80,5,294,3,174,2,120,398.423137,33.157615,41.9813065565783,28.9526252114333
192.168.43.233,50923,52.84.103.186,443,150,83402,68,8308,82,75094,431.420674,221.638345,299.875908205324,2710.5057114553
192.168.43.233,50924,52.84.103.186,443,16,6825,8,1087,8,5738,431.420984,0.222905000000026,39012.1352145488,205935.263901638
192.168.43.233,50925,52.84.103.186,443,6265,4689109,3000,202221,3265,4486888,431.762323,237.41714,6814.03204503264,151190.027813493
192.168.43.233,50926,52.84.109.5,443,893,589531,375,45834,518,543697,433.2752,235.949717,1554.02602156967,18434.3344645758
192.168.43.233,50927,52.16.255.206,443,409,188594,244,164738,165,23856,433.294003,236.654087,5568.90445758496,806.442865277877
192.168.43.233,50928,52.16.255.206,443,7,402,4,228,3,174,433.443645,19.521602,93.4349547747159,71.3056233807042
192.168.43.233,50929,52.84.109.5,443,9,534,5,294,4,240,433.44659,19.364459,121.45962869399,99.1507173012166
192.168.43.233,50930,49.44.178.243,80,14,828,7,414,7,414,433.532223,19.483702,169.988229136332,169.988229136332
192.168.43.233,50931,54.239.35.198,443,64,18313,31,6479,33,11834,436.949593,65.424532,792.241051109086,1447.0413024888
192.168.43.233,50932,52.84.108.164,80,16,1695,9,922,7,773,440.59223,126.058858,58.5123498421666,49.0564494880637
192.168.43.233,50933,52.84.108.164,80,9,534,5,294,4,240,440.844663,13.329745,176.447486429785,144.038764432478
192.168.43.233,50934,52.94.220.16,443,35,10879,18,2457,17,8422,440.983894,69.990194,280.839341579765,962.649139106544
192.168.43.233,50935,52.94.220.16,443,10,560,5,282,5,278,441.200289,12.974025,173.885898940383,171.419432288746
192.168.43.233,50936,54.239.35.198,443,44,15520,22,4714,22,10806,450.956398,7.65337900000003,4927.49673052907,11295.402984747
192.168.43.233,50937,54.239.35.198,443,44,17546,20,3807,24,13739,451.207065,6.74232699999999,4517.13481117128,16301.7901682906
192.168.43.233,50938,54.239.35.198,443,28,7800,13,1531,15,6269,452.010382,28.617003,427.997299367792,1752.52453934467
192.168.43.233,50939,54.239.35.198,443,39,12232,18,1801,21,10431,452.147825,21.785223,661.365734011537,3830.48638060763
192.168.43.233,50940,54.239.35.198,443,28,7800,13,1531,15,6269,452.465497,28.714611,426.542431656135,1746.56727893685
192.168.43.233,50941,54.239.35.198,443,8,459,4,228,4,231,453.113256,13.209637,138.081008584868,139.897863960985
192.168.43.233,50942,49.44.178.243,80,15,858,7,402,8,456,453.341201,16.000166,200.997914646636,227.997634524542
192.168.43.233,50943,172.217.166.226,443,19,5297,11,1663,8,3634,454.050635,22.600254,588.665950391531,1286.35722412677
192.168.43.233,50944,172.217.166.226,443,13,762,8,468,5,294,454.286496,21.40151,174.940927065427,109.898787515461
192.168.43.233,50945,54.83.70.244,443,17,7232,9,1141,8,6091,455.233725,21.416729,426.208876248095,2275.23073201327
192.168.43.233,50946,54.83.70.244,443,5,294,3,174,2,120,455.441388,18.30643,76.0388562925705,52.4405905466004
192.168.43.233,50947,54.77.120.226,443,23,7748,13,1417,10,6331,461.443105,28.841685,393.042223434588,1756.06938360224
192.168.43.233,50948,54.77.120.226,443,101,22596,51,7769,50,14827,461.641035,207.990573,298.821235518208,570.295077748548
192.168.43.233,50949,54.77.120.226,443,7,426,4,240,3,186,461.699468,17.873638,107.42077242473,83.2510986291656
192.168.43.233,50950,104.237.191.1,443,29,5287,15,3086,14,2201,465.306571,50.9516849999999,484.537459359784,345.582290359976
192.168.43.233,50951,104.237.191.1,443,12,696,5,294,7,402,465.557823,17.450935,134.777878663808,184.288119805615
192.168.43.233,50952,104.20.23.135,80,9,510,5,282,4,228,466.9614,23.022542,97.9909169022257,79.2266987720123
192.168.43.233,50953,104.20.23.135,80,10,3736,6,768,4,2968,466.961803,9.13131600000003,672.849346140248,2600.28236893783
192.168.43.233,50954,104.20.23.135,80,54,36819,25,2451,29,34368,467.144937,8.94818099999998,2191.28334574368,30726.2448088612
192.168.43.233,50955,104.20.23.135,80,15,2220,8,768,7,1452,470.614819,108.748119,56.4975289365695,106.815640645702
192.168.43.233,50956,163.53.78.128,80,12,1902,7,1261,5,641,473.508111,35.549159,283.77605219859,144.250951196904
192.168.43.233,50957,163.53.78.128,80,12,1132,7,414,5,718,473.508816,16.570914,199.868275220064,346.631453159434
192.168.43.233,50958,163.53.78.128,80,12,1132,7,414,5,718,473.553037,16.526692,200.403081269985,347.558967033452
192.168.43.233,50959,163.53.78.128,80,14,1777,8,747,6,1030,476.100936,103.34721,57.8244927947257,79.7312283514959
192.168.43.233,50960,163.53.78.128,80,14,1810,8,758,6,1052,476.103181,103.346594,58.6763410896734,81.4347108526866
192.168.43.233,50963,163.53.78.128,443,218,182907,83,11328,135,171579,480.52574,66.013044,1372.81959001921,20793.3450243561
192.168.43.233,50961,163.53.78.128,443,221,148549,112,7662,109,140887,480.5258,98.837926,620.166797105799,11403.4768394472
192.168.43.233,50962,163.53.78.128,443,31,9354,17,2206,14,7148,480.525801,98.924818,178.398104305838,578.055144867692
192.168.43.233,50964,163.53.78.128,443,7,402,4,228,3,174,480.663299,14.234585,128.138614508256,97.7899952826164
192.168.43.233,50965,182.50.136.239,80,14,3211,7,622,7,2589,484.542379,4.72152700000004,1053.89633480862,4386.71641610857
192.168.43.233,50966,182.50.136.239,80,12,3100,6,552,6,2548,487.900573,4.44960500000002,992.44764422909,4581.08079256471
192.168.43.233,50967,49.44.170.2,443,270,194427,119,11525,151,182902,489.889576,648.86621,142.094007330109,2255.03497862834
192.168.43.233,50968,49.44.170.2,443,85,46840,40,5930,45,40910,489.889924,328.837726,144.265685622701,995.262934034521
192.168.43.233,50969,49.44.170.2,443,145,111594,57,6056,88,105538,489.890122,328.828906,147.334979121331,2567.60882207843
192.168.43.233,50970,49.44.170.2,443,9,534,5,294,4,240,489.891704,14.365642,163.723974187858,133.652223826823
192.168.43.233,50971,49.44.170.2,443,618,512369,256,16855,362,495514,490.014722,328.704112,410.216955241497,12059.8187101474
192.168.43.233,50972,182.50.136.239,80,14,3265,7,610,7,2655,491.979389,2.84326199999998,1716.33848727273,7470.29292411327
192.168.43.233,50973,49.44.170.2,443,15,1648,8,1063,7,585,492.655618,12.776044,665.620750836487,366.310573132027
192.168.43.233,50974,104.244.42.1,443,23,6473,12,1856,11,4617,496.809579,17.212413,862.633263563919,2145.89319928589
192.168.43.233,50975,104.244.42.1,443,9,534,5,294,4,240,496.94343,12.978332,181.225137405947,147.938887678324
192.168.43.233,50976,49.44.170.2,443,103,71009,47,5813,56,65196,502.149775,152.987913,303.971726184669,3409.21050410041
192.168.43.233,50977,49.44.170.2,443,792,611069,336,54314,456,556755,502.151714,658.74664,659.604123369798,6761.38553055846
192.168.43.233,50978,49.44.170.2,443,560,411088,248,41438,312,369650,502.152408,658.746341,503.23467375434,4489.13309409942
192.168.43.233,50979,49.44.170.2,443,594,453016,255,41516,339,411500,502.154315,658.743823,504.183854791151,4997.39031329027
192.168.43.233,50980,49.44.170.2,443,907,716867,367,67246,540,649621,502.15515,658.743479,816.657799507417,7889.21357960038
192.168.43.233,50981,49.44.170.2,443,819,630033,356,55719,463,574314,502.158402,660.751087,674.614100180814,6953.46869705566
192.168.43.233,50982,49.44.170.2,443,14,1555,7,970,7,585,502.159365,13.190838,588.28711261559,354.791712247547
192.168.43.233,50983,74.207.230.33,443,42,20424,20,2970,22,17454,509.044274,75.3156190000001,315.472412169911,1853.95807475206
192.168.43.233,50984,74.207.230.33,443,40,22552,17,2035,23,20517,509.044695,70.308664,231.550410344876,2334.50602901515
192.168.43.233,50985,74.207.230.33,443,28,8266,14,1729,14,6537,509.188128,71.969969,192.191273557447,726.636411362078
192.168.43.233,50986,13.228.177.65,443,24,8073,13,3364,11,4709,509.608935,63.63355,422.921556317383,592.01474693774
192.168.43.233,50987,13.228.177.65,443,5,286,3,174,2,112,509.781871,11.021964,126.293281306308,81.2922270477383
192.168.43.233,50988,49.44.170.2,443,14,1531,7,958,7,573,511.673476,11.049566,693.601902554365,414.857922926567
192.168.43.233,50989,172.217.166.226,443,101,18161,46,6624,55,11537,513.714208,425.420369,124.563852277605,216.952470369372
192.168.43.233,50990,172.217.166.226,443,16,4829,8,1219,8,3610,513.71712,12.464285,782.395460309194,2317.02019008711
192.168.43.233,50991,172.217.166.226,443,17,4883,8,1219,9,3664,513.71795,12.8611050000001,758.255219905284,2279.11987344788
192.168.43.233,50992,157.240.16.39,443,29,3634,14,2056,15,1578,513.719045,67.241462,244.610981242496,187.741307587869
192.168.43.233,50993,172.82.241.224,443,29,9007,14,3542,15,5465,513.805955,32.7324599999999,865.685011147957,1335.67718405522
192.168.43.233,50994,172.82.241.224,443,8,456,4,228,4,228,513.963629,13.807547,132.101668746809,132.101668746809
192.168.43.233,50995,163.53.79.200,443,27,8259,13,1783,14,6476,514.180664,68.3496680000001,208.69157696567,757.984662046931
192.168.43.233,50996,163.53.79.200,443,28,8313,14,1837,14,6476,514.181732,68.348602,215.015370760619,757.996483966124
192.168.43.233,50997,163.53.79.200,443,28,8398,14,1948,14,6450,515.362175,68.507564,227.478530691881,753.201500494164
192.168.43.233,50998,104.237.191.1,443,24,3938,12,2001,12,1937,516.259038,48.5847199999999,329.48630762923,318.948014931444
192.168.43.233,50999,104.244.42.1,443,784,472217,364,99837,420,372380,520.661004,1528.901796,522.398496809667,1948.48355060733
192.168.43.233,51000,192.229.237.96,443,8275,6082936,3883,274452,4392,5808484,520.727161,415.939766,5278.68739532829,111717.791368859
192.168.43.233,51001,104.244.42.195,443,8,456,4,228,4,228,526.584966,22.813936,79.951131624109,79.951131624109
192.168.43.233,51002,104.244.42.195,443,108,13176,53,4878,55,8298,526.68427,1482.563801,26.3219700721669,44.7764878349407
192.168.43.233,51003,104.244.42.200,443,8,456,4,228,4,228,527.398834,21.957495,83.0695851234396,83.0695851234396
192.168.43.233,51004,104.244.42.200,443,108,14440,56,5969,52,8471,527.502925,1481.745043,32.226866710699,45.7352635125367
192.168.43.233,51005,104.244.42.2,443,136,19070,74,9744,62,9326,532.887466,1123.332528,69.3935215592724,66.4166648257158
192.168.43.233,51006,104.244.42.2,443,182,49755,89,10191,93,39564,533.370324,1124.206761,72.5204676117403,281.542516003424
192.168.43.233,51007,117.18.232.102,443,2426,1857711,960,63057,1466,1794654,537.727088,449.76188,1121.60683782272,31921.8516251311
192.168.43.233,51008,117.18.232.102,443,6,348,4,228,2,120,546.539631,24.812949,73.510004796286,38.6894762085716
192.168.43.233,51009,117.18.232.102,443,404,300970,185,13846,219,287124,546.791675,188.559255,587.443984120536,12181.8046003629
192.168.43.233,51010,163.53.78.128,443,68,32896,38,22706,30,10190,565.913026,118.828026,1528.66294353825,686.033444669021
192.168.43.233,51011,163.53.78.128,443,9,535,5,295,4,240,566.071839,77.065518,30.6232938056681,24.9138661469842
192.168.43.233,51012,163.53.78.128,443,57,33480,26,8557,31,24923,689.6984,41.188142,1662.03175661578,4840.81073625511
192.168.43.233,51013,163.53.78.128,443,26,11045,15,3384,11,7661,689.903819,39.299436,688.864847831404,1559.51347495165
192.168.43.233,51014,163.53.78.128,443,51,21685,28,11834,23,9851,691.122287,50.779583,1864.37135570806,1551.96233100221
192.168.43.233,51015,172.82.241.224,443,23,4959,11,3460,12,1499,697.819796,35.939081,770.192203857411,333.675755370595
192.168.43.233,51016,172.82.241.224,443,10,588,6,348,4,240,698.070294,40.6246190000001,68.5298734740133,47.2619817062161
192.168.43.233,51017,157.240.16.39,443,29,4320,15,2796,14,1524,698.791605,71.702351,311.956298336717,170.036265617009
192.168.43.233,51018,157.240.16.39,443,7,402,4,228,3,174,698.817598,40.991993,44.4964947178831,33.9578512320687
192.168.43.233,51019,216.58.221.34,443,23,6170,11,1922,12,4248,698.904937,17.767618,865.394562174852,1912.69308018667
192.168.43.233,51020,216.58.221.34,443,10,588,6,348,4,240,699.156049,39.343448,70.7614645264442,48.8010100182374
192.168.43.233,51021,49.44.170.2,443,347,278780,140,18681,207,260099,704.113622,456.784876,327.173704411352,4555.29968115669
192.168.43.233,51022,117.18.232.102,443,2185,1817126,914,55936,1271,1761190,736.509555,243.158615,1840.31316348796,57943.7417835268
192.168.43.233,51023,117.18.232.102,443,7,402,4,228,3,174,736.760704,43.575961,41.85794089544,31.9442180517832
192.168.43.233,51024,163.53.78.128,443,43,24004,19,3011,24,20993,779.219319,39.5580809999999,608.927414856147,4245.50422453507
192.168.43.233,51025,163.53.78.128,443,9,534,5,294,4,240,779.329341,39.458296,59.6072369673541,48.6589689529421
192.168.43.233,51026,52.114.75.78,443,25,9572,12,4305,13,5267,803.790098,8.35881900000004,4120.19927695525,5040.90350562679
192.168.43.233,51027,52.138.216.83,443,28,7649,15,2601,13,5048,805.733646,3.76145699999995,5531.8989423514,10736.2652291387
192.168.43.233,51028,52.114.6.46,443,19,7839,10,3146,9,4693,809.180327,1.66705200000001,15097.309502043,22521.1931001551
192.168.43.233,51029,163.53.78.128,443,247,173507,108,44895,139,128612,818.539477,69.152964,5193.70362780112,14878.5524218456
192.168.43.233,51030,163.53.78.128,443,21,7547,11,1261,10,6286,819.412809,18.886222,534.1460033669,2662.6818217005
192.168.43.233,51031,157.240.16.39,443,42,5651,22,3369,20,2282,819.70699,88.633428,304.083917413191,205.971949996112
192.168.43.233,51032,13.228.138.206,443,16,4676,8,1087,8,3589,819.707711,18.621316,466.991699190326,1541.88887616751
192.168.43.233,51033,172.82.241.224,443,14,1541,7,968,7,573,819.736083,18.772667,412.514641632967,244.184803363316
192.168.43.233,51034,163.53.79.200,443,16,6873,9,1173,7,5700,819.938648,18.2110240000001,515.292275711677,2503.97781036365
192.168.43.233,51035,13.228.138.206,443,7,395,4,229,3,166,819.958313,48.3755600000001,37.8703626376624,27.45187859324
192.168.43.233,51036,172.82.241.224,443,10,564,7,390,3,174,819.987561,55.739914,55.9742521310672,24.9731278738607
192.168.43.233,51037,163.53.79.200,443,17,6927,9,1173,8,5754,820.077337,18.221695,514.990509938841,2526.21943238541
192.168.43.233,51038,163.53.79.200,443,16,6873,9,1173,7,5700,820.077811,18.072297,519.247774646464,2523.19890493167
192.168.43.233,51039,49.44.170.2,443,52,22203,24,3436,28,18767,820.532228,318.495097,86.3058811859826,471.391872007373
192.168.43.233,51040,49.44.170.2,443,44,16148,20,2443,24,13705,820.549452,318.477874,61.3669004836424,344.262534231813
192.168.43.233,51041,172.82.241.224,443,38,14564,18,8822,20,5742,821.877524,65.6873870000001,1074.42240014814,699.312335258517
192.168.43.233,51042,172.82.241.224,443,10,564,7,390,3,174,822.128561,52.687997,59.2165232624045,26.4196796093805
192.168.43.233,51043,104.237.191.1,443,29,4210,14,2099,15,2111,868.182225,92.4680579999999,181.597844306409,182.636040653087
192.168.43.233,51044,104.237.191.1,443,7,426,4,240,3,186,868.433396,19.49379,98.4929046634852,76.332001114201
192.168.43.233,51045,23.213.64.67,443,309,214316,129,16874,180,197442,887.655007,241.199072,559.670478334179,6548.68191201001
192.168.43.233,51046,23.213.64.67,443,23,9425,9,1141,14,8284,887.655674,0.294518000000039,30993.0123116373,225018.504811221
192.168.43.233,51047,162.212.45.11,80,11,1065,6,642,5,423,887.868983,3.36686300000008,1525.45559471825,1005.08990119287
192.168.43.233,51048,162.212.45.11,80,13,1293,7,697,6,596,887.868983,3.36692600000003,1656.11005409681,1416.12853980157
192.168.43.233,51049,162.212.45.11,443,35,11463,19,2059,16,9404,888.496466,113.830647,144.706196741551,660.911643592784
192.168.43.233,51050,162.212.45.11,443,35,11430,19,2037,16,9393,888.508035,113.80067,143.1977509447,660.312456859876
192.168.43.233,51051,117.18.237.29,80,17,1968,9,736,8,1232,889.384852,136.517631,43.1299602613233,72.1958030461281
192.168.43.233,51052,49.44.170.52,443,28,9741,14,1423,14,8318,889.510401,18.397824,618.768828313609,3616.94948272143
192.168.43.233,51053,49.44.170.52,443,6965,5931180,2797,187358,4168,5743822,889.510646,333.858251,4489.52211158621,137634.986891488
192.168.43.233,51054,49.44.170.52,443,33,10054,16,1543,17,8511,889.510825,18.3974020000001,670.96430245966,3700.95734169421
192.168.43.233,51055,49.44.170.52,443,24,9479,10,1195,14,8284,889.529212,0.419796000000019,22772.9659167776,157867.154522666
192.168.43.233,51057,23.213.64.67,443,64,36287,33,2757,31,33530,891.087707,107.299108,205.556228855137,2499.92758560491
192.168.43.233,51056,23.213.64.67,443,32,11652,18,1969,14,9683,891.087759,107.299227,146.804412672982,721.943691169369
192.168.43.233,51058,49.44.178.225,443,5,294,3,174,2,120,891.893057,16.015168,86.9176021131966,59.9431738711701
192.168.43.233,51059,49.44.178.225,443,37,12463,18,2024,19,10439,891.903149,323.490401,50.0540354518896,258.159128499148
192.168.43.233,51060,49.44.148.176,443,163,86160,75,18704,88,67456,891.997105,236.862408,631.725402369463,2278.31847424265
192.168.43.233,51061,49.44.148.176,443,6,348,3,174,3,174,892.199776,15.708451,88.6147208276617,88.6147208276617
192.168.43.233,51062,49.44.170.52,443,310,227067,136,10861,174,216206,895.933879,169.199955,513.522595204,10222.5086289178
192.168.43.233,51063,49.44.170.52,443,34,11271,17,2480,17,8791,896.185021,14.237374,1393.51540529875,4939.67497096022
192.168.43.233,51064,49.44.170.52,443,29,10392,14,2054,15,8338,896.250189,19.479191,843.566860656584,3424.37219286981
192.168.43.233,51065,49.44.170.52,443,5,294,3,174,2,120,896.290838,11.61739,119.820372734323,82.6347398167747
192.168.43.233,51066,52.70.107.220,443,44,18640,25,10310,19,8330,898.100426,108.49279,760.234850629245,614.234365251368
192.168.43.233,51067,52.70.107.220,443,35,14249,19,6311,16,7938,898.100746,108.492654,465.358696082778,585.329952385532
192.168.43.233,51068,49.44.148.176,443,58,15020,28,5346,30,9674,898.139559,537.303721,79.5974387082274,144.037714564795
192.168.43.233,51069,49.44.148.176,443,9,534,5,294,4,240,898.144542,18.594247,126.490736624075,103.257744182919
192.168.43.233,51070,52.70.107.220,443,9,534,5,294,4,240,898.244145,18.704303,125.746465933534,102.650176272273
192.168.43.233,51071,157.240.16.20,443,78,40753,35,3438,43,37315,907.909136,68.8124290000001,399.695235289543,4338.16978034593
192.168.43.233,51072,157.240.16.20,443,7,402,4,228,3,174,908.077886,11.339972,160.846957999544,122.751625841757
192.168.43.233,51073,172.217.166.206,443,20,6711,10,1351,10,5360,909.146479,13.979317,773.142207162193,3067.38877156873
192.168.43.233,51074,172.217.166.206,443,9,534,5,294,4,240,909.39765,11.860617,198.303342903661,161.880279921356
192.168.43.233,51075,151.101.154.110,443,83,26118,40,3175,43,22943,915.730526,601.607029,42.2202513860589,305.089520488299
192.168.43.233,51076,23.37.48.123,443,32,7337,17,2020,15,5317,916.230017,319.888369,50.5176229148863,132.971386652698
192.168.43.233,51077,182.161.72.131,443,24,13138,10,1816,14,11322,916.246116,15.907569,913.275938014164,5693.89326552663
192.168.43.233,51078,52.84.110.220,443,71,29245,34,3186,37,26059,916.256396,211.333966,120.605317178404,986.457614674208
192.168.43.233,51079,52.84.109.10,443,53,27758,24,2765,29,24993,916.257041,159.943195,138.299100502525,1250.09382237237
192.168.43.233,51080,119.161.10.150,443,91,17394,44,3424,47,13970,916.283529,1201.443161,22.7992475126337,93.0214625442443
192.168.43.233,51081,185.167.164.39,443,96,49077,48,4962,48,44115,916.286696,186.080864,213.326610521327,1896.5948051488
192.168.43.233,51082,13.107.21.200,443,58,20689,26,3587,32,17102,916.293738,153.093155,187.441430676636,893.678100761591
192.168.43.233,51083,162.251.148.163,443,50,27860,26,6480,24,21380,916.294239,134.348217,385.862954921091,1273.10956423039
192.168.43.233,51084,182.22.24.124,443,49,15335,22,3099,27,12236,916.370517,125.055857,198.247411954484,782.754221579562
192.168.43.233,51085,23.37.48.123,443,5,294,3,174,2,120,916.410884,10.54811,131.966769402292,91.0115651050287
192.168.43.233,51086,182.161.72.131,443,4,240,2,120,2,120,916.41173,10.749818,89.3038375161328,89.3038375161328
192.168.43.233,51087,185.167.164.39,443,7,398,4,228,3,170,916.42217,12.1792819999999,149.762522946756,111.665039039248
192.168.43.233,51088,162.251.148.163,443,7,402,4,228,3,174,916.432265,12.061242,151.22820684636,115.410999961696
192.168.43.233,51089,182.22.24.124,443,5,294,3,174,2,120,916.563708,11.074883,125.689815413851,86.6826313198975
192.168.43.233,51090,182.22.24.124,443,19,7348,9,1267,10,6081,916.663495,1.61001999999996,6295.57396802539,30215.7737170974
192.168.43.233,51091,93.158.134.119,443,62,25884,32,12703,30,13181,916.719278,159.678733,636.427895504407,660.375981314932
192.168.43.233,51092,182.22.24.124,443,5,294,3,174,2,120,916.767483,10.900134,127.704852068791,88.0723117715802
192.168.43.233,51093,93.158.134.119,443,7,402,4,228,3,174,916.793904,11.3671890000001,160.461834495757,122.457715799394
192.168.43.233,51094,104.27.133.43,443,72,23211,31,2637,41,20574,916.815142,401.129244,52.591528330455,410.321616940001
192.168.43.233,51095,117.18.237.116,443,103,38659,49,4212,54,34447,916.873186,185.494375,181.655104096822,1485.62995508624
192.168.43.233,51096,157.240.16.39,443,68,16533,34,12861,34,3672,917.090806,157.344666,653.902052199215,186.698416583121
192.168.43.233,51097,49.44.178.209,443,37,10540,18,3671,19,6869,917.131147,318.987151,92.0664042671737,172.270261757346
192.168.43.233,51098,162.247.242.20,443,57,17996,29,12188,28,5808,917.908994,401.050404,243.121560351302,115.855761611451
192.168.43.233,51099,162.247.242.20,443,4,236,2,120,2,116,918.15014,11.127931,86.2694062355348,83.393759361017
192.168.43.233,51100,106.10.193.30,443,37,9274,18,2801,19,6473,918.448066,119.02521,188.26263780589,435.067495365058
192.168.43.233,51101,106.10.193.30,443,5,294,3,174,2,120,918.486364,20.7196220000001,67.1826928116736,46.3328915942577
192.168.43.233,51102,144.2.1.5,443,47,8815,22,2969,25,5846,918.709585,118.57955,200.304352647653,394.401901508312
192.168.43.233,51103,52.84.102.201,443,36,13513,18,2487,18,11026,918.755229,157.445008,126.367931589168,560.246406796206
192.168.43.233,51104,34.224.183.150,443,40,8451,18,3203,22,5248,918.816504,92.222388,277.850102948971,455.247374422792
192.168.43.233,51105,144.2.1.5,443,6,348,3,174,3,174,918.869456,20.288485,68.6103471994088,68.6103471994088
192.168.43.233,51106,182.161.72.82,443,15,6791,7,2566,8,4225,918.899967,18.333156,1119.71992165451,1843.65419680059
192.168.43.233,51107,52.84.102.201,443,10,588,5,294,5,294,918.920401,21.394865,109.932920820019,109.932920820019
192.168.43.233,51108,182.161.72.82,443,4,240,2,120,2,120,918.936565,10.731706,89.454556433059,89.454556433059
192.168.43.233,51109,52.84.110.8,443,50,16170,24,2548,26,13622,918.93895,208.660079,97.6899850593846,522.265689355941
192.168.43.233,51110,52.84.110.8,443,9,534,5,294,4,240,918.970648,21.344336,110.193167873669,89.953606427485
192.168.43.233,51111,34.224.183.150,443,7,402,4,228,3,174,918.992692,21.1251659999999,86.3425167877974,65.8929733380559
192.168.43.233,51112,144.2.1.1,443,38,8842,18,2466,20,6376,919.637703,117.686626,167.631621965269,433.422231001847
192.168.43.233,51113,144.2.1.1,443,5,294,3,174,2,120,919.721617,19.4427089999999,71.5949613811535,49.3758354352783
192.168.43.233,51114,13.126.200.177,443,30,9422,14,1936,16,7486,919.859116,60.74675,254.960141900595,985.863441254059
192.168.43.233,51115,34.251.148.205,443,45,10274,21,2516,24,7758,919.859422,91.089055,220.970565563557,681.355185867281
192.168.43.233,51116,13.126.200.177,443,7,402,4,228,3,174,919.971804,19.61628,92.9839908484179,70.9614667001084
192.168.43.233,51117,34.251.148.205,443,7,402,4,228,3,174,919.973489,19.938751,91.4801533957668,69.8138012757167
192.168.43.233,51118,49.44.136.233,443,72,43162,35,3077,37,40085,920.136311,70.637276,348.484559342294,4539.8126620851
192.168.43.233,51119,49.44.170.41,443,35,10665,17,2283,18,8382,920.25671,315.915787,57.8128753027464,212.259098023487
192.168.43.233,51120,13.228.37.108,443,31,9908,16,2872,15,7036,920.276529,88.111118,260.761644177526,638.829710457198
192.168.43.233,51121,52.216.17.48,443,38,8462,18,2234,20,6228,920.277169,17.2023740000001,1038.92637144152,2896.34442315926
192.168.43.233,51122,52.216.17.48,443,36,7193,17,2168,19,5025,920.277522,17.189943,1008.96204251521,2338.57668987035
192.168.43.233,51123,13.228.37.108,443,7,402,4,228,3,174,920.394594,19.5142060000001,93.4703671776343,71.332648635563
192.168.43.233,51124,52.216.17.48,443,7,409,4,228,3,181,920.420011,18.9382589999999,96.3129715355572,76.4589817891923
192.168.43.233,51125,182.161.72.84,443,18,7283,8,1996,10,5287,921.259968,13.467665,1185.65467733271,3140.5592580451
192.168.43.233,51126,35.186.193.174,443,234,174184,96,7772,138,166412,921.267914,241.464452,257.495459414457,5513.42439424583
192.168.43.233,51127,182.161.72.84,443,4,240,2,120,2,120,921.387231,11.4183069999999,84.0755113695933,84.0755113695933
192.168.43.233,51128,151.101.154.2,443,64,14061,31,4196,33,9865,922.176004,601.725766,55.7862100922566,131.156092125861
192.168.43.233,51129,192.82.211.131,443,26,8082,13,2947,13,5135,922.206902,15.283248,1542.60403286004,2687.91031853963
192.168.43.233,51130,192.82.211.131,443,7,402,4,228,3,174,922.379116,17.032858,107.087137108757,81.7243941093149
192.168.43.233,51131,52.84.110.163,443,40,9290,19,2724,21,6566,922.415819,182.572261,119.360958124959,287.710738270366
192.168.43.233,51132,52.84.110.163,443,9,534,5,294,4,240,922.507129,17.8081000000001,132.074730038577,107.816106153941
192.168.43.233,51133,34.231.96.113,443,28,8734,14,2294,14,6440,923.789046,84.879549,216.212270402144,606.977777414911
192.168.43.233,51134,34.231.96.113,443,7,402,4,228,3,174,923.87922,16.792344,108.620928680356,82.8949192560612
192.168.43.233,51135,52.220.119.167,443,30,10192,15,3165,15,7027,924.502536,83.8851120000001,301.841404229155,670.154675361225
192.168.43.233,51136,52.220.119.167,443,5,286,3,174,2,112,924.634559,14.5527530000001,95.6520048131096,61.5691065463694
192.168.43.233,51137,52.68.47.152,443,7,402,4,228,3,174,925.499328,14.353152,127.080100593932,96.9821820322113
192.168.43.233,51138,210.176.156.55,443,5,294,3,174,2,120,925.504186,13.92416,99.9701238710268,68.9449130145013
192.168.43.233,51139,52.68.47.152,443,32,7724,17,2680,15,5044,925.506523,111.500036,192.286933432022,361.901228444447
192.168.43.233,51140,210.176.156.55,443,34,8903,18,4460,16,4443,925.507651,354.338444,100.694690638761,100.310876795519
192.168.43.233,51141,103.243.221.75,443,22,7382,11,2278,11,5104,925.509806,11.9803459999999,1521.15807005909,3408.24881017628
192.168.43.233,51142,103.243.221.75,443,5,286,3,174,2,112,925.521805,13.89017,100.214756190889,64.5060499619514
192.168.43.233,51143,104.198.94.254,443,8,468,5,294,3,174,925.525632,14.271037,164.809326750397,97.5402137910512
192.168.43.233,51144,104.198.94.254,443,25,9030,13,1867,12,7163,925.538683,11.857488,1259.6259848629,4832.7267967718
192.168.43.233,51145,52.29.202.17,443,43,9622,21,2571,22,7051,925.54161,88.92373,231.299339332707,634.341361973908
192.168.43.233,51146,52.29.202.17,443,7,402,4,228,3,174,925.561576,14.235221,128.132889542073,97.7856262294767
192.168.43.233,51147,173.241.248.143,443,39,6465,20,2251,19,4214,925.765356,89.5031290000001,201.199669790315,376.657222788267
192.168.43.233,51148,173.241.248.143,443,7,402,4,228,3,174,925.827842,14.740285,123.742519225375,94.4350804614702
192.168.43.233,51149,182.161.72.94,443,19,6329,9,2391,10,3938,925.908001,17.998833,1062.73556735595,1750.33570232026
192.168.43.233,51150,182.161.72.94,443,4,240,2,120,2,120,926.019346,10.728075,89.4848330199035,89.4848330199035
192.168.43.233,51151,103.243.221.51,443,20,6572,10,2147,10,4425,926.762976,12.4644440000001,1377.9996925655,2840.07854662429
192.168.43.233,51152,103.243.221.51,443,7,402,4,228,3,174,926.955361,13.077951,139.471389669529,106.438692116219
192.168.43.233,51153,35.171.204.130,443,27,9415,14,3124,13,6291,927.390584,81.278011,307.487839484655,619.20806600447
192.168.43.233,51154,35.171.204.130,443,7,402,4,228,3,174,927.579131,12.378277,147.354918620742,112.455069473724
192.168.43.233,51155,182.161.72.82,443,16,6189,7,1910,9,4279,947.192849,13.15406,1161.61854210792,2602.39044067004
192.168.43.233,51156,182.161.72.82,443,4,240,2,120,2,120,947.444716,10.960098,87.5904576765644,87.5904576765644
192.168.43.233,51157,182.161.72.84,443,19,7353,8,2012,11,5341,949.155098,12.7700160000001,1260.45261023948,3345.96291813572
192.168.43.233,51158,182.161.72.84,443,4,240,2,120,2,120,949.407217,10.6400960000001,90.2247498518803,90.2247498518803
192.168.43.233,51159,103.243.221.75,443,19,4307,10,2149,9,2158,951.151605,57.524052,298.866289878189,300.117940231331
192.168.43.233,51160,104.198.94.254,443,18,2617,10,1630,8,987,951.153629,57.448802,226.984715886678,137.444119374326
192.168.43.233,51161,182.161.72.94,443,18,3501,8,2070,10,1431,951.400765,16.4335140000001,1007.69683221738,696.625201402449
192.168.43.233,51162,103.243.221.75,443,11,611,6,337,5,274,951.403534,61.7037879999999,43.6926173803139,35.524561312184
192.168.43.233,51163,182.161.72.94,443,4,240,2,120,2,120,951.652827,10.912301,87.9741128841666,87.9741128841666
192.168.43.233,51164,103.243.221.51,443,17,3495,9,2018,8,1477,952.115664,56.571797,285.371878853345,208.86732659385
192.168.43.233,51165,103.243.221.51,443,11,611,6,337,5,274,952.367276,60.7401070000001,44.3858289548288,36.0881814054097
192.168.43.233,51166,52.70.107.220,443,14,1548,7,970,7,578,1010.006533,27.158044,285.734863674276,170.26263010694
192.168.43.233,51167,52.70.107.220,443,9,534,5,294,4,240,1010.231748,27.884617,84.3475813205538,68.8551684249419
192.168.43.233,51168,184.50.104.173,443,151,96771,76,5533,75,91238,1011.671135,74.6740339999999,592.762940863755,9774.53555006819
192.168.43.233,51169,184.50.104.173,443,11,666,6,360,5,306,1011.732344,26.2960330000001,109.522223371107,93.0938898654406
192.168.43.233,51170,151.101.153.170,443,496,283598,241,21104,255,262494,1036.998074,647.670312,260.675835949078,3242.31628514107
192.168.43.233,51171,151.101.153.176,443,17,8346,9,1108,8,7238,1036.998999,13.6437040000001,649.676949895714,4244.00881168337
192.168.43.233,51172,151.101.153.176,443,411,200102,193,15377,218,184725,1036.999289,756.435241,162.625950421577,1953.63716535253
192.168.43.233,51173,151.101.153.176,443,9,534,5,294,4,240,1037.105888,15.6596070000001,150.195340151256,122.608440939801
192.168.43.233,51174,151.101.153.170,443,9,534,5,294,4,240,1037.249056,15.5163829999999,151.581718497153,123.740178365023
192.168.43.233,51175,151.101.153.170,443,25,8620,12,1880,13,6740,1038.721042,12.477212,1205.39748783622,4321.47822766817
192.168.43.233,51176,151.101.153.170,443,9,534,5,294,4,240,1038.972768,13.7925659999999,170.526644570708,139.205424139353
192.168.43.233,51177,172.217.166.206,443,46,8325,21,2299,25,6026,1042.629572,242.379613,75.8809694114002,198.894615777772
192.168.43.233,51178,172.217.166.206,443,8,480,4,240,4,240,1042.663352,33.5368859999999,57.2503958775423,57.2503958775423
192.168.43.233,51179,151.101.153.170,443,24,8796,12,1892,12,6904,1050.643432,24.9382869999999,606.938239182187,2214.74714762887
192.168.43.233,51180,151.101.153.170,443,9,534,5,294,4,240,1050.893968,26.3611799999999,89.2221061424417,72.8343723611769
192.168.43.233,51181,52.70.107.220,443,27,5767,14,4623,13,1144,1051.049041,87.8221000000001,421.124067859912,104.210671345823
192.168.43.233,51182,52.70.107.220,443,9,534,5,294,4,240,1051.300242,26.28766,89.471638023316,73.0380718557682
192.168.43.233,51183,63.215.202.75,443,51,13252,25,3346,26,9906,1052.118287,385.439317,69.4480267564401,205.604349387118
192.168.43.233,51184,63.215.202.75,443,7,394,4,228,3,166,1052.226674,25.361318,71.9205523940042,52.3632091991434
192.168.43.233,51185,49.44.170.52,443,102,66300,47,3659,55,62641,1076.200942,72.829031,401.927632402524,6880.8824327211
192.168.43.233,51186,49.44.170.52,443,12,720,6,360,6,360,1076.335789,27.427216,105.005189006423,105.005189006423
192.168.43.233,51187,151.101.153.170,443,19,7662,9,1108,10,6554,1082.055097,20.7064800000001,428.078553187214,2532.15418554964
192.168.43.233,51188,151.101.153.170,443,9,534,5,294,4,240,1082.306744,21.4561880000001,109.618726308699,89.4846745377133
192.168.43.233,51189,192.229.237.96,443,23,6188,11,1249,12,4939,1102.278821,36.4769729999998,273.926238342202,1083.20391607056
192.168.43.233,51190,192.229.237.96,443,23,6188,11,1249,12,4939,1102.279523,36.4762720000001,273.931502649173,1083.22473305386
192.168.43.233,51191,192.229.237.96,443,7,402,4,228,3,174,1102.529714,35.834803,50.9002379614031,38.8449184442287
192.168.43.233,51192,192.229.237.96,443,7,402,4,228,3,174,1102.53017,35.870891,50.849029649138,38.8058384164474
192.168.43.233,51193,104.24.19.71,443,26,8829,14,1417,12,7412,1139.297473,21.3581589999999,530.757356006202,2776.26924680167
192.168.43.233,51194,104.24.19.71,443,24713,21008789,9793,604271,14920,20404518,1139.297734,1139.903097,4240.85872976622,143201.772527512
192.168.43.233,51195,104.24.19.71,443,9,534,5,294,4,240,1139.36505,21.5327499999999,109.228965180946,89.1665021885274
192.168.43.233,51196,157.240.16.20,443,423,314947,191,14001,232,300946,1142.783065,89.2720039999999,1254.68226298583,26968.9028152656
192.168.43.233,51197,157.240.16.39,443,9,511,5,283,4,228,1160.898727,55.396857,40.8687445932177,32.9260557146771
192.168.43.233,51198,157.240.16.39,443,131,65483,65,10784,66,54699,1160.906813,109.110038,790.688020840026,4010.55675555717
192.168.43.233,51199,172.217.161.14,443,49,9770,25,3273,24,6497,1162.532042,241.289159,108.517100844966,215.409594925067
192.168.43.233,51200,172.217.166.197,443,1611,1024449,687,84830,924,939619,1215.324121,481.59344,1409.15540710023,15608.5016440423
192.168.43.233,51201,104.237.191.1,443,23,4108,12,2225,11,1883,1235.898817,46.7965039999999,380.37029432797,321.904388413289
192.168.43.233,51202,104.237.191.1,443,7,426,4,240,3,186,1236.149789,42.4041769999999,45.2785582891988,35.0908826741291
192.168.43.233,51203,104.121.28.119,443,21,8944,10,1008,11,7936,1240.259964,61.455371,131.217172214289,1033.07487965535
192.168.43.233,51204,13.107.3.128,443,43,11147,22,3087,21,8060,1240.277131,6.51626399999986,3789.90169827381,9895.24058571005
192.168.43.233,51205,52.175.28.154,443,26,9352,15,2612,11,6740,1240.282949,2.012021,10385.5774865173,26798.9250609213
192.168.43.233,51206,52.175.28.154,443,5,294,3,174,2,120,1240.28393,0.63120200000003,2205.31620622231,1520.90772842918
192.168.43.233,51207,52.175.28.154,443,27,10232,16,3524,11,6708,1240.285259,2.10866800000008,13369.5773824988,25449.2409426225
192.168.43.233,51208,131.253.61.84,443,95,37944,40,10113,55,27831,1240.517742,66.2769169999999,1220.6964907556,3359.35963949561
192.168.43.233,51209,52.175.28.154,443,40,18438,23,8225,17,10213,1242.273385,127.36359,516.631165939968,641.502017962905
192.168.43.233,51210,52.114.14.1,443,15,6232,8,1637,7,4595,1242.695224,123.921804,105.679546111191,296.638677080589
192.168.43.233,51211,52.114.14.1,443,3,198,1,66,2,132,1242.871823,3.14301599999999,167.991508792829,335.983017585658
192.168.43.233,51212,52.114.128.10,443,28,13540,16,8227,12,5313,1245.046275,126.690621,519.501755382508,335.494448322264
192.168.43.233,51213,52.114.128.10,443,5,294,3,174,2,120,1245.197173,0.846637999999984,1644.15015626516,1133.89665949322
192.168.43.233,51214,13.107.3.128,443,66,16471,34,5510,32,10961,1246.483261,128.023667,344.311337371707,684.935856430359
192.168.43.233,51215,52.175.28.154,443,35,15292,20,6478,15,8814,1247.203871,124.778144,415.329146104305,565.098964767419
192.168.43.233,51216,40.114.211.99,443,22,9095,12,2138,10,6957,1247.271051,123.189263,138.843269157313,451.792620920218
192.168.43.233,51217,52.175.28.154,443,58,30362,34,16479,24,13883,1247.383657,121.890639,1081.55967580086,911.177436685684
192.168.43.233,51218,52.175.28.154,443,26,11235,14,3072,12,8163,1247.39046,126.012768,195.027856224855,518.233199988116
192.168.43.233,51219,157.240.16.20,443,13,1742,7,971,6,771,1278.145655,13.259033,585.864745943386,465.192295697581
192.168.43.233,51220,157.240.16.39,443,50,19731,23,4283,27,15448,1282.594325,67.4770779999999,507.787251842767,1831.49602299021
192.168.43.233,51221,157.240.16.39,443,7,402,4,228,3,174,1282.594582,36.345724,50.1847204914669,38.2988656382247
192.168.43.233,51222,157.240.16.20,443,16,4975,8,1025,8,3950,1291.271391,27.430562,298.936638629569,1151.99972935297
192.168.43.233,51223,13.32.226.189,443,143,87280,72,6188,71,81092,1292.963048,191.209318,258.89951660201,3392.80536526991
192.168.43.233,51224,13.32.226.189,443,9,534,5,294,4,240,1292.963259,27.1199009999998,86.7259803050172,70.7967186163406
192.168.43.233,51225,13.32.226.189,443,23,9354,12,1441,11,7913,1293.023742,25.575159,450.749885856037,2475.21432809079
192.168.43.233,51226,117.18.237.29,80,11,1756,6,686,5,1070,1301.177559,60.831488,90.2164352777298,140.716597299083
192.168.43.233,51227,49.44.168.241,443,42,7310,21,1788,21,5522,1304.717976,500.664827,28.5700117695705,88.2346784069175
192.168.43.233,51228,23.213.64.243,443,45,8603,22,1923,23,6680,1305.501577,502.238945,30.6308384747025,106.403536667193
192.168.43.233,51229,157.240.16.16,443,38,7375,22,2491,16,4884,1318.663081,75.4117000000001,264.256076974793,518.115889178999
192.168.43.233,51230,172.217.166.195,443,144,88741,66,6098,78,82643,1435.634442,241.124151,202.319012001415,2741.92359934945
192.168.43.233,51231,172.217.166.195,443,21,7284,10,1856,11,5428,1435.63498,0.842435000000023,17625.0986723006,51545.8165911896
192.168.43.233,51232,172.217.166.197,443,46,7034,22,3542,24,3492,1468.463045,240.324033,117.907475362649,116.243055891127
192.168.43.233,51233,23.66.249.177,80,16,5699,7,603,9,5096,1501.528526,18.309426,263.470848294206,2226.61267480477
192.168.43.233,51234,188.138.1.175,843,11,923,6,359,5,564,1537.235113,0.684878000000026,4193.44759212574,6588.03465726718
192.168.43.233,51235,188.138.1.175,2004,674,89573,323,31585,351,57988,1537.699694,358.655149,704.520765154273,1293.45417539231
192.168.43.233,51236,188.138.1.175,2004,1324,119982,796,63905,528,56077,1537.727597,359.160436,1423.43072553793,1249.06853604555
192.168.43.233,51237,52.44.247.95,443,40,13496,20,5659,20,7837,1538.242736,208.478532,217.154253561225,300.731204304527
192.168.43.233,51238,52.44.247.95,443,9,523,5,283,4,240,1538.428609,55.163065,41.0419544309222,34.8058977506054
192.168.43.233,51239,54.152.236.192,443,26,8279,13,1963,13,6316,1539.733698,157.891027,99.4610035692529,320.018185707285
192.168.43.233,51240,54.152.236.192,443,9,523,5,283,4,240,1539.911183,53.8734480000001,42.0244124712418,35.6390777141273
192.168.43.233,51241,157.240.16.16,443,29,4278,14,2157,15,2121,1592.791527,65.505721,263.427373007619,259.030810453945
192.168.43.233,51242,157.240.16.16,443,20,5233,9,1081,11,4152,1593.010864,110.437435,78.3067806672621,300.767579399142
192.168.43.233,51243,157.240.16.20,443,42,13013,20,2362,22,10651,1593.383316,66.1107240000001,285.823522368322,1288.86805111981
192.168.43.233,51244,157.240.16.20,443,22,5883,10,1147,12,4736,1593.383555,110.662485,82.9187958322099,342.37438279106
192.168.43.233,51245,157.240.16.20,443,9,512,5,284,4,228,1593.535683,105.483916,21.5388287253196,17.2917357372284
192.168.43.233,51246,172.217.166.195,443,45,6947,21,2205,24,4742,1728.75689,241.708957,72.9803322927748,156.949086499927
192.168.43.233,51247,172.217.166.195,443,7,403,4,229,3,174,1728.837496,55.4660509999999,33.0292127701683,25.0964324105209
192.168.43.233,51248,157.240.16.16,443,26,3764,13,2024,13,1740,1853.686666,65.5078939999999,247.176317406877,212.493474450576
192.168.43.233,51249,157.240.16.20,443,30,5068,14,1829,16,3239,1854.221848,65.9468030000001,221.87580495752,392.922762305854
192.168.43.233,51250,151.101.153.170,443,13,1479,7,958,6,521,1931.071412,14.4013660000001,532.171739819679,289.416990027195
192.168.43.233,51251,151.101.153.176,443,86,20026,41,4074,45,15952,1931.074461,604.342257,53.9297055972705,211.165111361723
192.168.43.233,51252,151.101.153.176,443,12,1425,6,904,6,521,1931.293425,14.188811,509.697394658369,293.752591390498
192.168.43.233,51253,151.101.153.170,443,19,7662,9,1108,10,6554,1931.63171,13.8408469999999,640.423234213921,3788.20747025093
192.168.43.233,51254,163.53.78.128,80,8,668,5,282,3,386,1939.520134,10.899146,206.988694343576,283.324950413547
192.168.43.233,51255,163.53.78.128,80,8,668,5,282,3,386,1939.520364,10.897246,207.024784060119,283.374349812788
192.168.43.233,51256,163.53.78.128,443,365,291501,145,45421,220,246080,1939.848715,75.3983939999998,4819.30689399035,26109.839952294
192.168.43.233,51257,157.240.16.39,443,43,7610,22,5176,21,2434,1945.962284,99.577354,415.837520647516,195.546469330768
192.168.43.233,51258,172.82.241.224,443,23,5503,11,3366,12,2137,1946.042043,43.6860730000001,616.397816301775,391.337532215358
192.168.43.233,51259,172.82.241.224,443,8,456,4,228,4,228,1946.207676,25.3857069999999,71.8514556242222,71.8514556242222
192.168.43.233,51260,163.53.79.200,443,28,8401,14,1951,14,6450,1946.821973,68.4251359999998,228.10330987139,754.108840938221
192.168.43.233,51261,49.44.170.2,443,150,87979,63,17206,87,70773,1950.263864,333.901068,412.241868001452,1695.66393839747
192.168.43.233,51262,49.44.170.2,443,161,96295,66,16379,95,79916,1950.280278,333.918655,392.406947135074,1914.62199079593
192.168.43.233,51263,49.44.170.2,443,122,65169,53,15649,69,49520,1950.280804,333.884127,374.956429120693,1186.5194178578
192.168.43.233,51264,49.44.170.2,443,98,51934,44,11674,54,40260,1950.531862,333.667075,279.895761366326,965.273543995913
192.168.43.233,51265,49.44.170.2,443,104,60174,47,11230,57,48944,1950.534243,333.664693,269.252341901215,1173.48945877231
192.168.43.233,51266,49.44.170.2,443,113,65474,50,12539,63,52935,1950.558365,333.640569,300.658880605134,1269.27010485946
192.168.43.233,51267,163.53.78.128,443,36,13966,19,7036,17,6930,1969.314409,45.932701,1225.44502662711,1206.98323401448
192.168.43.233,51268,49.44.170.2,443,14,1594,7,1009,7,585,1969.340699,20.4530639999998,394.659694997291,228.816572421621
192.168.43.233,51269,49.44.170.2,443,9,534,5,294,4,240,1969.592998,21.4892219999999,109.450216485269,89.3471154981789
192.168.43.233,51270,172.82.241.224,443,36,10839,18,8840,18,1999,1975.041489,40.8877179999999,1729.61474641358,391.119895710492
192.168.43.233,51271,172.82.241.224,443,8,456,4,228,4,228,1975.292472,16.966095,107.508533931939,107.508533931939
192.168.43.233,51272,151.101.193.181,443,788,415061,324,27899,464,387162,1989.879136,1067.462174,209.086565722187,2901.5510576771
192.168.43.233,51273,151.101.152.188,443,18428,13306768,8827,595021,9601,12711747,1989.920233,1052.729344,4521.73963529224,96600.3052727672
192.168.43.233,51274,34.225.100.237,443,21,7744,10,1195,11,6549,1989.938024,13.557871,705.125458119495,3864.32353575278
192.168.43.233,51275,151.139.105.14,443,17,4921,9,1153,8,3768,1990.058171,11.6225370000002,793.630512856173,2593.58176274246
192.168.43.233,51276,34.225.100.237,443,10,564,5,282,5,282,1990.189913,16.887739,133.588042780623,133.588042780623
192.168.43.233,51277,34.225.100.237,443,185,80797,99,64378,86,16419,2001.681405,436.918446,1178.76460633571,300.632763854516
192.168.43.233,51278,34.225.100.237,443,11,633,6,339,5,294,2001.931855,153.380371,17.6815324041692,15.3344263328193
192.168.43.233,51279,52.175.28.154,443,4,240,2,120,2,120,2431.745017,121.534316,7.89900360322925,7.89900360322925
192.168.43.233,51280,52.175.28.154,443,4,240,2,120,2,120,2431.92252,119.209587,8.05304358616729,8.05304358616729
192.168.43.233,51281,13.107.21.200,443,35,11771,19,3600,16,8171,2432.500998,60.5624130000001,475.542478797864,1079.34933173815
192.168.43.233,51282,54.173.195.251,443,55,21536,30,11855,25,9681,2439.431319,93.0097950000004,1019.67755116544,832.686492858087
192.168.43.233,51283,54.173.195.251,443,7,402,4,228,3,174,2439.5765,33.7023989999998,54.1207763874617,41.3026977693786
192.168.43.233,51284,104.244.42.193,443,1011,556180,484,265953,527,290227,2472.294186,799.730378,2660.42663693838,2903.24847457527
192.168.43.233,51285,117.18.237.70,443,18,5841,9,1141,9,4700,2472.357415,19.596192,465.804784929644,1918.74013073561
192.168.43.233,51286,104.244.42.8,443,76,8946,39,4939,37,4007,2474.949878,797.078703,49.5710145701886,40.2168567286385
192.168.43.233,51287,104.244.42.3,443,79,8330,40,4273,39,4057,2475.055574,796.972883,42.8923000131737,40.7240957532052
192.168.43.233,51288,52.230.84.217,443,41,13197,23,5932,18,7265,2484.316401,601.715183,78.8678785923207,96.5905492200286
192.168.43.233,51289,74.207.230.33,443,12,1381,6,904,6,477,2491.954644,26.2357390000002,275.654518441426,145.450448336903
192.168.43.233,51290,74.207.230.33,443,38,18699,17,2118,21,16581,2491.955029,99.8347099999996,169.720531065799,1328.67616883948
192.168.43.233,51291,74.207.230.33,443,9,534,5,294,4,240,2492.164043,25.986555,90.5083417174768,73.8843605856953
192.168.43.233,51292,74.207.230.33,443,15,1543,7,958,8,585,2516.716103,18.9936329999996,403.503637245185,246.398358860577
192.168.43.233,51293,117.18.237.70,443,5970,4579742,2677,171872,3293,4407870,2521.370636,404.411624,3399.94183747795,87195.7132468577
192.168.43.233,51294,117.18.237.70,443,17,5689,8,1087,9,4602,2522.55485,0.346525999999812,25094.7980815428,106243.110185152
192.168.43.233,51295,216.239.32.21,80,9,534,5,294,4,240,2528.121359,15.9472629999996,147.48612348088,120.396835494596
192.168.43.233,51296,216.239.32.21,80,37,9644,18,2267,19,7377,2528.12192,300.393966,60.3740489248043,196.462002169511
192.168.43.233,51297,216.239.32.21,80,27,3576,13,1099,14,2477,2528.12294,287.607088,30.5694830441731,68.8995536855476
192.168.43.233,51298,104.16.88.20,80,13,1540,7,815,6,725,2530.59849,60.9313190000003,107.005725577678,95.1891423850512
192.168.43.233,51299,104.16.88.20,80,13,1427,7,751,6,676,2530.59877,60.9310390000001,98.6032750894006,88.7560771776762
192.168.43.233,51300,104.16.88.20,80,7,402,4,228,3,174,2530.721864,13.4734129999997,135.377725005538,103.314579609489
192.168.43.233,51301,104.16.88.20,443,94,40909,43,3432,51,37477,2531.706929,402.00771,68.2971975835986,745.796641561925
192.168.43.233,51302,104.16.88.20,443,18,6000,9,1080,9,4920,2531.722137,59.8069819999996,144.464738247452,658.117140905058
192.168.43.233,51303,104.16.88.20,443,8,456,4,228,4,228,2531.958874,12.2220130000001,149.238918335301,149.238918335301
192.168.43.233,51304,104.244.42.194,443,103,10868,56,5942,47,4926,2532.246089,739.782212,64.2567491201046,53.2697317680302
192.168.43.233,51305,104.244.42.194,443,17,1972,9,1066,8,906,2532.246361,59.3281729999999,143.742838667896,122.167928548887
192.168.43.233,51306,104.244.42.194,443,7,402,4,228,3,174,2532.28767,59.3137469999997,30.7517243852426,23.4684212413693
192.168.43.233,51307,104.244.42.194,443,140,35282,72,7971,68,27311,2535.413845,736.576345,86.5735105842966,296.626414197431
192.168.43.233,51308,172.217.166.206,443,79,33823,33,3787,46,30036,2535.532689,243.110342,124.618310149883,988.390695448078
192.168.43.233,51309,172.217.166.206,443,20,6702,10,1340,10,5362,2535.533093,55.880244,191.838818742452,767.641601564947
192.168.43.233,51310,117.18.232.102,443,1140,945939,439,25516,701,920423,2591.655863,343.960623,593.463281405907,21407.6365363485
192.168.43.233,51311,117.18.232.102,443,28,6679,13,1496,15,5183,2591.665265,67.925945,176.191880731288,610.429490528251
192.168.43.233,51312,117.18.232.102,443,9,524,5,284,4,240,2591.717264,106.634082,21.3065087389227,18.0055003427516
192.168.43.233,51313,117.18.232.102,443,541,363284,212,14406,329,348878,2596.691963,199.903963,576.516834736289,13961.8242585816
192.168.43.233,51314,52.114.76.37,443,19,7404,10,2710,9,4694,2603.453149,6.268012,3458.83192310417,5991.05426090441
192.168.43.233,51315,74.207.230.33,443,39,17078,18,2613,21,14465,2939.577884,86.591011,241.410739505051,1336.3973773213
192.168.43.233,51316,74.207.230.33,443,12,1381,6,904,6,477,2939.578341,18.1386950000001,398.705640069474,210.378971585331
192.168.43.233,51317,74.207.230.33,443,9,534,5,294,4,240,2939.74141,17.652255,133.240767256082,108.767973270271
192.168.43.233,51318,117.18.237.70,443,2049,1549731,805,56495,1244,1493236,2956.055679,204.013994,2215.33822821978,58554.257802531
192.168.43.233,51319,117.18.237.70,443,16,5635,7,1033,9,4602,2957.250409,0.365248999999949,22625.6608505462,100796.990546189
192.168.43.233,51320,117.18.232.102,443,395,319720,145,9096,250,310624,2978.258846,182.40004,398.947280932614,13623.8566614349
192.168.43.233,51321,117.18.232.102,443,266,201421,96,7671,170,193750,2979.980036,183.759887,333.957541016555,8434.92029356765
192.168.43.233,51322,172.217.166.197,443,2153,1311640,916,139574,1237,1172066,3003.907382,268.70397,4155.47265639581,34895.3831980971
192.168.43.233,51323,172.217.194.189,443,18,5381,9,1274,9,4107,3025.830512,48.7223020000001,209.18551836898,674.352373580376
192.168.43.233,51324,139.59.72.43,443,279,231139,105,14791,174,216348,3074.494853,197.645573,598.687834004762,8757.00868847693
192.168.43.233,51325,172.217.166.197,443,43,7630,21,4913,22,2717,3074.919011,197.322854,199.186253407829,110.154498373513
192.168.43.233,51326,139.59.72.43,443,1264,1179195,435,31385,829,1147810,3074.990335,197.172749,1273.4011229919,46570.7357967607
192.168.43.233,51327,209.197.3.15,443,49,28990,20,2147,29,26843,3075.031969,12.122147,1416.91071721865,17715.0136852819
192.168.43.233,51328,139.59.72.43,443,790,709038,293,20367,497,688671,3075.143434,182.590771,892.356164047305,30173.3103476517
192.168.43.233,51329,209.197.3.15,443,7,403,4,229,3,174,3075.219943,55.3724910000001,33.0850205023284,25.1388365388871
192.168.43.233,51330,157.240.16.20,443,74,40812,33,2896,41,37916,3076.947448,66.5829370000001,347.957014873044,4555.64163533368
192.168.43.233,51331,157.240.16.20,443,16,4976,8,1025,8,3951,3076.957894,25.2627950000001,324.587995904648,1251.1679725066
192.168.43.233,51332,104.19.196.151,443,128,91067,54,3960,74,87107,3076.958421,196.085988,161.561773603119,3553.82863970881
192.168.43.233,51333,52.84.110.243,443,34,10307,17,1949,17,8358,3077.008238,195.035001,79.9446249137609,342.830772205856
192.168.43.233,51334,157.240.16.20,443,9,511,5,283,4,228,3077.009325,60.8257720000001,37.2210647815534,29.9872889406154
192.168.43.233,51335,104.19.196.151,443,7,402,4,228,3,174,3077.011294,60.1617679999999,30.3182579341751,23.1376178971336
192.168.43.233,51336,52.84.110.243,443,9,534,5,294,4,240,3077.088853,60.1675809999997,39.0908186918801,31.9108724015348
192.168.43.233,51337,52.84.110.2,443,31,9900,16,2430,15,7470,3078.628957,193.414281,100.509641271008,308.974082425692
192.168.43.233,51338,52.84.110.2,443,9,534,5,294,4,240,3078.838705,58.37237,40.2930359003754,32.8922742043881
192.168.43.233,51339,157.240.16.39,443,85,14946,43,10030,42,4916,3079.263187,155.525997,515.926607433996,252.870907492076
192.168.43.233,51340,157.240.16.39,443,8,457,5,283,3,174,3079.428685,58.6372660000002,38.6102585342228,23.7391695581441
192.168.43.233,51341,139.59.72.43,443,221,181261,84,9742,137,171519,3080.742152,191.398274,407.192804674926,7169.09286235256
192.168.43.233,51342,139.59.72.43,443,336,283228,130,16324,206,266904,3080.753049,191.410676,682.260795108419,11155.2398467053
192.168.43.233,51343,139.59.72.43,443,185,149714,71,9668,114,140046,3080.754655,191.325631,404.253207454469,5855.81761389827
192.168.43.233,51344,139.59.72.43,443,66,29332,31,7073,35,22259,3082.824786,189.198976,299.071386094606,941.189026308474
192.168.43.233,51345,139.59.72.43,443,9,523,5,283,4,240,3082.998693,55.0782439999998,41.1051594164841,34.8594991517886
192.168.43.233,51346,139.59.46.160,443,889,820808,314,30035,575,790773,3083.951522,188.134801,1277.1693419975,33625.8042976323
192.168.43.233,51347,139.59.46.160,443,155,111995,67,15941,88,96054,3083.951928,188.091313,678.011110486533,4085.41993643269
192.168.43.233,51348,139.59.46.160,443,1507,1418192,519,41072,988,1377120,3083.952287,188.093684,1746.87417999639,58571.6636822319
192.168.43.233,51349,139.59.46.160,443,891,817480,315,31467,576,786013,3083.952645,188.128249,1338.10845175091,33424.5602849362
192.168.43.233,51350,139.59.46.160,443,263,208689,106,21390,157,187299,3083.952997,188.090243,909.776058931456,7966.34623944847
192.168.43.233,51351,139.59.46.160,443,1551,1411872,569,46991,982,1364881,3083.953336,188.127558,1998.26120105168,58040.6619640488
192.168.43.233,51352,209.197.3.15,443,46,27225,19,2175,27,25050,3084.617741,17.7029579999999,982.886588783645,11320.1420915082
192.168.43.233,51353,209.197.3.15,443,7,402,4,228,3,174,3084.86879,52.4472380000002,34.7778085091915,26.5409591254356
192.168.43.233,51354,104.94.6.160,443,25,9191,12,1147,13,8044,3085.470719,51.5089290000001,178.143870939347,1249.33678974377
192.168.43.233,51355,131.253.61.66,443,163,67780,67,19229,96,48551,3086.791056,70.3477600000001,2186.73629409095,5521.25611391179
192.168.43.233,51356,23.33.237.68,443,24,12035,14,3558,10,8477,3096.265317,61.3883470000001,463.671061219485,1104.70477401843
192.168.43.233,51357,139.59.72.43,443,29,4911,15,3059,14,1852,3137.069418,134.945164,181.347736181195,109.792745147948
192.168.43.233,51358,139.59.72.43,443,55,18986,27,8049,28,10937,3137.070361,134.944219,477.174942929567,648.386426987287
192.168.43.233,51359,139.59.72.43,443,31,8981,15,2477,16,6504,3137.073751,134.936064,146.85473558796,385.604844676661
192.168.43.233,51360,139.59.72.43,443,39,10920,19,5731,20,5189,3137.076627,134.939428,339.767262093329,307.634326121495
192.168.43.233,51361,45.79.77.20,443,33,8847,17,3451,16,5396,3137.371404,134.874744,204.693622995866,320.059921670731
192.168.43.233,51362,45.79.77.20,443,18,2472,9,1646,9,826,3137.563843,29.3958630000002,447.954190016463,224.793536423814
192.168.43.233,51363,139.59.72.43,443,36,7832,18,4768,18,3064,3137.592687,134.421894,283.763298261517,182.351247037183
192.168.43.233,51364,117.18.237.29,80,23,5080,11,2032,12,3048,3158.012841,63.7566459999998,254.969497611277,382.454246416916
192.168.43.233,51365,204.79.197.229,443,73,33032,38,13080,35,19952,3201.962022,5.6302169999999,18585.4293005051,28349.8842051741
192.168.43.233,51367,204.79.197.229,443,39,11476,21,1981,18,9495,3201.962764,6.5229360000003,2429.58078999997,11645.0628980564
192.168.43.233,51369,204.79.197.229,443,46,14549,24,2168,22,12381,3201.964513,6.52119100000027,2659.63686694643,15188.636554273
192.168.43.233,51370,23.213.64.207,80,101,84221,41,2955,60,81266,3203.154197,5.19849000000022,4547.47436274745,125060.931155003
192.168.43.233,51371,204.79.197.229,443,175,78258,90,64841,85,13417,3207.089094,1.84027300000025,281875.56954861,58326.1287863188
192.168.43.233,51372,104.85.125.73,443,34,9951,19,1907,15,8044,3210.008014,70.607927,216.066391525699,911.39908412833
192.168.43.233,51373,131.253.33.254,443,35,9393,19,1883,16,7510,3210.644555,0.455337000000327,33083.1889347652,131946.228837008
192.168.43.233,51374,13.107.42.254,443,37,9517,20,1953,17,7564,3211.164615,1.18529099999978,13181.5731326762,51052.4419741745
192.168.43.233,51375,204.79.197.222,443,32,8947,17,1984,15,6963,3212.448264,0.358213999999862,44308.7093190275,155504.809973986
172.30.1.136,51492,50.19.112.59,443,6,326,3,164,3,162,4.055356,91.878943,14.2796592686096,14.105517082407
172.30.1.136,51498,52.84.110.227,443,2313,908971,1050,387273,1263,521698,4.251507,663.584852,4668.85883645819,6289.4503806425
172.30.1.136,51497,172.217.161.3,443,2,109,1,55,1,54,4.268964,0.212542999999999,2070.16933044138,2032.52988806972
172.30.1.136,51490,50.19.112.59,443,8,465,4,218,4,247,4.368907,96.647627,18.044933477777,20.4454062798666
172.30.1.136,51491,66.117.26.67,443,2,108,2,108,0,0,8.948644,0.000123,0,0
172.30.1.136,51515,52.84.110.12,443,36,9075,18,2133,18,6942,8.949177,180.186232,94.7020191864604,308.214447816412
172.30.1.136,51516,172.217.161.14,443,64,14714,29,6976,35,7738,9.569802,241.445448,231.141238993249,256.38917822961
172.30.1.136,51517,52.84.108.242,443,57,15575,30,6554,27,9021,9.846398,190.07406,275.85037116585,379.683582283664
172.30.1.136,51518,52.84.108.242,443,17,1681,8,1015,9,666,10.218044,15.303118,530.610820618386,348.164341410685
172.30.1.136,51519,52.84.108.242,443,17,1681,8,1015,9,666,10.223225,15.298876,530.757945877854,348.260878773055
172.30.1.136,51500,52.84.110.12,443,25,1595,11,622,14,973,12.210781,145.967739,34.0897244424674,53.3268519011588
172.30.1.136,51520,52.230.85.180,443,34,8149,22,3059,12,5090,18.922042,719.668049,34.0045664581116,56.5816421287309
172.30.1.136,51521,52.84.108.135,443,27,7590,14,1564,13,6026,25.140087,174.791203,71.5825498380488,275.803353787776
172.30.1.136,51522,52.84.108.135,443,21556,19690076,8127,477271,13429,19212805,25.140293,450.946035,8467.0175667472,340844.42055245
172.30.1.136,51523,52.84.108.135,443,13,752,7,404,6,348,25.28749,127.352739,25.3783312819051,21.8605427873836
172.30.1.136,51484,172.217.161.3,443,16,979,7,382,9,597,31.336793,150.780079,20.2679294258759,31.6752719037904
172.30.1.136,51524,40.77.226.13,443,29,14101,14,4225,15,9876,33.044414,135.406571,249.618609720203,583.487192803959
172.30.1.136,51486,172.217.161.10,443,58,25887,27,3847,31,22040,33.077812,253.153673,121.570426513227,696.493943423843
172.30.1.136,51482,52.84.110.227,443,1,118,0,0,1,118,35.449189,0,0,0
172.30.1.136,51485,74.125.68.188,5228,32,1910,18,986,14,924,40.753871,654.972446,12.0432547173137,11.2859709521277
172.30.1.136,51495,172.217.161.3,443,13,817,6,328,7,489,40.976032,148.875796,17.6254305300238,26.2769375889685
172.30.1.136,51507,131.253.61.82,443,1,54,0,0,1,54,50.754249,0,0,0
172.30.1.136,51508,131.253.61.82,443,1,54,0,0,1,54,52.740683,0,0,0
172.30.1.136,51478,52.230.85.180,443,24,3299,16,1683,8,1616,60.396389,679.893129,19.8031123212013,19.014753126002
172.30.1.136,51525,13.107.21.200,443,43,13398,24,4250,19,9148,62.085422,8.917561,3812.70170173212,8206.72827469305
172.30.1.136,51483,52.84.110.12,443,8,693,0,0,8,693,91.84794,3.876524,0,1430.14721436008
172.30.1.136,51504,13.107.21.200,443,1,54,0,0,1,54,106.186603,0,0,0
172.30.1.136,51505,13.107.21.200,443,1,54,0,0,1,54,106.229574,0,0,0
172.30.1.136,51506,13.107.21.200,443,1,54,0,0,1,54,106.24218,0,0,0
172.30.1.136,51513,13.107.18.11,443,1,54,0,0,1,54,113.650741,0,0,0
172.30.1.136,51514,204.79.197.222,443,1,54,0,0,1,54,113.668828,0,0,0
172.30.1.136,51511,131.253.33.254,443,1,54,0,0,1,54,113.686957,0,0,0
172.30.1.136,51503,13.107.21.200,443,1,54,0,0,1,54,115.953817,0,0,0
172.30.1.136,51512,13.107.18.11,443,1,54,0,0,1,54,116.055498,0,0,0
172.30.1.136,51509,13.107.246.10,443,1,54,0,0,1,54,116.093445,0,0,0
172.30.1.136,51510,13.107.49.254,443,1,54,0,0,1,54,116.116092,0,0,0
172.30.1.136,51526,52.216.229.171,80,54,31130,24,1792,30,29338,200.193626,116.610661,122.939016699339,2012.7147722797
172.30.1.136,51527,52.216.229.171,80,9,512,5,284,4,228,200.215237,116.404457,19.5181529861868,15.6695031015866
172.30.1.136,51528,52.84.110.12,443,119,68780,53,4634,66,64146,200.394822,183.214526,202.342034823156,2800.91328566382
172.30.1.136,51529,52.84.110.12,443,42,8443,21,1831,21,6612,200.395338,273.471819,53.5631058935546,193.423952030684
172.30.1.136,51530,172.217.161.3,443,74,17510,34,8855,40,8655,300.321232,253.290059,279.679353700968,273.362485181465
172.30.1.136,51531,172.217.161.3,443,9,535,5,295,4,240,300.42715,56.288267,41.9270325021731,34.1101281373612
172.30.1.136,51532,172.217.161.16,80,59,34702,27,3736,32,30966,302.699888,95.781619,312.043169786052,2586.38351059821
172.30.1.136,51533,52.84.108.135,443,2772,2494571,1063,64849,1709,2429722,595.112851,137.449955,3774.40647397811,141417.114323537
172.30.1.136,51537,13.107.4.52,80,2,132,2,132,0,0,695.511853,8.99994900000002,117.33399822599,0
172.30.1.136,51538,172.217.161.3,443,2,132,2,132,0,0,695.514811,8.99993499999994,117.334180746862,0
172.30.1.136,51539,172.217.161.3,443,2,132,2,132,0,0,695.565312,9.00086800000008,117.322018276459,0
172.30.1.136,51540,204.79.197.213,443,2,132,2,132,0,0,701.64765,2.99974599999996,352.029805190178,0
172.30.1.136,51541,172.217.161.4,443,2,132,2,132,0,0,701.877828,2.99976600000002,352.027458141732,0
172.30.1.136,51542,172.217.161.4,443,3,198,3,198,0,0,702.129991,8.99955199999999,176.008761325008,0
172.30.1.136,51547,52.84.110.227,443,9,546,7,414,2,132,711.152204,30.423324,108.86384406911,34.7102111524698
172.30.1.136,51548,52.84.110.135,443,11,654,7,414,4,240,711.228069,29.866457,110.893635626081,64.2861655803366
172.30.1.136,51543,172.217.161.14,443,59,18755,28,6755,31,12000,712.929564,28.166738,1918.57502278042,3408.27539205995
172.30.1.136,51544,172.217.161.14,443,16,888,9,498,7,390,713.178647,27.915647,142.715660503946,111.765276298271
172.30.1.136,51545,52.84.110.227,443,193,137318,98,28216,95,109102,713.950664,27.143629,8316.05825440658,32155.4645475002
172.30.1.136,51546,52.84.110.135,443,18,6918,10,1210,8,5708,713.975725,18.580422,520.978479390834,2457.64062839908
172.30.1.136,51549,52.230.85.180,443,58,26203,32,17250,26,8953,715.668391,25.4767099999999,5416.71196948116,2811.35201523275
172.30.1.136,51550,204.79.197.213,443,17,1246,6,588,11,658,722.707945,18.021758,261.017820791956,292.091370886237
172.30.1.136,51551,52.230.85.180,443,23,8316,13,1401,10,6915,726.505205,14.640044,765.571469593944,3778.67716791015
172.30.1.136,51552,204.79.197.213,443,10,800,6,552,4,248,729.831459,11.263004,392.080123562061,176.151939571361
172.30.1.136,51553,172.217.161.14,443,1,66,1,66,0,0,735.980373,0,0,0
172.30.1.136,51554,52.84.110.227,443,1,66,1,66,0,0,735.983204,0,0,0
172.30.1.136,51555,172.217.161.14,443,2,132,2,132,0,0,736.110499,3.00020199999994,351.976300262455,0
172.30.1.136,51556,172.217.161.14,443,2,132,2,132,0,0,736.356862,3.00044100000002,351.948263605247,0
172.30.1.136,51557,52.230.85.180,443,2,132,2,132,0,0,736.530275,3.00071300000002,351.916361211483,0
172.30.1.136,51558,172.217.161.14,443,2,132,2,132,0,0,739.508146,2.99985700000002,352.016779466486,0
172.30.1.136,51559,204.79.197.213,443,1,66,1,66,0,0,741.095666,0,0,0
172.30.1.136,51759,13.107.4.52,80,13,2451,6,459,7,1992,2945.378008,2.85316499999999,1286.99181435354,5585.37624007026
172.30.1.136,51760,13.107.4.52,80,20,3686,9,657,11,3029,2948.022778,4.54928000000018,1155.34765940979,5326.55716948595
172.30.1.136,51761,74.125.68.188,5228,20,2415,11,1475,9,940,2948.272241,77.8133769999999,151.644877204083,96.6414810656528
172.30.1.136,51762,74.125.68.188,5228,9,534,5,294,4,240,2948.315688,61.8496299999997,38.0277133428286,31.0430313002682
172.30.1.136,51763,172.217.160.228,443,14,1743,7,1181,7,562,2948.627436,17.2581139999998,547.45263590217,260.515140878086
172.30.1.136,51764,172.217.160.228,443,9,534,5,294,4,240,2948.880009,16.9496490000001,138.763935465565,113.276682012706
172.30.1.136,51765,52.114.75.78,443,27,11295,16,6136,11,5159,2952.517673,9.70452400000022,5058.25942622213,4252.86186112777
172.30.1.136,51766,204.79.197.213,443,42,18655,21,4960,21,13695,2952.576361,70.4197400000003,563.478365583285,1555.81375335949
172.30.1.136,51767,52.230.84.217,443,50,12468,27,6260,23,6208,2954.341397,569.290118,87.969206590022,87.2384719665905
172.30.1.136,51768,52.114.75.78,443,23,8027,12,3225,11,4802,2957.494849,2.34452199999987,11004.3753055,16385.4295246546
172.30.1.136,51769,52.84.110.227,443,897,530316,422,97909,475,432407,2965.858183,61.9885640000002,12635.7500393137,55804.7448881053
172.30.1.136,51770,52.84.110.12,443,46,13577,20,2286,26,11291,2965.976348,200.086913,91.4002806370451,451.443818317094
172.30.1.136,51771,157.240.16.20,443,101,56219,47,4409,54,51810,2973.346665,41.0831400000002,858.551707586125,10088.8101542384
172.30.1.136,51772,204.79.197.200,443,47,13619,22,2687,25,10932,2973.487901,40.513097,530.593847219332,2158.70931812495
172.30.1.136,51773,204.79.197.200,443,6,348,3,174,3,174,2973.56068,40.4400919999998,34.4212866775873,34.4212866775873
172.30.1.136,51774,172.217.160.243,443,40,7810,18,2766,22,5044,2973.931588,39.607649,558.679966084328,1018.79311241119
172.30.1.136,51775,35.241.16.233,443,52,19688,23,4014,29,15674,2973.932122,40.0687599999997,801.42235497181,3129.42052611563
172.30.1.136,51776,172.217.160.243,443,36,7410,16,2621,20,4789,2974.075184,42.2078240000001,496.779933502375,907.699008600868
172.30.1.136,51777,35.241.16.233,443,9,534,5,294,4,240,2974.166946,40.26181,58.4176419291632,47.6878709625822
172.30.1.136,51778,172.217.160.243,443,9,534,5,294,4,240,2974.171748,40.246983,58.4391630050879,47.7054391878268
172.30.1.136,51779,172.217.160.243,443,9,534,5,294,4,240,2974.278807,40.1399200000001,58.5950345690773,47.8326812808794
172.30.1.136,51780,172.217.160.243,443,44,7817,19,2483,25,5334,2974.295425,37.6687030000003,527.334323138226,1132.82371309678
172.30.1.136,51781,172.217.160.243,443,11,642,6,348,5,294,2974.391155,37.2537090000001,74.7308140512934,63.1346532502306
172.30.1.136,51782,172.217.160.243,443,11,642,6,348,5,294,2974.532571,35.625599,78.1460544705509,66.0199425699482
172.30.1.136,51783,172.217.160.243,443,38,7250,16,2303,22,4947,2974.532906,44.1927380000002,416.901075466289,895.531750035488
172.30.1.136,51784,172.217.160.243,443,20,5018,8,1066,12,3952,2974.547673,2.74418000000014,3107.66786435276,11521.110131259
172.30.1.136,51785,52.220.54.9,443,31,9175,14,2440,17,6735,2974.55,123.830418,157.634935868504,435.111185686218
172.30.1.136,51786,172.217.160.243,443,11,642,6,348,5,294,2974.593841,36.4318720000001,76.416605767609,64.5588565967731
172.30.1.136,51787,52.220.54.9,443,9,534,5,294,4,240,2974.59413,37.370054,62.9380947643266,51.3780365423074
172.30.1.136,51788,54.88.180.215,443,34,12122,17,3537,17,8585,2977.301743,13.4627340000002,2101.80190739857,5101.489786547
172.30.1.136,51789,130.211.21.54,443,35,6130,17,2647,18,3483,2977.304478,41.4620989999999,510.731499628132,672.035441331615
172.30.1.136,51790,54.255.158.169,443,14,1626,7,1009,7,617,2977.306333,3.32684999999992,2426.31919082621,1483.68576882039
172.30.1.136,51791,54.255.158.169,443,14,1626,7,1009,7,617,2977.306614,3.32656700000007,2426.52560432417,1483.81198995839
172.30.1.136,51792,54.255.158.169,443,52,14338,30,5556,22,8782,2977.306869,41.4598510000001,1072.07331738843,1694.55505279071
172.30.1.136,51793,54.255.158.169,443,13,1560,7,1009,6,551,2977.307117,3.32606200000009,2426.89402662962,1325.29098976504
172.30.1.136,51794,54.255.158.169,443,14,1626,7,1009,7,617,2977.307357,3.32583499999964,2427.05967072957,1484.13856971273
172.30.1.136,51795,54.255.158.169,443,13,1560,7,1009,6,551,2977.307597,3.32557499999984,2427.24942303222,1325.48506649232
172.30.1.136,51796,107.22.42.44,443,23,6679,11,1904,12,4775,2977.332616,7.55264099999977,2016.7779721028,5057.83341218008
172.30.1.136,51797,130.211.21.54,443,12,696,7,402,5,294,2977.382383,45.1870479999998,71.1708363865685,52.0503131782366
172.30.1.136,51798,107.22.42.44,443,7,402,4,228,3,174,2977.402461,37.0162700000001,49.2756293381261,37.6050855475173
172.30.1.136,51799,54.88.180.215,443,7,402,4,228,3,174,2977.408386,37.0103439999998,49.283519223707,37.6111067759869
172.30.1.136,51800,72.247.219.151,443,23,7768,10,3469,13,4299,2977.493049,3.11475699999983,8909.84433135604,11041.631819112
172.30.1.136,51801,72.247.219.151,443,14,828,7,414,7,414,2977.633396,37.4252139999999,88.4964879559543,88.4964879559543
172.30.1.136,51802,103.243.221.46,443,22,8428,10,3908,12,4520,2977.652895,14.1626999999999,2207.48868506714,2553.18548016977
172.30.1.136,51803,157.240.16.39,443,50,10113,25,6990,25,3123,2977.67574,36.7547420000001,1521.43633602434,679.749023949072
172.30.1.136,51804,172.217.160.227,443,53,12633,25,5305,28,7328,2977.688288,38.4899770000002,1102.62471707894,1523.09781842685
172.30.1.136,51805,157.240.16.39,443,26,6331,9,1660,17,4671,2977.739466,143.48465,92.5534543242083,260.43203924601
172.30.1.136,51806,172.217.160.227,443,11,642,6,348,5,294,2977.758545,36.242225,76.8164758096393,64.896677839178
172.30.1.136,51807,157.240.16.39,443,8,456,5,282,3,174,2977.807738,45.1885990000001,49.9240970050874,30.8042300669688
172.30.1.136,51808,103.243.221.46,443,7,394,4,228,3,166,2977.851748,36.5672500000001,49.8806992595833,36.3166494609247
172.30.1.136,51809,52.84.108.135,443,19157,16952790,7468,437508,11689,16515282,2983.843254,849.803484,4118.67457112002,155473.89306773
172.30.1.136,51810,52.84.108.135,443,19,2556,7,1530,12,1026,2983.843766,188.461208,64.9470526581788,43.5527294296023
172.30.1.136,51811,52.84.108.135,443,11,666,6,360,5,306,2983.898827,27.5268850000002,104.624987534913,88.9312394046759
172.30.1.136,51812,74.125.68.188,5228,18,2660,9,1573,9,1087,3009.955422,4.47426099999984,2812.53149961534,1943.56118250596
172.30.1.136,51813,52.84.110.171,443,46,11855,22,9297,24,2558,3010.028379,187.384479,396.916545046401,109.208618073432
172.30.1.136,51814,74.125.68.188,5228,7,402,4,228,3,174,3010.030656,4.3887450000002,415.608562356646,317.174955482703
172.30.1.136,51815,13.107.4.52,80,18,2820,9,700,9,2120,3011.250846,5.3740270000003,1042.04910023706,3155.92013214654
172.30.1.136,51816,74.125.68.188,5228,11,643,6,349,5,294,3015.523112,59.7245670000002,46.7479320528182,39.3807794370446
172.30.1.136,51817,74.125.68.188,5228,29,2915,15,1645,14,1270,3015.774457,288.011414,45.6926335565298,35.2763797062571
172.30.1.136,51818,52.84.110.171,443,585,192178,278,139552,307,52626,3017.419718,286.310462,3899.31961340623,1470.45971376345
172.30.1.136,51819,23.21.249.197,443,40,12281,19,3371,21,8910,3031.762767,173.926742,155.05378695589,409.827719304948
172.30.1.136,51820,23.21.249.197,443,15,873,8,459,7,414,3031.782691,162.764974,22.5601363104079,20.3483582407601
172.30.1.136,51821,157.240.16.39,443,43,15050,29,12822,14,2228,3055.709359,164.964582,621.806200800121,108.047435297354
172.30.1.136,51822,157.240.16.39,443,37,10678,21,2660,16,8018,3055.951376,99.0352849999999,214.872911205335,647.688346633223
172.30.1.136,51823,157.240.16.39,443,11,666,6,360,5,306,3057.238219,43.751444,65.8263987812608,55.9524389640717
172.30.1.136,51824,52.230.84.217,443,53,12435,28,5469,25,6966,3070.207033,1689.549504,25.8956602907564,32.983940315489
172.30.1.136,51825,172.217.160.227,443,41,11210,19,3101,22,8109,3085.103798,8.58214199999975,2890.65363868376,7558.95206581316
172.30.1.136,51826,172.217.160.227,443,36,4060,17,2257,19,1803,3098.894743,202.751961,89.0546257158024,71.1411121690703
172.30.1.136,51827,172.217.160.227,443,12,697,6,349,6,348,3099.067771,70.896741,39.3812178193071,39.2683776536357
172.30.1.136,51828,13.107.4.52,80,13,924,5,460,8,464,3298.451173,3.79093599999987,970.736514676091,979.177701760231
172.30.1.136,51829,52.84.110.227,443,13,1537,7,970,6,567,3304.976071,2.42305699999997,3202.56601474917,1872.01539212658
172.30.1.136,51830,52.84.110.227,443,50,13747,27,9814,23,3933,3304.976313,16.3489299999997,4802.27146363717,1924.52961753464
172.30.1.136,51831,74.125.24.188,5228,22,2596,12,1468,10,1128,3304.9817,20.5529410000004,571.402409027486,439.0612516233
172.30.1.136,51832,52.84.110.227,443,9,534,5,294,4,240,3305.043211,14.7855049999998,159.074715405394,129.856910535015
172.30.1.136,51833,74.125.24.188,5228,9,534,5,294,4,240,3305.043535,12.7216240000002,184.882055938766,150.924127296952
172.30.1.136,51834,13.107.4.52,80,10,1519,5,436,5,1083,3314.480264,0.607868000000053,5738.08787434064,14253.094421814
172.30.1.136,51835,74.125.24.188,5228,29,3305,15,1900,14,1405,3320.536794,164.771406,92.249015584658,68.2157194191813
172.30.1.136,51836,52.84.110.227,443,389,122437,182,83756,207,38681,3320.537154,161.947377,4137.44274475035,1910.79352893749
172.30.1.136,51837,74.125.24.188,5228,10,589,5,295,5,294,3320.787,63.1034710000004,37.3988936361359,37.2721177255049
172.30.1.136,51838,52.84.110.227,443,13,750,7,402,6,348,3320.787599,77.4281120000001,41.535301803562,35.955932904576
172.30.1.136,51839,172.217.160.227,443,37,4824,18,2885,19,1939,3398.216494,84.089011,274.471060195963,184.471190890805
172.30.1.136,51840,172.217.160.227,443,9,535,5,295,4,240,3398.328751,56.307855,41.9124472065221,34.0982621341196
172.30.1.136,51841,13.107.4.52,80,16,2822,8,764,8,2058,3478.55618,0.793963000000076,7698.09172467661,20736.4826824404
172.30.1.136,51842,74.125.24.188,5228,36,3826,18,2304,18,1522,3484.636841,348.877224,52.8323396657158,34.9005299354251
172.30.1.136,51843,52.84.110.84,443,576,169749,271,111596,305,58153,3485.876972,346.388824,2577.3579808106,1343.06873595899
172.30.1.136,51844,52.230.80.159,443,114,22238,63,9443,51,12795,3527.56955,2226.732758,33.9259391269978,45.9686954495327
172.30.1.136,51845,172.217.160.234,443,42,11086,21,3003,21,8083,3678.080739,154.197969,155.799717439858,419.357015007118
172.30.1.136,51846,172.217.160.227,443,21,2515,12,1671,9,844,3682.802771,148.737676,89.8763538567056,45.3953576631116
172.30.1.136,51847,172.217.160.227,443,9,511,5,283,4,228,3683.054276,56.0999710000001,40.356527100522,32.5133857912332
172.30.1.136,51848,13.107.4.52,80,10,1519,5,436,5,1083,3829.352026,0.252799999999752,13797.4683544439,34272.1518987678
172.30.1.136,51849,74.125.200.188,5228,7,402,4,228,3,174,3834.68718,18.1326979999999,100.591759703934,76.7673955635289
172.30.1.136,51850,74.125.200.188,5228,20,6058,10,1378,10,4680,3834.80017,19.912409,553.624626734012,1880.2345813608
172.30.1.136,51851,13.107.4.52,80,10,1519,5,436,5,1083,3850.494491,0.353743000000122,9860.26578617469,24492.3574459339
172.30.1.136,51852,74.125.200.188,5228,23,3033,12,1973,11,1060,3855.525176,9.13637500000004,1727.59984129372,928.15804955466
172.30.1.136,51853,74.125.200.188,5228,9,535,5,295,4,240,3864.024218,56.572842,41.7161294459981,33.9385459899646
172.30.1.136,51854,74.125.200.188,5228,29,3026,15,1634,14,1392,3864.274519,217.060585,60.2228175142899,51.303648702504
172.30.1.136,51855,52.114.132.21,443,20,7392,11,2698,9,4694,3916.711564,2.9454539999997,7327.90259158765,12749.1381634219
172.30.1.136,51856,104.16.92.188,80,11,1337,6,569,5,768,3977.861091,46.2212909999998,98.4827533268168,132.925754929693
172.30.1.136,51857,52.84.108.120,443,36,9133,19,2443,17,6690,3982.098397,97.7252949999997,199.98916350163,547.657594689278
172.30.1.136,51858,52.84.110.227,443,212,64104,102,43291,110,20813,3983.042861,191.455779,1808.91901936269,869.673409022561
172.30.1.136,51859,13.107.4.52,80,10,1519,5,436,5,1083,4079.610565,0.290802999999869,11994.3741983459,29793.3652679096
172.30.1.136,51860,74.125.24.188,5228,25,2626,15,1620,10,1006,4081.793415,116.103368999999,111.624667842326,69.3175406477657
172.30.1.136,51861,74.125.24.188,5228,9,535,5,295,4,240,4082.016129,57.727566,40.8816820719585,33.2596735500679
172.30.1.136,51862,74.125.24.188,5228,2,132,2,132,0,0,4164.539754,3.00019199999952,351.977473441757,0
172.30.1.136,51863,74.125.24.188,5228,2,132,2,132,0,0,4164.781368,3.00061199999982,351.928206645865,0
172.30.1.136,51864,172.217.160.228,443,13,1485,8,1031,5,454,4168.839467,15.79277,522.264301955894,229.978654789502
172.30.1.136,51865,172.217.160.238,443,13,1445,8,995,5,450,4168.84791,15.7819609999997,504.373315838264,228.108534801225
172.30.1.136,51866,172.217.160.228,443,10,600,6,360,4,240,4169.091023,14.810547,194.456018403641,129.637345602427
172.30.1.136,51867,172.217.160.238,443,10,600,6,360,4,240,4169.098964,14.8377740000005,194.099195741888,129.399463827925
172.30.1.136,51868,13.107.4.52,80,11,1585,6,502,5,1083,4170.089184,9.10494899999958,441.078802308523,951.570404183527
172.30.1.136,51869,13.107.4.52,80,10,1519,5,436,5,1083,4179.196966,0.13961399999971,24983.1678771988,62056.8137867117
172.30.1.136,51870,52.84.110.171,443,37,6957,19,4895,18,2062,4182.110992,160.714514,243.661876114064,102.641631981042
172.30.1.136,51871,74.125.24.188,443,26,2741,13,1549,13,1192,4185.544908,163.209659,75.9268788129751,58.4279144900364
172.30.1.136,51872,74.125.24.188,443,9,535,5,295,4,240,4185.789488,56.5625169999994,41.7237443659027,33.9447411790395
172.30.1.136,51873,172.217.160.228,443,14,1743,7,1181,7,562,4185.846094,19.3368809999993,488.59999707297,232.509058725664
172.30.1.136,51874,172.217.160.228,443,9,534,5,294,4,240,4186.096904,18.8013419999998,125.097453149889,102.120369918276
172.30.1.136,51875,52.84.110.171,443,43,9376,21,5972,22,3404,4204.775957,138.354069,345.316912941679,196.828327470441
172.30.1.136,51876,13.107.4.52,80,11,1573,6,490,5,1083,4339.518598,0.324665000000095,12073.9839526861,26685.9686137941
172.30.1.136,51877,74.125.68.188,5228,19,2277,10,1337,9,940,4345.549283,55.4384359999995,192.934735749041,135.64596230673
172.30.1.136,51878,13.107.4.52,80,11,1573,6,490,5,1083,4396.020714,0.262716999999611,14920.9986411454,32978.4520986949
172.30.1.136,51879,74.125.68.188,5228,19,2423,10,1348,9,1075,4402.048417,15.0058209999997,718.65444749742,573.110928085851
172.30.1.136,51880,13.107.4.52,80,10,1519,5,436,5,1083,4411.548269,0.224403000000166,15543.4642139251,38609.1095038551
172.30.1.136,51881,74.125.68.188,5228,29,2882,15,1612,14,1270,4417.521093,278.381867,46.3248563528026,36.4966300049996
172.30.1.136,51882,23.57.218.72,443,21,8944,10,1008,11,7936,4419.107749,60.4362570000003,133.429838317088,1050.49523500437
172.30.1.136,51883,52.229.207.60,443,51,20657,30,8467,21,12190,4419.680775,3.41549600000053,19831.9658403902,28552.2219905937
172.30.1.136,51884,13.75.122.216,443,22,8805,14,2542,8,6263,4420.515557,2.58014000000003,7881.74285116303,19419.1012890771
172.30.1.136,51885,52.229.207.60,443,34,10110,21,3271,13,6839,4464.915768,1.57917799999996,16570.6462476052,34645.8727261914
172.30.1.136,51886,13.75.122.216,443,22,8795,14,2532,8,6263,4465.70525,0.790289999999914,25631.0974452444,63399.5115717085
172.30.1.136,51887,52.84.110.171,443,39,8008,19,5352,20,2656,4531.167266,163.740565999999,261.486820559788,129.766254747159
172.30.1.136,51888,52.84.110.171,443,11,644,6,350,5,294,4531.32128,121.917115,22.9664227208788,19.2917950855382
172.30.1.136,51889,52.46.136.108,443,88,22849,40,7548,48,15301,4588.399301,12.8510399999996,4698.76367982685,9525.14349033263
172.30.1.136,51890,52.46.136.108,443,375,240251,192,217240,183,23011,4588.680203,25.8988639999998,67104.1015544163,7107.95654975452
172.30.1.136,51891,184.29.24.103,443,34,21199,14,1409,20,19790,4599.469044,3.20925999999963,3512.33617718767,49332.2448165678
172.30.1.136,51892,184.29.24.103,443,34,6478,17,2137,17,4341,4603.000091,102.711853,166.446223105332,338.110928638393
172.30.1.136,51893,184.29.24.103,443,24,4299,12,1503,12,2796,4603.038728,102.762610999999,117.007536914375,217.66671537764
172.30.1.136,51894,13.107.4.52,80,11,1739,6,644,5,1095,4691.061151,0.564868000000388,9120.71492808313,15508.0478979053
172.30.1.136,51895,172.217.194.188,5228,21,2397,11,1403,10,994,4698.098389,47.3172789999999,237.207215571293,168.057000910809
172.30.1.136,51896,172.217.194.188,5228,9,534,5,294,4,240,4698.268011,38.8220350000001,60.5841502126303,49.4564491531676
172.30.1.136,51897,13.107.4.52,80,12,1651,6,502,6,1149,4734.213997,0.59199499999977,6783.84107974149,15527.1581685717
172.30.1.136,51898,172.217.194.188,5228,18,2222,10,1348,8,874,4739.642462,9.76091700000052,1104.8142300564,716.32614025912
172.30.1.136,51899,172.217.194.188,5228,2,132,2,132,0,0,4739.893046,3.00004799999988,351.994368090125,0
172.30.1.136,51900,13.107.4.52,80,10,1519,5,436,5,1083,4744.122767,0.219788000000335,15869.8382077032,39419.8045388592
172.30.1.136,51901,52.114.132.73,443,20,7483,11,2789,9,4694,4744.69022,2.05033699999967,10882.1135257295,18315.0379669323
172.30.1.136,51902,172.217.194.188,5228,60,4805,31,2524,29,2281,4750.523946,996.438647,20.2641678549828,18.3132198404183
172.30.1.136,51903,23.57.209.77,80,19,5908,9,723,10,5185,4759.616955,60.6935049999993,95.2985002266728,683.433919329597
172.30.1.136,51904,52.84.110.71,443,781,307380,358,135979,423,171401,5129.745556,649.609311,1674.59422391192,2110.81949839848
172.30.1.136,51905,157.240.16.39,443,36,8472,17,3238,19,5234,5320.355341,67.3304839999992,384.729151805894,621.887702455852
172.30.1.136,51906,157.240.16.39,443,38,5166,18,3027,20,2139,5417.828926,116.854652999999,207.231799319109,146.438327962859
172.30.1.136,51907,52.84.108.201,443,6273,5607113,2437,144632,3836,5462481,5470.890878,348.757501999999,3317.65193111173,125301.528280817
172.30.1.136,51908,157.240.16.39,443,27,3657,14,2175,13,1482,5587.927966,68.0272299999997,255.779928125841,174.283151026435
172.30.1.136,51909,157.240.16.39,443,11,644,6,350,5,294,5587.970945,107.457865,26.0567246520298,21.887648707705
172.30.1.136,51910,13.107.4.52,80,1,66,1,66,0,0,5743.82126,0,0,0
172.30.1.136,51911,172.217.160.238,443,37,18029,23,7347,14,10682,5744.857414,72.5440140000001,810.211577208837,1177.98830376273
172.30.1.136,51912,172.217.160.238,443,24,1416,13,762,11,654,5745.109449,58.1136480000005,104.89790625431,90.0304864702343
172.30.1.136,51913,172.217.160.228,443,39,19398,25,9140,14,10258,5745.551275,74.047775,987.470589089274,1108.25747296256
172.30.1.136,51914,172.217.160.228,443,21,1242,12,708,9,534,5745.723523,26.3020280000001,215.344611449733,162.420935754459
172.30.1.136,51915,52.230.7.59,443,54,17742,31,6744,23,10998,5778.497247,647.98736,83.2608833604408,135.780426334242
172.30.1.136,51916,52.84.108.135,443,4250,3697946,1680,98454,2570,3599492,5787.102634,395.066657,1993.66862792473,72888.8036734519
172.30.1.136,51917,52.84.108.135,443,13,776,7,416,6,360,5787.23273,132.969939000001,25.0282133317365,21.6590307678489
172.30.1.136,51918,74.125.24.188,5228,49,4610,25,2582,24,2028,5824.865622,612.653854,33.7156126010431,26.4815113690609
172.30.1.136,51919,74.125.24.188,5228,11,619,6,337,5,282,5824.869485,60.1972399999995,44.7861064726559,37.4768012619851
172.30.1.136,51920,52.84.110.171,443,44,8425,22,6129,22,2296,5965.34003,191.207539999999,256.433402155585,96.0631573420172
172.30.1.136,51921,52.84.110.171,443,16,950,9,536,7,414,5965.383925,127.23981,33.7001446324071,26.0295893242846
172.30.1.136,51922,52.84.108.120,443,4908,4467087,1824,106797,3084,4360290,6211.150844,226.368329,3774.27356456742,154095.407931381
172.30.1.136,51923,23.57.218.72,443,21,8944,10,1008,11,7936,6219.56149,61.9219199999998,130.228520045891,1025.29120544066
172.30.1.136,51924,52.84.110.171,443,66,10964,33,6276,33,4688,6258.786148,178.751036,280.882288145172,209.811371386961
172.30.27.232,59065,172.30.1.136,7680,3,198,3,198,0,0,402.218137,9.282106,170.650927709725,0
172.30.29.42,59040,172.30.1.136,31461,2,132,2,132,0,0,3673.569322,2.05844100000013,513.009602898472,0
192.168.43.233,51631,13.107.4.52,80,15,5233,5,405,10,4828,832.733125,4.67921799999999,692.423392113812,8254.37070895181
192.168.43.233,51634,172.217.163.78,443,4,264,1,66,3,198,835.695486,2.58362199999999,204.364260716158,613.092782148474
192.168.43.233,51636,172.217.163.68,443,28,4089,13,2433,15,1656,835.731392,1.114868,17458.5690862057,11883.0211289588
192.168.43.233,51637,13.107.4.52,80,10,1476,5,393,5,1083,838.73251,0.221985999999902,14163.0553278197,39029.4883461292
192.168.43.233,51638,74.125.130.188,443,74,5678,39,3001,35,2677,839.502729,1399.074903,17.1599104154612,15.307257641516
192.168.43.233,51639,52.46.6.89,443,1769,1473235,741,44675,1028,1428560,839.56698,211.366597,1690.90104620457,54069.4705890543
192.168.43.233,51640,52.46.6.89,443,11,654,6,348,5,306,839.735878,15.2235000000001,182.875160114296,160.804020100502
192.168.43.233,51632,52.230.7.59,443,60,17498,34,9715,26,7783,842.078536,1202.531972,64.6302982454092,51.7774175238311
192.168.43.233,51641,52.84.110.227,443,3855,1663547,1822,638000,2033,1025547,842.734688,1422.006822,3589.29361029465,5769.57569617061
192.168.43.233,51642,52.84.110.12,443,52,13024,26,3196,26,9828,842.735746,231.147688,110.61326298016,340.146166636112
192.168.43.233,51643,52.84.110.227,443,9,534,5,294,4,240,842.891047,13.9644450000001,168.427746322893,137.492037814606
192.168.43.233,51644,52.84.110.12,443,9,534,5,294,4,240,842.987619,13.868211,169.596496620942,138.446119690565
192.168.43.233,51645,172.217.166.206,443,127,28767,60,14487,67,14280,851.606863,308.336284,375.875321893676,370.504562479582
192.168.43.233,51646,172.217.166.206,443,11,642,6,348,5,294,851.836257,13.70494,203.138430376201,171.616949800583
192.168.43.233,51647,52.84.110.140,443,38,9455,19,2169,19,7286,855.704745,186.459424,93.060461240082,312.604204977057
192.168.43.233,51648,52.84.110.140,443,7,426,4,240,3,186,855.773913,14.481666,132.581430893379,102.750608942369
192.168.43.233,51649,204.79.197.200,443,49,14251,24,2993,25,11258,855.777901,166.195115,144.071623284475,541.917251899973
192.168.43.233,51650,204.79.197.200,443,9,534,6,348,3,186,855.818917,28.15355,98.8862860989112,52.8530149839008
192.168.43.233,51651,35.241.16.233,443,93,35965,42,5382,51,30583,855.881794,285.041399,151.051742487413,858.345492473534
192.168.43.233,51652,35.241.16.233,443,7,402,4,228,3,174,855.899279,14.152745,128.879591909556,98.3554780362397
192.168.43.233,51653,172.217.166.211,443,53,5806,25,3169,28,2637,857.397481,282.6277,89.7010448728132,74.6423652034107
192.168.43.233,51654,172.217.166.211,443,11,642,6,348,5,294,857.443781,37.5170780000001,74.206205504597,62.6914494780216
192.168.43.233,51655,157.240.16.39,443,72,13122,36,9000,36,4122,857.456266,174.73817,412.045061476837,188.716638156391
192.168.43.233,51656,157.240.16.39,443,17,5030,9,1079,8,3951,857.457089,36.244531,238.160068894256,872.07639685005
192.168.43.233,51657,157.240.16.39,443,7,402,4,228,3,174,857.488038,38.891654,46.8995224528121,35.7917408192513
192.168.43.233,51658,18.185.199.142,443,32,9138,17,2799,15,6339,865.487398,155.325917,144.161389370713,326.487691039996
192.168.43.233,51659,18.185.199.142,443,9,534,5,294,4,240,865.614379,31.237797,75.2934017722185,61.4640014467089
192.168.43.233,51660,130.211.21.54,443,15,2106,9,1312,6,794,868.131993,25.4050590000001,413.146058822378,250.028941086104
192.168.43.233,51661,130.211.21.54,443,9,510,5,282,4,228,868.349317,26.611541,84.7752484532933,68.5416902388329
192.168.43.233,51662,107.22.42.44,443,15,1836,8,1024,7,812,870.184109,23.7628199999999,344.740228642898,273.368228181673
192.168.43.233,51663,49.44.149.244,443,17,1756,9,1117,8,639,870.184674,23.489499,380.425312604581,217.629162716497
192.168.43.233,51664,54.255.158.169,443,14,1587,8,1024,6,563,870.209211,23.737701,345.105029337087,189.740362809355
192.168.43.233,51665,54.255.158.169,443,13,1533,8,1024,5,509,870.210125,23.3284630000001,351.159011204466,174.550719436595
192.168.43.233,51666,54.255.158.169,443,13,1533,8,1024,5,509,870.210776,23.328116,351.164234608572,174.553315835706
192.168.43.233,51667,54.255.158.169,443,15,1704,9,1129,6,575,870.211389,23.3268419999999,387.193431498358,197.197717547879
192.168.43.233,51668,54.172.100.225,443,25,8967,12,1327,13,7640,870.212053,23.734877,447.274279112548,2575.11340800292
192.168.43.233,51669,49.44.149.244,443,11,666,6,360,5,306,870.357093,26.0228500000001,110.671967136574,94.0711720660879
192.168.43.233,51670,107.22.42.44,443,7,402,4,228,3,174,870.376888,24.803179,73.538960469543,56.1218382530723
192.168.43.233,51671,54.172.100.225,443,11,642,6,348,5,294,870.387036,24.79303,112.289623333654,94.8653714370529
192.168.43.233,51672,54.255.158.169,443,9,534,5,294,4,240,870.390417,26.350642,89.2577873434735,72.8634998722233
192.168.43.233,51673,23.21.249.197,443,27,8042,13,1860,14,6182,891.007513,163.402546,91.0634525853716,302.66358273267
192.168.43.233,51674,23.21.249.197,443,13,741,7,393,6,348,891.256165,156.994839,20.0261360183948,17.733067008655
192.168.43.233,51675,130.211.21.54,443,47,7680,23,3783,24,3897,894.525544,246.304789,122.872154142322,126.574883608942
192.168.43.233,51676,49.44.149.244,443,26,10146,12,4872,14,5274,894.526671,4.28778199999999,9090.01437106645,9840.05250266923
192.168.43.233,51677,107.22.42.44,443,18,4133,9,3026,9,1107,894.608976,4.57058600000005,5296.4762067708,1937.60712521325
192.168.43.233,51678,54.172.100.225,443,37,12796,17,4054,20,8742,894.609532,9.19185500000003,3528.34112374487,7608.47511193331
192.168.43.233,51679,54.255.158.169,443,50,13031,26,5079,24,7952,894.61006,64.842754,626.623600842123,981.081093501981
192.168.43.233,51680,130.211.21.54,443,9,534,5,294,4,240,894.777007,10.58164,222.271783957874,181.446354251326
192.168.43.233,51681,49.44.149.244,443,20,2449,10,1690,10,759,894.77738,115.756597,116.796799062778,52.4548937802655
192.168.43.233,51682,107.22.42.44,443,7,402,4,228,3,174,894.860416,10.7214690000001,170.125940764273,129.832954793787
192.168.43.233,51683,54.172.100.225,443,7,402,4,228,3,174,894.860792,10.7135340000001,170.251944876451,129.929115826765
192.168.43.233,51684,54.255.158.169,443,26,2894,13,1852,13,1042,894.861102,125.873444,117.705526512804,66.2252476384137
192.168.43.233,51685,54.255.158.169,443,26,2894,13,1852,13,1042,894.911482,125.823063,117.752657157933,66.2517649884266
192.168.43.233,51686,54.255.158.169,443,26,2894,13,1852,13,1042,894.913419,125.821124,117.754471816672,66.2527859789267
192.168.43.233,51687,54.255.158.169,443,14,794,8,446,6,348,894.959619,125.774923,28.3681350375384,22.1347780113529
192.168.43.233,51688,52.84.108.201,443,26306,23182208,10351,610849,15955,22571359,905.386256,860.309205,5680.27398939664,209890.665996071
192.168.43.233,51689,172.217.166.206,443,29,6447,15,1603,14,4844,1018.78141,289.78659,44.2532554732778,133.725994705276
192.168.43.233,51690,172.217.166.206,443,9,535,6,361,3,174,1019.031953,69.3083029999999,41.6688892238496,20.0841737533236
192.168.43.233,51691,23.66.249.177,80,17,6299,8,681,9,5618,1145.761211,62.8051210000001,86.7445188108147,715.610435652213
192.168.43.233,51692,111.221.29.253,443,27,7572,14,2547,13,5025,1365.93644,1.73584800000003,11738.3549711724,23158.7097487794
192.168.43.233,51693,52.114.77.33,443,36,16609,19,10410,17,6199,1365.951293,6.24410799999987,13337.3734086601,7942.20727764495
192.168.43.233,51694,52.114.128.43,443,20,7863,11,3169,9,4694,1368.551317,3.96516100000008,6393.68741899749,9470.48556162013
192.168.43.233,51695,52.84.110.12,443,41,10053,21,2456,20,7597,1492.281891,180.935593,108.591127230561,335.898531584109
192.168.43.233,51696,52.216.0.24,80,51,29280,25,1856,26,27424,1492.293124,81.54162,182.091059755742,2690.5523829426
192.168.43.233,51697,52.216.0.24,80,11,619,6,337,5,282,1492.417587,81.4061790000001,33.1178791722923,27.7128840551526
192.168.43.233,51698,52.84.110.12,443,20,7024,10,1196,10,5828,1492.443326,81.1748769999999,117.868980571415,574.364898637297
192.168.43.233,51699,157.240.16.39,443,32,5044,15,3157,17,1887,1573.619147,67.6426819999999,373.373722821931,223.172700337341
192.168.43.233,51700,157.240.16.39,443,72,11939,37,7474,35,4465,1794.976728,161.601845,369.995775728922,221.037080362542
192.168.43.233,51701,172.217.166.206,443,25,2306,12,1244,13,1062,1812.966871,286.197624,34.7731747766012,29.6857810391885
192.168.43.233,51702,52.84.108.201,443,12393,10928733,4766,272546,7627,10656187,1841.279723,419.57732,5196.58212221767,203179.466421112
192.168.43.233,51703,172.217.166.206,443,48,7385,23,3307,25,4078,1850.967288,242.063645,109.293570292226,134.774472226096
192.168.43.233,51704,204.79.197.200,443,35,11774,19,3602,16,8172,2027.864793,60.607538,475.452409896604,1078.67770507358
192.168.42.240,50919,204.79.197.200,443,13,4179,6,3603,7,576,1.859013,124.227077,232.026710247718,37.0933625042148
192.168.42.240,50907,172.217.161.14,80,5,283,3,163,2,120,7.234941,6.246954,208.741732370688,153.674894996826
192.168.42.240,50906,104.20.42.93,443,4,229,3,163,1,66,7.560692,5.833573,223.533673102231,90.5105670229892
192.168.42.240,50927,172.217.163.78,443,57,17798,30,11673,27,6125,8.300821,240.699023,387.970000193977,203.573738643717
192.168.42.240,50910,146.185.181.89,80,5,271,3,163,2,108,10.241651,3.418242,381.482645172577,252.76150723091
192.168.42.240,50909,146.185.181.89,80,10,542,5,272,5,270,10.580769,98.069976,22.1882383248467,22.0250895136346
192.168.42.240,50913,172.217.194.189,443,3,162,2,108,1,54,13.393598,0.133039999999999,6494.2874323512,3247.1437161756
192.168.42.240,50900,172.82.246.68,443,2,108,2,108,0,0,13.394593,0.000126,0,0
192.168.42.240,50928,172.217.161.5,443,113,27407,53,18004,60,9403,13.397335,594.973048,242.081553919397,126.432617835153
192.168.42.240,50899,172.217.161.10,443,68,29700,29,2430,39,27270,21.606896,258.515885,75.198473780441,843.89398353606
192.168.42.240,50929,52.114.132.73,443,17,7032,9,2392,8,4640,25.907692,1.46308,13079.2574568718,25371.1348661728
192.168.42.240,50891,172.217.166.195,443,18,1237,8,460,10,777,27.880392,151.782934,24.2451499850438,40.9532207356065
192.168.42.240,50903,172.217.161.5,443,407,258090,149,33909,258,224181,28.847861,150.599616,1801.27949330229,11908.7156238167
192.168.42.240,50930,74.125.68.189,443,52,10006,25,3630,27,6376,28.932661,262.737212,110.528690545746,194.14075231947
192.168.42.240,50901,172.217.163.67,443,20,1345,9,514,11,831,36.393064,152.587489,26.9484741307985,43.5684474760575
192.168.42.240,50893,74.125.68.188,5228,27,1614,14,768,13,846,44.861524,563.508857,10.9031116790415,12.0104589589441
192.168.42.240,50931,104.16.92.188,80,11,1337,6,569,5,768,44.893625,46.367873,98.171421406369,132.50553891053
192.168.42.240,50924,117.18.232.200,443,5,365,2,108,3,257,46.115628,0.004163999999996,0,0
192.168.42.240,50918,131.253.61.80,443,1,54,0,0,1,54,47.61006,0,0,0
192.168.42.240,50926,104.25.219.21,443,19,1062,8,432,11,630,103.04956,5.601185,617.012292934442,899.809593862727
192.168.42.240,50932,172.217.161.14,443,19,5607,10,1175,9,4432,107.0296,50.855166,184.838645497686,697.19563986872
192.168.42.240,50933,172.217.161.14,443,15,859,8,457,7,402,107.28123,72.101746,50.706122983485,44.6036355347067
192.168.42.240,50920,13.107.54.254,443,1,54,0,0,1,54,108.655607,0,0,0
192.168.42.240,50923,204.79.197.254,443,1,54,0,0,1,54,109.019,0,0,0
192.168.42.240,50925,13.107.6.254,443,1,54,0,0,1,54,112.01438,0,0,0
192.168.42.240,50922,13.107.136.254,443,1,54,0,0,1,54,113.970725,0,0,0
192.168.42.240,50540,52.230.84.217,443,12,1064,9,642,3,422,124.403928,486.36246,10.560025541445,6.94132520013983
192.168.42.240,50561,52.230.84.217,443,15,2338,8,505,7,1833,144.81936,470.695254,8.58304808826477,31.1539151401769
192.168.42.240,50935,216.58.221.67,443,167,93834,74,8662,93,85172,160.287529,260.408984,266.104490465659,2616.5610323183
192.168.42.240,50936,216.58.221.67,443,41,8282,22,2611,19,5671,160.538018,51.003335,409.541846626304,889.51046044342
192.168.42.240,50937,216.58.221.67,443,41,8282,22,2611,19,5671,160.588372,50.952983,409.946557986605,890.38947925777
192.168.42.240,50938,216.58.221.67,443,41,8281,22,2611,19,5670,160.588778,50.954377,409.935342747886,890.208116959216
192.168.42.240,50939,216.58.221.67,443,41,8281,22,2611,19,5670,160.589045,50.952306,409.952004920052,890.244300228532
192.168.42.240,50940,216.58.221.67,443,41,8283,22,2611,19,5672,160.589279,50.95208,409.953823278657,890.562269489293
192.168.42.240,50941,172.217.166.206,443,33,7985,14,2119,19,5866,170.708608,11.645363,1455.68669692821,4029.75845407309
192.168.42.240,50942,172.217.166.206,443,177,57640,80,33486,97,24154,170.709209,125.00991,2142.9341081839,1545.73345425175
192.168.42.240,50943,172.217.166.206,443,20,1212,11,666,9,546,170.959385,40.710773,130.874449374862,107.293467505518
192.168.42.240,50944,216.58.221.46,443,155,48231,67,27269,88,20962,178.677047,128.052019,1703.62015143236,1309.59278353901
192.168.42.240,50945,216.58.221.46,443,13,750,7,402,6,348,178.842113,32.724532,98.274896643289,85.0737911240412
192.168.42.240,50946,172.217.24.68,443,42,9011,19,4199,23,4812,179.054204,242.034939,138.789879423152,159.051416952657
192.168.42.240,50947,172.217.24.68,443,15,858,8,456,7,402,179.206319,32.465936,112.363925069032,99.0576707845417
192.168.42.240,50921,13.35.129.85,443,19,1378,6,384,13,994,179.259967,0.340752000000009,9015.3542752498,23336.6201812456
192.168.42.240,50948,13.35.130.15,443,455,290849,185,40624,270,250225,179.533709,47.320507,6867.88922189696,42303.0125184415
192.168.42.240,50949,13.35.130.15,443,17,1002,9,510,8,492,179.534353,32.137903,126.95290044282,122.472209838956
192.168.42.240,50950,172.217.163.101,443,3929,2717701,2210,2615609,1719,102092,179.543635,116.338647,179861.744481178,7020.33263288682
192.168.42.240,50951,172.217.163.101,443,12,696,6,348,6,348,179.625598,32.044558,86.8790263856971,86.8790263856971
192.168.42.240,50952,172.217.166.206,443,115,33272,55,16999,60,16273,207.877764,88.337467,1539.46003455136,1473.71216790719
192.168.42.240,50953,172.217.166.206,443,21,1266,11,654,10,612,208.128372,18.725002,279.412520222962,261.468596905891
192.168.42.240,50954,172.217.166.206,443,18,5554,9,1120,9,4434,209.300611,14.613018,613.151917009889,2427.42464287665
192.168.42.240,50955,172.217.24.68,443,80,14045,36,3893,44,10152,211.717794,396.680002,78.5116462714952,204.739335460627
192.168.42.240,50956,13.35.130.15,443,289,172514,118,18951,171,153563,223.914223,71.921986,2107.95068979324,17081.0633621825
192.168.42.240,50957,13.35.130.15,443,15,1722,9,1090,6,632,224.215988,47.535616,183.441401074933,106.362353650787
192.168.42.240,50958,13.35.130.15,443,13,1533,8,1024,5,509,224.216222,47.535297,172.335096591487,85.6626603174479
192.168.42.240,50959,13.35.130.15,443,11,1401,7,958,4,443,225.867681,45.884003,167.029890569923,77.2382479357784
192.168.42.240,50960,216.58.221.67,443,45,11984,21,4596,24,7388,226.822324,241.147137,152.47122755598,245.095176062571
192.168.42.240,50961,104.237.191.1,443,76,13073,33,6061,43,7012,227.927194,380.478467,127.439537859576,147.435413210914
192.168.42.240,50962,104.237.191.1,443,15,834,9,498,6,336,228.033201,52.17948,76.3518532572575,51.514503402487
192.168.42.240,50963,216.58.221.46,443,100,23481,44,13004,56,10477,234.746628,60.972492,1706.21204066909,1374.6526876415
192.168.42.240,50964,216.58.221.46,443,27,7559,14,1861,13,5698,234.997704,36.753698,405.074885253724,1240.25615055116
192.168.42.240,50965,216.58.221.46,443,15,918,9,546,6,372,236.282167,43.851364,99.609216260639,67.8656198698859
192.168.42.240,50966,216.58.221.46,443,63,19208,26,11042,37,8166,278.289794,61.7723150000001,1430.02573240132,1057.56114207473
192.168.42.240,50967,172.217.166.234,443,22,1236,12,684,10,552,280.058003,44.934324,121.777730538463,98.2767649959527
192.168.42.240,50968,172.217.166.234,443,80,13537,37,6659,43,6878,280.297168,328.073226,162.378383172298,167.718654371387
192.168.42.240,50969,172.217.163.101,443,7694,5847053,4862,5674620,2832,172433,283.409933,324.817897,139761.264447815,4246.88421648146
192.168.42.240,50970,172.217.163.101,443,19,2730,9,1330,10,1400,283.711263,12.860452,827.3426159516,870.886964159579
192.168.42.240,50971,216.58.221.46,443,16,1949,9,1318,7,631,285.140604,11.39208,925.555298066725,443.114865766391
192.168.42.240,50972,64.233.184.94,443,18,1056,10,588,8,468,287.980766,37.346585,125.955291494524,100.250129965029
192.168.42.240,50973,64.233.184.94,443,182,36020,84,23316,98,12704,288.232691,320.641681,581.733477127074,316.964406134086
192.168.42.240,50974,216.58.221.46,443,147,37192,63,20277,84,16915,290.712868,101.072927,1604.94016365035,1338.8352748506
192.168.42.240,50975,172.217.161.14,443,16,5627,8,1219,8,4408,295.146319,14.641649,666.045197504736,2408.47188728538
192.168.42.240,50976,172.217.161.14,443,17,942,9,498,8,444,295.397125,29.595203,134.616410639251,120.019450449453
192.168.42.240,50977,13.35.130.79,443,1290,692371,551,172103,739,520268,296.118426,311.012503,4426.9088435972,13382.5616650531
192.168.42.240,50978,13.35.130.79,443,11,1401,7,958,4,443,296.119203,13.669061,560.682259008135,259.271650042384
192.168.42.240,50979,172.217.163.67,443,72,14576,28,4775,44,9801,296.178424,51.909848,735.891193516883,1510.46483511183
192.168.42.240,50980,172.217.163.67,443,16,5627,8,1219,8,4408,296.179005,17.092531,570.541600889885,2063.12336072405
192.168.42.240,50981,172.217.163.67,443,17,5693,7,1165,10,4528,296.179534,0.805616999999984,11568.7727542991,44964.2944476106
192.168.42.240,50982,13.35.130.79,443,12,696,7,402,5,294,296.215555,31.720454,101.385686346103,74.147740760583
192.168.42.240,50983,172.217.163.67,443,22,1212,12,660,10,552,296.37858,31.606327,167.055159557135,139.718860720513
192.168.42.240,50984,172.217.163.99,443,77,17805,38,9385,39,8420,297.353183,309.877366,242.289396509198,217.37631524853
192.168.42.240,50985,172.217.163.99,443,17,943,9,499,8,444,297.398805,68.597386,58.1946373291833,51.7803987458064
192.168.42.240,50986,35.188.42.15,443,35,8267,18,3376,17,4891,310.531512,61.125427,441.845584162545,640.126407624114
192.168.42.240,50987,35.188.42.15,443,22,1332,13,786,9,546,310.640265,53.113513,118.387951480445,82.2389586619887
192.168.42.240,50988,216.58.221.46,443,45,10006,22,8028,23,1978,323.176544,50.685639,1267.10447509599,312.198885368694
192.168.42.240,50989,216.58.221.46,443,37,5758,19,4050,18,1708,323.428167,50.4359940000001,642.39836335931,270.917630769803
192.168.42.240,50990,216.58.221.46,443,33,5154,17,3714,16,1440,325.431162,45.5186210000001,652.743851796388,253.083238176306
192.168.42.240,50991,216.58.221.46,443,26,1572,14,840,12,732,327.17239,39.436208,170.401778994573,148.492978838128
192.168.42.240,50992,216.58.221.46,443,38,10428,18,3406,20,7022,331.290371,39.850757,683.751126735184,1409.65954548868
192.168.42.240,50993,216.58.221.46,443,40,11325,20,4289,20,7036,331.541335,39.599794,866.46915385469,1421.42153567769
192.168.42.240,50994,172.217.163.67,443,54,9677,28,7673,26,2004,332.080811,39.113092,1569.39778629621,409.88833099669
192.168.42.240,50995,172.217.163.67,443,36,6468,19,4950,17,1518,332.383125,38.807928,1020.4100564194,312.925750635283
192.168.42.240,50996,216.58.221.46,443,458,145136,198,77138,260,67998,336.020358,271.100821,2276.2896760095,2006.57452084957
192.168.42.240,50997,216.58.221.46,443,42,11918,22,4409,20,7509,336.021026,42.869261,822.78068660899,1401.28377766997
192.168.42.240,50998,216.58.221.46,443,42,11916,22,4409,20,7507,336.354383,42.536087,829.225311674767,1411.88351434395
192.168.42.240,50999,216.58.221.46,443,41,11838,21,4343,20,7495,337.033483,41.857134,830.061609091534,1432.49177069792
192.168.42.240,51000,172.217.163.67,443,28,5028,11,4014,17,1014,342.382384,51.273528,626.288091585974,158.210295183901
192.168.42.240,51001,172.217.163.67,443,40,7464,22,5904,18,1560,344.157227,47.601166,992.244601739377,262.178451679104
192.168.42.240,51002,172.217.163.67,443,41,6550,21,4722,20,1828,352.399247,41.256666,915.633851751375,354.463930750003
192.168.42.240,51003,172.217.163.67,443,41,6550,21,4722,20,1828,354.153512,39.511133,956.08495964922,370.123529487246
192.168.42.240,51004,172.217.163.78,443,43,11363,20,4217,23,7146,356.450915,38.763747,870.297703676583,1474.78003093973
192.168.42.240,51005,172.217.163.78,443,22,1308,12,720,10,588,356.702308,30.824128,186.866600086789,152.607723404211
192.168.42.240,51006,172.217.163.67,443,219,29082,89,14658,130,14424,378.915683,228.326677,513.579935295953,505.381156140594
192.168.42.240,51007,172.217.163.67,443,35,6368,19,4926,16,1442,379.21702,38.076456,1034.9702713929,302.969372989965
192.168.42.240,51008,216.58.221.46,443,227,67508,98,39915,129,27593,382.851235,225.399032,1416.68753927923,979.347595423569
192.168.42.240,51009,172.217.163.67,443,32,5902,17,4242,15,1660,389.182332,28.111524,1207.19175523888,472.404128641335
192.168.42.240,51010,172.217.163.67,443,32,5902,17,4242,15,1660,390.169227,27.125004,1251.09658970004,489.585181259327
192.168.42.240,51011,172.217.161.14,443,31,7364,16,2461,15,4903,395.155014,22.20918,886.480275273558,1766.11653379368
192.168.42.240,51012,172.217.161.14,443,9,534,5,294,4,240,395.40611,21.958086,107.113160955832,87.4393150659853
192.168.42.240,51013,172.217.166.206,443,34,12488,17,2551,17,9937,417.295051,37.723483,540.989282458356,2107.33457459376
192.168.42.240,51014,172.217.166.206,443,32,11396,16,2485,16,8911,417.295889,37.722152,527.011290342078,1889.81795100131
192.168.42.240,51015,172.217.166.206,443,34,12488,17,2551,17,9937,417.296678,37.721639,541.015728399288,2107.43759039738
192.168.42.240,51016,172.217.166.206,443,32,11392,16,2485,16,8907,417.297276,37.721483,527.020637020024,1889.00314444159
192.168.42.240,51017,13.35.130.42,443,46,10732,20,2201,26,8531,420.486498,187.763766,93.7774117717686,363.478009915928
192.168.42.240,51019,54.239.25.128,443,52,16239,25,4248,27,11991,488.067424,2.895713,11735.9696903664,33127.5924098832
192.168.42.240,51020,104.108.212.173,80,18,2553,13,1128,5,1425,488.455066,97.798645,92.2712170500931,116.566032177644
192.168.42.240,51021,54.239.25.128,443,64,23887,32,11288,32,12599,490.158389,5.61869899999999,16072.0479954524,17938.6722798285
192.168.42.240,51022,104.108.212.173,443,36,21115,14,1205,22,19910,490.166144,2.79007700000005,3455.10177676093,57088.0301869794
192.168.42.240,51023,104.108.212.173,443,28,4309,12,1420,16,2889,491.58961,116.617621,97.4123799009757,198.18617291121
192.168.42.240,51024,104.108.212.173,443,24,3069,10,1130,14,1939,491.673279,116.541803,77.5687329978926,133.102454232667
192.168.42.240,51025,54.239.25.128,443,2,128,1,66,1,62,495.067354,0.709586000000002,744.09585307489,698.999134706715
192.168.42.240,51026,54.239.25.128,443,174,92496,87,77408,87,15088,495.707575,20.521358,30176.5604401035,5881.87195018966
192.168.42.240,51027,54.182.215.114,443,10634,9155549,4032,241895,6602,8913654,501.982433,115.565694,16745.1077652854,617044.985685804
192.168.42.240,51028,54.182.215.114,443,29,1676,14,806,15,870,502.102311,104.579367,61.6565215966549,66.5523248003595
192.168.42.240,51029,13.35.129.69,443,86,41026,42,3596,44,37430,502.201717,106.170638,270.960036992525,2820.36545734989
192.168.42.240,51030,13.35.129.69,443,17,1015,13,751,4,264,502.205223,74.378503,80.7760274497593,28.3953012606344
192.168.42.240,51034,172.217.194.188,5228,24,4938,12,3124,12,1814,608.35585,7.15503100000001,3492.92686502686,2028.22321804056
192.168.42.240,51035,172.217.27.4,443,38,9545,19,6193,19,3352,608.356837,8.20778199999995,6036.22269694788,3267.14330375736
192.168.42.240,51036,172.217.166.206,443,49,10278,24,5421,25,4857,608.371256,7.98134800000003,5433.66859833701,4868.35055932906
192.168.42.240,51037,172.217.166.206,443,11,1502,6,926,5,576,608.434883,1.44450800000004,5128.38973546688,3190.01348556039
192.168.42.240,51038,172.217.161.5,443,2,132,2,132,0,0,613.865835,3.00002900000004,351.996597366221,0
192.168.42.240,51039,172.217.161.5,443,2,132,2,132,0,0,614.107575,3.00039400000003,351.953776737319,0
192.168.42.240,51040,216.58.221.35,443,2,132,2,132,0,0,615.133483,3.00107300000002,351.874146346988,0
192.168.42.240,51041,216.58.221.35,443,1,66,1,66,0,0,615.384828,0,0,0
192.168.42.240,51042,216.58.221.35,443,1,66,1,66,0,0,616.170364,0,0,0
172.30.1.136,51222,172.217.194.188,5228,1,66,1,66,0,0,1625.707917,0,0,0
172.30.1.136,51223,172.217.194.188,5228,1,66,1,66,0,0,1625.956425,0,0,0
172.30.1.136,51224,52.84.108.120,443,1,66,1,66,0,0,1627.350544,0,0,0
172.30.1.136,51225,52.175.23.79,443,1,66,1,66,0,0,1627.353819,0,0,0
172.30.1.136,51226,52.84.108.120,443,1,66,1,66,0,0,1627.466207,0,0,0
192.168.43.233,51113,172.217.161.3,443,10,629,5,272,5,357,2.455257,58.050471,37.4846226484536,49.1985672260954
192.168.43.233,51099,172.217.160.238,443,7,454,3,163,4,291,3.94434,8.622303,151.235696541864,269.997470513388
192.168.43.233,51127,40.100.141.2,443,1,54,0,0,1,54,8.011089,0,0,0
192.168.43.233,51126,40.100.141.2,443,1,54,0,0,1,54,8.710218,0,0,0
192.168.43.233,51060,172.217.161.14,443,32,2553,15,1295,17,1258,10.372632,258.061252,40.1455077804552,38.9984932724422
192.168.43.233,51080,172.217.160.227,443,16,980,8,437,8,543,10.574725,196.643128,17.7783990498768,22.0907795974442
192.168.43.233,51116,172.217.31.10,443,9,575,4,218,5,357,11.062277,57.608149,30.2734948140757,49.5763194891056
192.168.43.233,51130,117.18.237.29,80,2,108,1,54,1,54,12.523597,0.000238,0,0
192.168.43.233,51132,13.107.21.200,443,1,54,0,0,1,54,15.80257,0,0,0
192.168.43.233,51093,172.217.160.229,443,583,306955,284,91574,299,215381,16.0079,829.962319,882.681036511008,2076.05569621047
192.168.43.233,51133,13.107.49.254,443,1,54,0,0,1,54,17.678756,0,0,0
192.168.43.233,51135,13.107.140.254,443,1,54,0,0,1,54,17.690899,0,0,0
192.168.43.233,51048,172.217.160.238,443,16,979,8,436,8,543,18.434956,151.421517,23.0350353708317,28.6881289136735
192.168.43.233,51131,204.79.197.222,443,1,54,0,0,1,54,18.492728,0,0,0
192.168.43.233,51134,13.107.42.254,443,1,54,0,0,1,54,19.181299,0,0,0
192.168.43.233,51121,13.107.21.200,443,1,54,0,0,1,54,20.66149,0,0,0
192.168.43.233,51043,74.125.24.188,5228,31,1941,15,867,16,1074,34.728427,840.855134,8.24874549674808,10.2181691620616
192.168.43.233,51103,172.217.160.227,443,11,696,5,273,6,423,41.762269,104.643884,20.8707849567205,32.3382492186548
192.168.43.233,51138,52.46.7.55,443,2171,1853331,868,52887,1303,1800444,120.486636,212.080966,1994.97393839672,67915.345123428
192.168.43.233,51139,52.46.7.55,443,11,643,6,349,5,294,120.605554,123.785874,22.5550776496517,19.0005525186178
192.168.43.233,51140,172.217.161.5,443,51,5823,24,2687,27,3136,244.18165,242.889991,88.5009707954578,103.289558769838
192.168.43.233,51032,52.230.84.217,443,26,4052,10,936,16,3116,254.565774,520.844146,14.376661535906,47.8607663951742
192.168.43.233,51142,23.100.94.137,443,44,16748,23,10686,21,6062,313.092769,149.833013,570.555168639637,323.666987862014
192.168.43.233,51143,52.114.74.45,443,31,11002,16,5551,15,5451,474.241631,12.725846,3489.59118317164,3426.7269932388
192.168.43.233,51144,172.217.24.234,443,24,7640,12,2234,12,5406,475.047685,12.955965,1379.44182467304,3338.07632237352
192.168.43.233,51145,172.217.24.234,443,9,534,5,294,4,240,475.299634,11.38606,206.568382741704,168.627251217717
192.168.43.233,51146,74.125.158.9,443,24,8979,11,2373,13,6606,475.757653,3.71767599999998,5106.41594372401,14215.3323743113
192.168.43.233,51147,74.125.158.9,443,12,696,6,348,6,348,476.005009,14.301295,194.667685688603,194.667685688603
192.168.43.233,51148,74.125.158.121,443,24,8950,11,2619,13,6331,476.027616,5.44054499999999,3851.08477183813,9309.36147022038
192.168.43.233,51149,74.125.158.121,443,11,642,6,348,5,294,476.082454,25.408549,109.569420906326,92.5672693863786
192.168.43.233,51150,74.125.158.168,443,24,8974,11,2619,13,6355,476.169068,7.441507,2815.55873024106,6831.94949625123
192.168.43.233,51151,74.125.158.119,443,24,8973,11,2619,13,6354,476.169334,7.599987,2756.84682092219,6688.43249337137
192.168.43.233,51152,74.125.158.136,443,24,8992,11,2619,13,6373,476.192811,6.01453099999998,3483.56339006318,8476.80392702277
192.168.43.233,51153,74.125.158.168,443,9,534,5,294,4,240,476.212715,25.278288,93.0442757832335,75.9545108434559
192.168.43.233,51154,74.125.158.136,443,2518,2067665,1109,70664,1409,1997001,476.299012,87.890001,6432.03997687973,181772.759338119
192.168.43.233,51155,74.125.158.119,443,11,642,6,348,5,294,476.403047,25.087956,110.9695823765,93.7501644215257
192.168.43.233,51156,52.114.158.91,443,32,11856,17,5035,15,6821,477.730794,12.208348,3299.38170176669,4469.72841861978
192.168.43.233,51157,173.194.166.76,443,23,8730,11,2405,12,6325,479.52813,6.36041900000004,3024.95794695285,7955.45073367017
192.168.43.233,51158,173.194.166.76,443,1193,956122,538,36752,655,919370,479.611053,83.437394,3523.79174258487,88149.4453194452
192.168.43.233,51159,172.217.160.238,443,19,5812,9,1285,10,4527,480.460762,21.013264,489.214812130091,1723.48284397893
192.168.43.233,51160,172.217.160.238,443,18,5759,9,1285,9,4474,480.461211,20.146171,510.270661357933,1776.61551666567
192.168.43.233,51161,172.217.160.238,443,9,534,5,294,4,240,480.711627,20.779376,113.189154477016,92.3993097771562
192.168.43.233,51162,74.125.170.249,443,29,10146,13,3298,16,6848,481.67544,6.29208199999999,4193.20663653144,8706.81596330119
192.168.43.233,51163,74.125.170.249,443,18,2316,9,1492,9,824,481.886763,20.682019,577.119670956689,318.730971091362
192.168.43.233,51164,74.125.170.89,443,9,534,5,294,4,240,483.63688,17.938602,131.113896166491,107.031751972645
192.168.43.233,51165,74.125.170.89,443,23,9047,11,2439,12,6608,483.6775,7.114733,2742.47817873137,7430.21558222916
192.168.43.233,51166,74.125.103.103,443,1149,909840,528,35624,621,874216,483.92708,80.665802,3532.99654790514,86700.0367764272
192.168.43.233,51167,74.125.103.103,443,9,534,5,294,4,240,484.076672,17.4988100000001,134.409139821507,109.721746793067
192.168.43.233,51168,104.237.191.1,443,30,9059,16,2990,14,6069,486.687278,51.910305,460.794826768982,935.305619953495
192.168.43.233,51169,104.237.191.1,443,13,750,6,348,7,402,486.936681,14.566657,191.121408295672,220.778178548449
192.168.43.233,51170,172.217.160.238,443,27,6585,9,1287,18,5298,500.608716,274.278042,37.5385500236289,154.529322474892
192.168.43.233,51171,172.217.160.238,443,11,642,6,348,5,294,500.859822,41.06755,67.7907496307913,57.2714953777374
192.168.43.233,51173,172.217.161.1,443,2928,2681928,1082,63644,1846,2618284,540.846124,91.191326,5583.33804686643,229695.881382402
192.168.43.233,51174,172.217.161.1,443,35,29221,11,3531,24,25690,549.196483,7.77741200000003,3632.05652471541,26425.2427414157
192.168.43.233,51175,204.79.197.200,443,5,302,3,186,2,116,557.881181,131.437932,11.3209328339098,7.06036671362115
192.168.43.233,51176,172.217.161.1,443,21,5331,9,827,12,4504,563.478399,1.45105599999999,4559.43809198269,24831.570938682
192.168.43.233,51177,172.217.161.1,443,23,6245,10,893,13,5352,567.546285,5.93580099999997,1203.54439106029,7213.17982189771
192.168.43.233,51179,13.107.4.52,80,10,1476,5,393,5,1083,632.333487,0.894641999999976,3514.25486395685,9684.32065563682
192.168.43.233,51180,23.9.140.60,443,17,2462,9,1392,8,1070,633.350029,2.16591500000004,5141.47600436757,3952.14031944921
192.168.43.233,51181,52.229.174.172,443,27,9242,14,1375,13,7867,634.397604,1.95242299999995,5634.0250038031,32234.8179672138
192.168.43.233,51182,52.230.7.59,443,56,15860,27,7480,29,8380,634.44425,1124.714644,53.2046064477133,59.6062302181601
192.168.43.233,51183,131.253.14.229,443,28,12449,16,1825,12,10624,634.557418,33.3296330000001,438.048627778169,2550.04308028234
192.168.43.233,51184,131.253.61.100,443,238,91336,115,33189,123,58147,634.761117,286.055069,928.18491533181,1626.17639193102
192.168.43.233,51185,74.125.68.188,5228,6,384,1,66,5,318,635.165285,12.685359,41.6227873409024,200.546157187984
192.168.43.233,51186,104.104.182.224,443,18,6781,9,1169,9,5612,636.153988,1.29577699999993,7217.29124687389,34647.9371064639
192.168.43.233,51187,131.253.61.100,443,250,86784,121,23601,129,63183,636.859026,108.460178,1740.80481409499,4660.36483915783
192.168.43.233,51188,74.125.68.188,443,67,9195,36,3066,31,6129,638.204071,952.233945,25.7583760049638,51.4915481195117
192.168.43.233,51189,40.77.226.13,443,36,11320,20,4360,16,6960,642.093717,117.878509,295.897872274581,472.350731887863
192.168.43.233,51190,172.217.161.5,443,119,18545,57,10961,62,7584,646.026053,733.886707,119.484382485211,82.6721610042734
192.168.43.233,51191,172.217.161.5,443,11,643,6,349,5,294,646.041018,58.889174,47.4110912134716,39.9394292743858
192.168.43.233,51192,40.77.226.13,443,32,13801,18,4628,14,9173,651.397825,112.582257,328.861767267643,651.825624707453
192.168.43.233,51193,23.9.140.60,443,19,3520,10,2396,9,1124,666.876534,76.608869,250.206017269358,117.375443827529
192.168.43.233,51194,131.253.14.229,443,80,45522,42,4205,38,41317,668.200323,76.929536,437.283282197361,4296.60722248474
192.168.43.233,51195,204.79.197.213,443,50,19277,25,6966,25,12311,675.767935,68.274542,816.233963165949,1442.52890045019
192.168.43.233,51196,52.175.18.194,443,40,12706,20,5243,20,7463,681.925025,75.283454,557.147656907453,793.056067804753
192.168.43.233,51197,52.175.18.194,443,33,17023,17,6561,16,10462,684.002555,73.5237979999999,713.891303602135,1138.35251002675
192.168.43.233,51198,172.217.160.227,443,13,1552,8,1033,5,519,724.356377,77.345095,106.845818729682,53.6814907267229
192.168.43.233,51199,172.217.160.227,443,9,535,5,295,4,240,724.608114,57.720058,40.8869998016981,33.2639998386696
192.168.43.233,51200,52.46.6.85,443,8,480,5,294,3,186,749.541561,32.659723,72.0153076619787,45.5607048473743
192.168.43.233,51201,52.46.6.85,443,8690,7197901,3771,234753,4919,6963148,749.552017,668.166957,2810.71067691245,83370.156839408
192.168.43.233,51202,52.84.110.171,443,449,151058,219,38158,230,112900,781.613194,950.309186,321.225980446326,950.427516966042
192.168.43.233,51203,52.84.110.171,443,11,644,6,350,5,294,781.746765,124.612233,22.4697040779295,18.8745514254608
192.168.43.233,51204,172.217.160.238,443,32,2958,17,1551,15,1407,801.701916,339.207167,36.5794157881104,33.1832611308003
192.168.43.233,51205,172.217.160.238,443,9,535,5,295,4,240,801.953808,58.900676,40.0674518574286,32.5972489687555
192.168.43.233,51206,13.68.93.109,443,24,6450,13,1403,11,5047,970.904097,2.92145700000003,3841.91860431281,13820.5012088145
192.168.43.233,51207,52.114.128.8,443,19,7339,10,2645,9,4694,976.069811,5.32052300000009,3977.05263185586,7057.95276141074
192.168.43.233,51208,52.216.228.96,80,67,43054,30,2186,37,40868,1154.497468,62.0371869999999,281.895437973357,5270.12934999778
192.168.43.233,51209,52.216.228.96,80,11,618,6,336,5,282,1154.594914,61.93974,43.3970178111823,36.422497091528
192.168.43.233,51210,172.217.160.229,443,44,5876,23,3188,21,2688,1216.416402,245.426141,103.917210677244,87.6190283251042
192.168.43.233,51211,172.217.160.229,443,10,590,6,350,4,240,1216.62293,103.540746,27.0424939762362,18.5434244408477
192.168.43.233,51212,52.84.108.135,443,4337,3490924,1929,117376,2408,3373548,1437.710558,346.18808,2712.42152531653,77958.7327212422
192.168.43.233,51213,52.84.108.135,443,15,1699,9,1120,6,579,1437.710783,72.9645049999999,122.799435150009,63.4829222784422
192.168.43.233,51214,52.84.108.135,443,12,696,7,402,5,294,1437.928283,75.7209809999999,42.4717159963895,31.0614042361654
192.168.43.233,51215,172.217.160.229,443,39,7382,19,4169,20,3213,1442.956286,276.133672,120.782082671903,93.0853517929534
192.168.43.233,51216,172.217.160.229,443,7,403,4,229,3,174,1443.016607,61.894442,29.5987804526939,22.4899030513919
192.168.43.233,51217,172.217.160.238,443,9,511,5,283,4,228,1510.676327,59.149363,38.2759827861544,30.837187545029
192.168.43.233,51218,172.217.160.238,443,26,7290,10,1352,16,5938,1510.927823,273.702836,39.5173106646217,173.5604960995
192.168.43.233,51219,52.114.132.73,443,23,9007,13,3889,10,5118,1533.878892,12.567164,2475.65799252718,3258.01429821397
192.168.43.233,51220,104.121.28.119,443,28,10477,15,1550,13,8927,1536.960293,325.08835,38.1434769963304,219.681818804027
192.168.43.233,51221,23.32.125.203,80,17,6018,9,972,8,5046,1536.96035,308.468558,25.2084038983318,130.865849867266
192.168.43.233,51227,104.104.182.224,443,21,7081,10,1349,11,5732,1628.720538,2.29941000000008,4693.37786649603,19942.5069909231
192.168.43.233,51228,13.107.4.52,80,10,1476,5,393,5,1083,1628.867165,0.291351999999961,10791.0705950205,29737.2250748276
192.168.43.233,51229,204.79.197.213,443,39,15685,20,4870,19,10815,1629.156632,3.35443800000007,11614.4641814811,25792.6961237615
192.168.43.233,51230,52.230.85.180,443,80,21382,49,13312,31,8070,1630.874187,2144.385085,49.6627218427049,30.1065328478537
192.168.43.233,51231,172.217.160.229,443,6,384,1,66,5,318,1631.600488,12.2717,43.025823643016,207.306241189077
192.168.43.233,51232,172.217.160.227,443,277,31392,126,17032,151,14360,1631.690439,329.346224,413.716599951059,348.812257826281
192.168.43.233,51233,172.217.160.227,443,21,4271,12,3360,9,911,1631.690738,40.3476149999999,666.210381951946,180.630255344709
192.168.43.233,51234,172.217.160.227,443,20,4217,12,3360,8,857,1631.690991,40.0755140000001,670.733755280093,171.077032224714
192.168.43.233,51235,204.79.197.213,443,36,15430,19,5208,17,10222,1632.14445,71.2349710000001,584.881265691818,1147.97547962783
192.168.43.233,51236,13.107.4.52,80,15,2781,9,843,6,1938,1632.552648,2.19787299999984,3068.42115081284,7054.09275240248
192.168.43.233,51237,172.217.194.189,443,202,78584,98,9524,104,69060,1632.950144,456.545138,166.888208105285,1210.13226078864
192.168.43.233,51238,172.217.160.228,443,55,7785,26,4952,29,2833,1633.022341,247.200468,160.258596274179,91.6826743224451
192.168.43.233,51239,52.84.108.201,443,13551,11494839,5609,331791,7942,11163048,1634.691709,843.259259,3147.70098480472,105903.828563832
192.168.43.233,51240,172.217.160.229,443,90,38577,46,32260,44,6317,1634.692136,255.53647,1009.95368684556,197.764334773819
192.168.43.233,51241,172.217.194.188,5228,135,11216,71,6439,64,4777,1634.692346,2446.788164,21.0529055019575,15.6188429232568
192.168.43.233,51242,52.84.110.84,443,978,347774,447,87088,531,260686,1672.039924,1165.119059,597.968074265276,1789.93552967019
192.168.43.233,51243,52.84.110.84,443,11,644,6,350,5,294,1672.269554,126.807072,22.080787418544,18.5478614315769
192.168.43.233,51244,172.217.160.238,443,26,7005,14,2333,12,4672,1804.319664,144.083823,129.535707835848,259.404555083189
192.168.43.233,51245,172.217.160.238,443,10,590,6,350,4,240,1804.570102,103.897181,26.9497206088777,18.4798084175162
192.168.43.233,51246,172.217.160.229,443,40,9507,23,6324,17,3183,1949.966753,249.871173,202.472335614321,101.908514272673
192.168.43.233,51247,172.217.160.229,443,12,709,7,415,5,294,1950.029696,61.1488030000001,54.29378560362,38.4635493191911
192.168.43.233,51248,172.217.161.3,443,46,5927,22,3755,24,2172,1957.028571,245.771768,122.227220174451,70.6997396055678
192.168.43.233,51249,13.107.21.200,443,53,14300,28,4543,25,9757,2196.701215,61.2948059999999,592.937678928294,1273.45210946585
192.168.43.233,51250,13.107.21.200,443,29,10355,16,1312,13,9043,2196.701223,61.294645,171.238449949421,1180.26623696083
192.168.43.233,51251,52.229.207.60,443,37,15301,22,3617,15,11684,2196.854399,1.56010700000024,18547.4457841645,59913.8392430682
192.168.43.233,51252,172.217.160.229,443,44,7270,21,4211,23,3059,2266.365376,242.306565,139.030488092636,100.996025427541
192.168.43.233,51253,172.217.160.229,443,9,534,5,294,4,240,2266.51883,28.5912290000001,82.2629905136289,67.1534616437787
192.168.43.233,51254,52.84.108.242,443,36,11954,18,3784,18,8170,2295.288619,217.351965,139.276403597271,300.710416857745
192.168.43.233,51255,52.84.108.242,443,50,22854,24,4102,26,18752,2295.288827,217.593316,150.813456053034,689.432941956728
192.168.43.233,51256,52.84.108.242,443,35,11062,17,3251,18,7811,2295.288988,216.302219,120.239173320732,288.892089451935
192.168.43.233,51257,52.84.108.242,443,11,666,6,360,5,306,2295.302952,12.8539329999999,224.055936809382,190.447546287975
192.168.43.233,51258,52.84.108.242,443,90,53621,44,5019,46,48602,2300.549897,219.308781,183.084324380062,1772.91578671444
192.168.43.233,51259,52.84.108.242,443,59,30424,30,3629,29,26795,2300.636567,214.648485,135.253691634488,998.656011944365
192.168.43.233,51260,52.84.108.242,443,37,15462,18,2805,19,12657,2300.637757,214.654209,104.540228232841,471.716815951185
192.168.43.233,51261,52.84.108.242,443,11,644,6,350,5,294,2300.80144,123.300607,22.708728433105,19.0753318838082
192.168.43.233,51262,52.84.110.78,443,57,23528,27,2600,30,20928,2307.272296,181.762466,114.435067138669,921.114263491563
192.168.43.233,51263,52.84.110.78,443,42,11622,19,2687,23,8935,2307.2726,182.252084,117.946525099817,392.204020009998
192.168.43.233,51264,52.84.110.78,443,11,644,6,350,5,294,2307.274469,122.402174,22.8754106932774,19.215344982353
192.168.43.233,51265,52.84.110.78,443,11,644,6,350,5,294,2307.274821,122.403531,22.8751570900353,19.2151319556296
192.168.43.233,51266,52.84.108.85,443,43,19657,20,2245,23,17412,2310.274494,212.761395,84.4138101275373,654.705239171795
192.168.43.233,51267,52.84.108.85,443,200,172351,73,5025,127,167326,2310.606059,212.429831,189.238958628179,6301.4125356057
192.168.43.233,51268,52.114.132.73,443,26,11199,14,5974,12,5225,2484.944789,9.0974839999999,5253.32058841769,4594.67694584574
192.168.43.233,51269,13.107.21.200,443,35,11778,19,3605,16,8173,2532.193729,60.4503150000001,477.086016838787,1081.6155383144
192.168.43.233,51270,172.217.161.5,443,1663,1218859,801,61507,862,1157352,2564.443292,610.638099,805.806255465891,15162.5259137327
192.168.43.233,51271,172.217.161.5,443,9,535,5,295,4,240,2564.50645,57.1128820000004,41.3216759049208,33.6176346345118
192.168.43.233,51272,52.84.108.135,443,6130,5196067,2553,153038,3577,5043029,2652.235066,452.07921,2708.16258062387,89241.5114599055
192.168.43.233,51273,52.84.108.135,443,30,2814,16,1575,14,1239,2652.308004,189.01119,66.6627198103985,52.4413395841801
192.168.43.233,51274,13.107.21.200,443,93,49430,50,30261,43,19169,2696.043006,1201.9018,201.420781631245,127.59112266909
192.168.43.233,51275,13.107.21.200,443,36,13748,20,2178,16,11570,2696.330759,23.2209910000001,750.355572679904,3986.048657441
192.168.43.233,51276,13.107.21.200,443,33,14649,19,1617,14,13032,2702.036894,9.93209100000013,1302.44477220354,10496.8832846979
192.168.43.233,51277,13.107.42.254,443,47,16029,26,3685,21,12344,2702.353469,17.827573,1653.61824629746,5539.2845677872
192.168.43.233,51278,13.107.54.254,443,39,14956,21,2726,18,12230,2718.651387,183.171536,119.05779946072,534.144125973808
192.168.43.233,51279,13.107.42.254,443,10,826,6,578,4,248,2720.181767,181.641154,25.4567860761334,10.9226348561956
192.168.43.233,51280,13.107.42.254,443,9,566,5,318,4,248,2720.181776,125.724099,20.2347841045176,15.7805863456615
192.168.43.233,51281,23.9.140.60,80,16,4046,9,3344,7,702,2761.943758,6.66516300000012,4013.70529122836,842.590046184902
192.168.43.233,51282,207.46.155.185,80,116,71820,63,35950,53,35870,2768.384114,113.169904,2541.31169007619,2535.65647630133
192.168.43.233,51283,52.175.18.194,443,36,12279,19,4816,17,7463,2768.616815,10.8897420000003,3538.00852214855,5482.59086395237
192.168.43.233,51284,23.9.140.60,80,18,4406,9,3608,9,798,2770.968843,9.42874299999994,3061.27762735713,677.07858831236
192.168.43.233,51285,23.9.140.60,80,18,4154,9,3344,9,810,2775.001407,5.67661599999974,4712.66684235841,1141.52516217414
192.168.43.233,51286,23.9.140.60,80,20,4802,10,3938,10,864,2778.993151,6.45912899999985,4877.43780933942,1070.11332332891
192.168.43.233,51287,23.9.140.60,80,27,12080,15,11120,12,960,2781.992341,125.327639,709.819483633614,61.2793798820386
192.168.43.233,51288,23.9.140.60,80,29,13284,16,12270,13,1014,2784.753195,152.896274,642.00387250771,53.0555767500259
192.168.43.233,51289,23.9.140.60,80,36,13485,18,11589,18,1896,2789.252355,67.3063750000001,1377.46238747815,225.357553426402
192.168.43.233,51290,23.9.140.60,80,30,10402,15,8668,15,1734,2793.625966,65.75047,1054.6540579862,210.979480450862
192.168.43.233,51291,23.9.140.60,80,25,10728,13,9768,12,960,2798.603374,67.7344280000002,1153.68214226301,113.383994325603
192.168.43.233,51292,23.9.140.60,80,16,5290,9,4588,7,702,2801.824477,12.5279799999998,2929.76202069292,448.276577708463
192.168.43.233,51293,23.9.140.60,80,13,4010,8,3416,5,594,2807.137148,5.15068700000029,5305.69999691274,922.595374170423
192.168.43.233,51294,23.9.140.60,80,23,6292,12,4774,11,1518,2812.332671,8.1077449999998,4710.55762113892,1497.82707768933
192.168.43.233,51295,23.9.140.60,80,25,10728,14,9822,11,906,2815.861244,142.004871,553.333131790952,51.0405026881086
192.168.43.233,51296,23.9.140.60,80,29,10348,16,8722,13,1626,2820.175032,68.2947549999999,1021.68900086105,190.468506695719
192.168.43.233,51297,23.9.140.60,80,20,6750,11,5940,9,810,2825.580979,22.3074140000003,2130.23347305068,290.486382688729
192.168.43.233,51298,23.9.140.60,80,22,10534,13,9436,9,1098,2831.241763,65.7088199999998,1148.82598713537,133.680683962975
192.168.43.233,51299,172.217.161.3,443,23,2511,13,1522,10,989,2841.31955,189.778805,64.1589033085123,41.690640848961
192.168.43.233,51300,172.217.161.3,443,9,535,5,295,4,240,2841.571366,62.4467919999997,37.7921735355118,30.7461750797384
192.168.43.233,51301,13.107.42.254,443,33,10774,17,1446,16,9328,2900.166705,122.671814,94.3003907971885,608.322299693067
192.168.43.233,51303,13.107.21.200,443,42,15107,23,5220,19,9887,2901.827484,61.6889030000002,676.945090108019,1282.17549921417
192.168.43.233,51302,52.175.39.99,443,14,6089,8,1069,6,5020,2901.827842,9.73222399999986,878.730288164362,4126.49770494397
192.168.43.233,51304,52.175.39.99,443,18,7292,10,1421,8,5871,2902.488494,9.07189199999993,1253.10133762616,5177.31031189529
192.168.43.233,51305,13.107.42.254,443,7,434,4,252,3,182,2930.148463,127.464953,15.8161122139981,11.4227477101098
192.168.43.233,51306,13.107.54.254,443,7,434,4,252,3,182,2930.149192,127.270538,15.8402724753155,11.4401967877279
192.168.43.233,51307,52.84.110.71,443,637,177686,268,40835,369,136851,3031.201985,432.023441,756.162673126804,2534.14027133773
192.168.43.233,51308,52.84.110.71,443,29,2557,15,1445,14,1112,3031.202534,255.886834,45.1762203599737,34.7653681939728
192.168.43.233,51309,52.84.110.71,443,28,2503,15,1445,13,1058,3031.203016,255.806131,45.1904727803416,33.0875572329421
192.168.43.233,51310,52.84.110.71,443,28,2503,15,1445,13,1058,3031.203541,255.805776,45.1905354943979,33.0876031509155
192.168.43.233,51311,52.84.110.71,443,11,644,6,350,5,294,3031.267771,122.910927,22.7807247764065,19.1358088121815
192.168.43.233,51312,104.104.201.9,443,22,8999,11,1062,11,7937,3132.070434,63.7382789999997,133.295095714775,996.198846222382
192.168.43.233,51313,49.44.164.116,443,130,87675,68,8882,62,78793,3133.019341,66.735185,1064.7456810077,9445.45220036477
192.168.43.233,51314,49.44.164.116,443,18,5062,11,2890,7,2172,3135.962888,63.7937590000001,362.417897336947,272.377741527976
192.168.43.233,51315,172.217.161.5,443,139,64308,59,11382,80,52926,3287.089941,542.722856,167.776239738833,780.155092639032
192.168.43.233,51316,23.32.125.203,80,15,5625,7,603,8,5022,3349.043372,2.8372589999999,1700.23251314038,14160.1454079453
192.168.43.233,51317,104.25.14.32,443,410,269575,184,14047,226,255528,3362.719579,415.5169,270.448686924647,4919.71325354035
192.168.43.233,51318,104.25.14.32,443,20,6979,10,1145,10,5834,3362.720071,12.7352809999998,719.261710833092,3664.7797563321
192.168.43.233,51319,151.101.154.109,443,110,52159,51,4432,59,47727,3365.086663,604.547911,58.6487842483009,631.572772070996
192.168.43.233,51320,104.19.195.151,443,51,12254,25,2395,26,9859,3365.087432,403.135577,47.5274351685413,195.64633959359
192.168.43.233,51321,104.19.195.151,443,8,456,4,228,4,228,3365.292609,15.4458380000001,118.090064132486,118.090064132486
192.168.43.233,51322,151.101.154.109,443,9,534,5,294,4,240,3365.295614,15.264662,154.081367802313,125.780708410052
192.168.43.233,51323,151.101.154.109,443,24,9634,13,1934,11,7700,3365.31675,12.7758760000002,1211.03241765964,4821.58718509786
192.168.43.233,51324,52.222.134.188,443,34,9532,17,2996,17,6536,3365.611864,213.027151,112.511479816016,245.452280399694
192.168.43.233,51325,52.222.134.188,443,9,534,5,294,4,240,3365.772442,14.7863350000002,159.065786078833,129.849621288843
192.168.43.233,51326,172.217.161.8,443,21,5881,10,1351,11,4530,3365.907399,13.1722179999997,820.514813830157,2751.24508264294
192.168.43.233,51327,137.117.84.54,443,66,36783,30,8528,36,28255,3365.98653,152.879332,446.260453309673,1478.55172470272
192.168.43.233,51328,137.117.84.54,443,79,50114,35,7381,44,42733,3365.987247,150.604691,392.072780787419,2269.9425743651
192.168.43.233,51329,137.117.84.54,443,15,6304,8,1087,7,5217,3366.126479,18.535206,469.161227557978,2251.71492563935
192.168.43.233,51330,172.217.161.8,443,9,534,5,294,4,240,3366.159524,12.9296119999999,181.908010851371,148.496335388874
192.168.43.233,51331,104.16.164.13,443,95,39947,45,3717,50,36230,3368.902466,409.050364,72.695204837906,708.568004110124
192.168.43.233,51332,104.16.164.13,443,9,534,5,294,4,240,3368.974621,15.0459880000003,156.320741449478,127.608768530186
192.168.43.233,51333,172.217.160.238,443,23,6518,11,1922,12,4596,3370.752203,13.1096790000001,1172.8738743336,2804.64533113279
192.168.43.233,51334,137.117.84.54,443,48,27654,22,4707,26,22947,3370.826951,149.594325,251.72077884639,1227.15885111283
192.168.43.233,51335,172.217.160.238,443,9,534,5,294,4,240,3371.003894,11.9966210000002,196.055205878385,160.045066023171
192.168.43.233,51336,104.16.50.161,443,56,13957,28,2597,28,11360,3371.282827,403.6383,51.4718251464244,225.152073031722
192.168.43.233,51337,104.16.50.161,443,9,534,5,294,4,240,3371.334772,13.2703149999998,177.237691795564,144.683830037195
192.168.43.233,51338,172.217.194.154,443,23,5808,12,1976,11,3832,3374.881605,12.016811,1315.49044084991,2551.0927982474
192.168.43.233,51339,172.217.194.154,443,9,534,5,294,4,240,3375.132613,14.0266879999999,167.680353337867,136.881921092136
192.168.43.233,51340,34.208.98.48,443,48,17642,25,7605,23,10037,3379.081711,85.7451550000001,709.54446347435,936.449412214602
192.168.43.233,51341,34.208.98.48,443,21,3362,12,2107,9,1255,3379.26692,85.5597299999999,197.00856933513,117.344923832742
192.168.43.233,51342,34.208.98.48,443,15,1590,7,958,8,632,3383.02318,35.6309919999999,215.093646564767,141.898940113708
192.168.43.233,51343,52.77.26.194,443,28,8461,15,2074,13,6387,3383.407442,81.4209179999998,203.780556736047,627.553720285985
192.168.43.233,51344,35.156.121.57,443,25,8559,14,1950,11,6609,3389.161278,26.1791859999998,595.893241294825,2019.61970857307
192.168.43.233,51345,35.156.121.57,443,9,534,5,294,4,240,3389.174356,24.763903,94.9769509273234,77.5322048386314
192.168.43.233,51346,137.117.84.54,443,15,6304,8,1087,7,5217,3390.727064,26.374613,329.710998982242,1582.43080192305
192.168.43.233,51347,104.16.2.213,443,114,38476,53,6378,61,32098,3416.93381,432.820529,117.887199384667,593.280546542653
192.168.43.233,51348,104.16.2.213,443,16,4549,9,1120,7,3429,3416.934084,19.2842610000002,464.627604863878,1422.50719381985
192.168.43.233,51349,104.16.2.213,443,9,534,5,294,4,240,3417.095459,19.8802729999998,118.308234499598,96.5781506119168
192.168.43.233,51350,52.216.18.144,443,29,7845,13,1908,16,5937,3424.001005,10.6114090000001,1438.45176451118,4475.93717290509
192.168.43.233,51351,52.216.18.144,443,32,9175,15,2042,17,7133,3424.001594,10.5535440000003,1547.91603654654,5407.09357918044
192.168.43.233,51352,52.216.18.144,443,29,7894,13,1964,16,5930,3424.002076,10.6103389999998,1480.81979284547,4471.11067799066
192.168.43.233,51353,52.216.18.144,443,7,409,4,228,3,181,3424.069293,12.9961790000002,140.348944101183,111.417363518922
192.168.43.233,51354,52.216.18.144,443,61,27395,28,2844,33,24551,3436.219,28.6080590000001,795.300373226995,6865.47801093388
192.168.43.233,51355,52.216.18.144,443,275,216334,114,7722,161,208612,3436.220616,34.2340909999998,1804.51702368847,48749.5344918026
192.168.43.233,51356,52.216.18.144,443,379,307612,155,10102,224,297510,3436.257719,34.1966429999998,2363.27290956602,69599.8142273795
192.168.43.233,51357,172.217.160.238,443,20,6150,11,1663,9,4487,3436.291214,28.5369500000002,466.20258997545,1257.87794420917
192.168.43.233,51358,172.217.160.238,443,18,5759,9,1285,9,4474,3436.2916,28.5363870000001,360.241820381815,1254.25829135272
192.168.43.233,51359,172.217.160.238,443,19,5812,9,1285,10,4527,3436.291949,28.5905130000001,359.559830213608,1266.71389212218
192.168.43.233,51360,172.217.160.238,443,18,5758,9,1285,9,4473,3436.292252,28.5353829999999,360.254495269961,1254.02206797085
192.168.43.233,51361,172.217.160.238,443,20,5948,10,1351,10,4597,3436.293132,28.5341500000004,378.77420564481,1288.84161609859
192.168.43.233,51362,172.217.160.238,443,20,5866,10,1339,10,4527,3436.295256,28.5872050000003,374.713092797981,1266.86047131924
192.168.43.233,51363,52.216.18.144,443,17,1006,10,588,7,418,3436.470979,28.3575939999996,165.88149192065,117.922557181686
192.168.43.233,51364,52.216.18.144,443,83,50480,34,3764,49,46716,3464.828916,109.047908,276.135512842667,3427.19091869236
192.168.43.233,51365,52.216.18.144,443,66,33692,30,3600,36,30092,3464.948712,14.4571260000002,1992.09718446111,16651.7190207788
192.168.43.233,51366,52.216.18.144,443,131,90334,54,4866,77,85468,3464.950712,109.724862,354.778299926228,6231.44096549422
192.168.43.233,51367,52.216.18.144,443,7,409,4,228,3,181,3465.080095,12.3014320000002,148.275420292529,117.709873126964
192.168.43.233,51368,205.185.216.10,443,34,11153,15,2643,19,8510,3470.719763,58.2777270000001,362.814424797315,1168.19930193914
192.168.43.233,51369,117.18.237.66,443,33,10360,16,3857,17,6503,3470.720153,181.833865,169.693362674769,286.107321097751
192.168.43.233,51370,151.101.152.65,443,49,16298,24,3335,25,12963,3470.720491,324.848183,82.1306733305631,319.238356337058
192.168.43.233,51371,192.28.144.75,443,31,9042,15,2266,16,6776,3473.54307,152.644721,118.75942961696,355.125284679842
192.168.43.233,51372,52.212.88.15,443,43,11955,22,5141,21,6814,3473.609585,151.827949,270.885566662038,359.037979232664
192.168.43.233,51373,192.28.144.75,443,4,236,2,120,2,116,3473.642202,10.899782,88.0751559985331,85.1393174652487
192.168.43.233,51374,52.212.88.15,443,31,6861,17,3793,14,3068,3473.719214,151.718773,200.001617466285,161.772992983538
192.168.43.233,51375,52.212.88.15,443,18,1754,10,1122,8,632,3477.110797,148.325936,60.5153774320358,34.0870931702733
192.168.43.233,51376,52.212.88.15,443,21,2924,12,1694,9,1230,3477.111662,148.325464,91.36664490731,66.3405981322263
192.168.43.233,51377,52.216.18.144,443,39,11609,18,2136,21,9473,3477.148313,100.888095,169.375782147537,751.168906499822
192.168.43.233,51378,151.101.154.110,443,56,11888,27,2520,29,9368,3477.198137,603.135697,33.4253139057694,124.257278043352
192.168.43.233,51379,52.216.18.144,443,17,989,9,524,8,465,3477.399003,114.086001,36.7442101857878,32.6069804129605
192.168.43.233,51380,34.225.143.92,443,24,6120,13,1769,11,4351,3477.456261,147.979361,95.6349581750119,235.221991531643
192.168.43.233,51381,34.225.143.92,443,11,632,6,338,5,294,3477.599977,148.584007,18.1984592729418,15.8294290717305
192.168.43.233,51382,104.244.42.67,443,45,8202,23,2438,22,5764,3477.688707,593.791029,32.8465723587077,77.6569495798159
192.168.43.233,51383,173.241.248.143,443,24,5179,13,1753,11,3426,3478.091065,62.1855500000001,225.518629327874,440.745478652194
192.168.43.233,51384,173.241.248.143,443,11,632,6,338,5,294,3478.161879,148.022106,18.2675417413667,15.8895185561
192.168.43.233,51385,210.176.156.35,443,32,8083,16,3074,16,5009,3478.262149,317.350372,77.4916375393441,126.27053104573
192.168.43.233,51386,172.217.161.2,443,22,5194,11,1384,11,3810,3478.370928,147.064212,75.2868413696732,207.256405793681
192.168.43.233,51387,210.176.156.35,443,14,784,13,718,1,66,3478.48739,203.318345,28.2512628164468,2.59691273800207
192.168.43.233,51388,52.7.220.66,443,24,6093,13,1985,11,4108,3479.006747,146.431639,108.446508612801,224.432371476768
192.168.43.233,51389,103.243.221.46,443,24,7809,12,2566,12,5243,3479.00699,57.621568,356.255490999481,727.921878141185
192.168.43.233,51390,162.247.242.20,443,36,6788,17,2505,19,4283,3479.128483,316.486889,63.320158580092,108.263568542329
192.168.43.233,51391,52.7.220.66,443,11,632,6,338,5,294,3479.164255,147.019727,18.3920896547441,15.9978531316413
192.168.43.233,51392,103.243.221.46,443,16,2182,6,338,10,1844,3479.168295,147.015688,18.3925949453775,100.343032778924
192.168.43.233,51393,162.247.242.20,443,4,236,2,120,2,116,3479.222261,12.0804410000001,79.4672975928606,76.8183876730986
192.168.43.233,51394,52.175.39.99,443,25,6861,13,2085,12,4776,3517.941501,2.28005900000016,7315.60016648639,16757.4611007861
192.168.43.233,51395,104.16.93.188,80,13,1445,7,623,6,822,3579.427635,46.9267770000001,106.208018505085,140.133212216982
192.168.43.233,51396,172.217.166.206,443,19,5812,9,1285,10,4527,3625.440681,21.1109019999999,486.95219181066,1715.51172943724
192.168.43.233,51397,172.217.166.206,443,9,534,5,294,4,240,3625.691818,20.859766,112.752942674429,92.0432185097377
192.168.43.233,51398,172.217.161.14,443,27,9329,13,2300,14,7029,3626.455048,20.0965330000004,915.58081187435,2798.09457681079
192.168.43.233,51399,172.217.161.14,443,27,9329,13,2300,14,7029,3626.455451,20.0961310000002,915.59912701603,2798.15054947638
192.168.43.233,51400,172.217.161.14,443,26,9277,13,2300,13,6977,3626.455816,19.9629479999999,921.707555417172,2795.97983223722
192.168.43.233,51401,172.217.161.14,443,19,5813,10,1339,9,4474,3626.701938,19.7171709999998,543.282806646051,1815.27055783005
192.168.43.233,51402,172.217.161.14,443,18,5759,9,1285,9,4474,3626.702485,19.7168320000001,521.381933973975,1815.30176855997
192.168.43.233,51403,172.217.161.14,443,19,5813,9,1285,10,4528,3626.702876,19.8487060000002,517.91789348887,1825.0056200137
192.168.43.233,51404,172.217.161.14,443,9,534,5,294,4,240,3626.953717,19.5978660000001,120.013066728795,97.9698503908534
192.168.43.233,51405,172.217.166.214,443,16,5034,8,1219,8,3815,3627.888481,18.531195,526.247767615633,1646.95261152883
192.168.43.233,51406,151.101.152.223,443,19,6117,8,1054,11,5063,3646.579726,0.440456000000267,19143.7964291436,91959.2422398046
192.168.43.233,51407,151.101.152.223,443,100,34411,44,4507,56,29904,3646.580058,416.7314,86.5209581039489,574.067612855667
192.168.43.233,51408,151.101.152.223,443,15,897,8,459,7,438,3646.670991,142.807896,25.7128639441617,24.5364584042327
192.168.43.233,51409,23.100.69.251,443,23,9412,11,2076,12,7336,3647.786756,127.421211,130.339367124678,460.58265762362
192.168.43.233,51410,23.100.69.251,443,21,8378,10,1601,11,6777,3647.787027,129.718332,98.737008120024,417.951720193256
192.168.43.233,51411,23.100.69.251,443,24,9443,11,2072,13,7371,3647.787267,127.122708,130.393698032298,463.866770364899
192.168.43.233,51412,23.100.69.251,443,21,8395,10,1602,11,6793,3647.787501,122.688436,104.459722675085,442.943131168449
192.168.43.233,51413,23.100.69.251,443,21,8353,10,1581,11,6772,3647.787738,129.686981,97.5271372845052,417.74432238499
192.168.43.233,51414,23.100.69.251,443,21,8349,10,1579,11,6770,3647.78798,127.14388,99.3520097074275,425.974101152175
192.168.43.233,51415,13.107.246.10,443,125,69572,52,4448,73,65124,3649.36731,128.678001,276.535225317963,4048.80395989366
192.168.43.233,51416,13.107.246.10,443,19,4992,8,1056,11,3936,3649.367519,124.221891,68.0073369676846,253.481892334097
192.168.43.233,51417,13.107.246.10,443,19,4992,8,1056,11,3936,3649.367682,125.774216,67.1679798027921,250.353379264952
192.168.43.233,51418,13.107.246.10,443,19,4992,8,1056,11,3936,3649.36785,122.829507,68.7782618878378,256.355339763759
192.168.43.233,51419,13.107.246.10,443,19,4992,8,1056,11,3936,3649.368008,124.611845,67.7945182498502,252.68865893126
192.168.43.233,51420,13.107.246.10,443,19,4992,8,1056,11,3936,3649.410192,125.033118,67.566098767528,251.837277224422
192.168.43.233,51421,23.100.69.251,443,26,9640,11,1848,15,7792,3650.711096,124.49687,118.749973392905,500.703351015974
192.168.43.233,51422,23.100.69.251,443,8,482,4,230,4,252,3650.956042,126.517984,14.5433869701876,15.9344935499446
192.168.43.233,51423,13.107.246.10,443,152,111583,64,4548,88,107035,3652.397214,124.528081,292.175063711132,6876.20007570823
192.168.43.233,51424,52.114.158.91,443,20,8365,11,3671,9,4694,3669.416997,5.76427899999999,5094.82625667496,6514.6048621172
192.168.43.233,51425,52.114.158.91,443,20,7890,10,3142,10,4748,3671.659496,3.23479399999997,7770.51027051499,11742.32424074
192.168.43.233,51426,52.230.84.217,443,33,10985,18,5387,15,5598,3774.024681,302.573166,142.431665602494,148.010481537546
192.168.43.233,51427,104.131.222.33,80,260,225049,104,10572,156,214477,3788.457016,28.6733060000001,2949.64243048917,59840.187245935
192.168.43.233,51428,104.131.222.33,80,178,139029,78,8063,100,130966,3788.458059,30.556227,2110.99361187492,34288.5265252153
192.168.43.233,51429,104.131.222.33,80,120,89832,54,7172,66,82660,3788.530869,38.8831969999997,1475.59883000363,17006.8320256692
192.168.43.233,51430,104.131.222.33,80,389,338591,153,12030,236,326561,3790.80271,27.099299,3551.38337711245,96404.2649221296
192.168.43.233,51431,104.131.222.33,80,116,90248,49,7387,67,82861,3790.804783,35.71551,1654.63127923975,18560.2277553925
192.168.43.233,51432,104.131.222.33,80,231,181245,104,11225,127,170020,3790.806348,35.8807349999997,2502.73579958718,37907.8076299164
192.168.43.233,51433,151.101.193.69,443,649,458141,296,21854,353,436287,3795.042825,258.638792,675.969751668187,13494.8666169149
192.168.43.233,51434,151.101.193.69,443,17,6273,9,1625,8,4648,3795.043774,17.3447719999999,749.505384100757,2143.81601556943
192.168.43.233,51435,151.101.193.69,443,9,534,5,294,4,240,3795.085472,16.6507269999997,141.255093546368,115.310280446015
192.168.43.233,51436,104.16.3.35,443,304,213415,147,11685,157,201730,3799.971068,257.260455,363.36715644851,6273.17556442944
192.168.43.233,51437,104.16.3.35,443,9,534,5,294,4,240,3800.073319,13.7536959999998,171.008578348688,139.598839468317
192.168.43.233,51438,192.0.73.2,443,90,33284,50,5922,40,27362,3801.394978,199.981627,236.901762980456,1094.58055364256
192.168.43.233,51439,192.0.73.2,443,7,402,4,228,3,174,3801.507767,15.2230380000001,119.81839630171,91.4403550723576
192.168.43.233,51440,192.0.73.2,80,21,8615,10,1053,11,7562,3802.208202,89.0821810000002,94.5643663573973,679.10326533204
192.168.43.233,51441,192.0.73.2,80,20,8010,10,1053,10,6957,3802.208702,89.0816800000002,94.5648981923105,624.774925663726
192.168.43.233,51442,192.0.73.2,80,18,6873,9,999,9,5874,3802.209162,89.0812189999997,89.7158805157351,527.518600750178
192.168.43.233,51443,23.74.147.187,80,108,83552,45,5939,63,77613,3802.293378,22.7511300000001,2088.33583211031,27291.1279571607
192.168.43.233,51444,192.0.73.2,80,9,534,5,294,4,240,3802.413543,14.3171469999998,164.278539572168,134.104930262994
192.168.43.233,51445,23.74.147.187,80,25,8188,13,2785,12,5403,3802.424822,240.609297,92.5982506818928,179.643931215177
192.168.43.233,51446,151.101.154.2,80,54,41350,22,2444,32,38906,3803.721438,25.2305099999999,774.934791250756,12336.1755271694
192.168.43.233,51447,151.101.154.2,80,7,402,4,228,3,174,3803.933126,14.0738310000002,129.602238367079,98.9069713854021
192.168.43.233,51448,216.58.196.194,80,20,1971,12,1155,8,816,3808.684043,243.352599,37.9695965359302,26.825273396813
192.168.43.233,51449,216.58.196.194,80,9,534,5,294,4,240,3808.823045,20.3472389999997,115.59307874646,94.3616969358853
192.168.43.233,51450,23.74.147.187,80,18,6319,10,3870,8,2449,3810.179362,7.60263600000008,4072.27177521056,2577.00092441619
192.168.43.233,51451,49.44.178.248,80,58,39940,25,3088,33,36852,3810.40594,234.275386,105.44855104838,1258.41645182478
192.168.43.233,51452,49.44.178.248,80,9,534,5,294,4,240,3810.60457,18.6732529999999,125.955557930908,102.820863617068
192.168.43.233,51453,23.74.147.187,80,44,21681,24,3071,20,18610,3810.946239,233.901262,105.035773599203,636.50789536997
192.168.43.233,51454,173.241.248.143,80,14,1985,8,1137,6,848,3811.181468,80.3161219999997,113.252479993992,84.4662295821507
192.168.43.233,51455,173.241.248.143,80,9,908,5,294,4,614,3811.432999,17.9174739999999,131.268503584826,274.145786398241
192.168.43.233,51456,23.74.147.187,80,7,402,4,228,3,174,3811.995832,17.3552569999997,105.097838654883,80.2062452892529
192.168.43.233,51457,49.44.178.216,80,13,3742,8,3168,5,574,3812.419312,6.07333699999981,4172.9941875448,756.091749889747
192.168.43.233,51458,49.44.178.216,80,7,402,4,228,3,174,3812.556174,16.6224520000001,109.731103449719,83.7421578958384
192.168.43.233,51459,49.44.178.243,80,9,2166,5,756,4,1410,3813.390437,4.13866400000006,1461.34114777134,2725.51722004971
192.168.43.233,51460,157.240.16.16,443,29,6893,14,1972,15,4921,3813.455862,69.6980400000002,226.347828432477,564.836543466644
192.168.43.233,51461,49.44.178.243,80,7,402,4,228,3,174,3813.535737,15.6011799999997,116.914233410552,89.2240202343688
192.168.43.233,51462,157.240.16.16,443,7,402,4,228,3,174,3813.640991,15.5300349999998,117.449831890271,89.6327664425754
192.168.43.233,51463,172.217.160.238,443,20,5673,10,1175,10,4498,3814.927924,76.160801,123.423071666486,472.474022430515
192.168.43.233,51464,172.217.160.238,443,12,696,6,348,6,348,3815.179802,14.224479,195.718943379227,195.718943379227
192.168.43.233,51465,35.177.238.167,80,7,402,4,228,3,174,3815.772363,13.930593,130.934842472248,99.9239587288205
192.168.43.233,51466,35.177.238.167,80,9,534,5,294,4,240,3815.894435,13.353028,176.139823866167,143.78761131932
192.168.43.233,51467,54.81.94.76,80,11,655,6,349,5,306,3816.109115,76.3484659999999,36.5691695757188,32.0635125792836
192.168.43.233,51468,54.81.94.76,80,11,655,6,349,5,306,3816.109342,76.3546069999998,36.5662284136962,32.0609337953898
192.168.43.233,51469,54.81.94.76,80,11,655,6,349,5,306,3816.109547,76.4578660000002,36.5168444539113,32.0176343922546
192.168.43.233,51470,54.81.94.76,80,11,655,6,349,5,306,3816.109748,76.354135,36.5664544559374,32.0611319871543
192.168.43.233,51471,54.81.94.76,80,22,4421,12,3342,10,1079,3816.109944,233.003033,114.745287457267,37.0467280569691
192.168.43.233,51472,54.81.94.76,80,18,2437,10,1466,8,971,3816.110145,233.062336,50.3213011646807,33.3301387659652
192.168.43.233,51473,31.13.79.26,443,20,5232,10,1134,10,4098,3816.132724,74.9562310000001,121.030631863013,437.375246362106
192.168.43.233,51474,31.13.79.26,443,11,643,6,349,5,294,3816.213466,75.0769169999999,37.188527600301,31.3278713882192
192.168.43.233,51475,54.81.94.76,80,11,655,6,349,5,306,3816.249251,76.2147459999997,36.6333307730241,32.1197685287833
192.168.43.233,51476,54.81.94.76,80,18,2573,10,1602,8,971,3816.314166,232.856789,55.0381204474996,33.3595598967054
192.168.43.233,51477,54.81.94.76,80,18,2812,10,1841,8,971,3816.612731,233.057087,63.1948171565365,33.3308894399766
192.168.43.233,51478,54.81.94.76,80,11,655,6,349,5,306,3816.616862,75.8344730000003,36.8170291102305,32.2808335465058
192.168.43.233,51479,54.81.94.76,80,11,655,6,349,5,306,3816.619478,75.8381789999999,36.815229964844,32.2792560723274
192.168.43.233,51480,104.131.222.33,80,11,655,6,349,5,306,3816.682523,74.7747140000001,37.3388255286405,32.738339861788
192.168.43.233,51481,104.131.222.33,80,9,523,5,283,4,240,3816.684935,74.772301,30.278592068472,25.6779579379268
192.168.43.233,51482,104.131.222.33,80,11,655,6,349,5,306,3816.688434,74.7688020000001,37.3417779249693,32.7409284958183
192.168.43.233,51483,31.13.79.26,443,52,20622,25,3529,27,17093,3818.166374,69.7136690000002,404.970795612549,1961.50915539963
192.168.43.233,51484,31.13.79.26,443,13,751,7,403,6,348,3818.410551,72.8798320000001,44.2372040594166,38.1998685178088
192.168.43.233,51485,216.58.196.194,443,25,5976,14,2109,11,3867,3818.641334,72.447932,232.884494204748,427.010118107995
192.168.43.233,51486,52.84.110.163,443,38,8059,20,2774,18,5285,3818.69009,189.379186,117.182888303258,223.255791161759
192.168.43.233,51487,23.43.115.95,443,26,8383,14,2211,12,6172,3818.721701,235.201154,75.2037126484508,209.9309427708
192.168.43.233,51488,23.43.115.95,443,26,8494,14,2322,12,6172,3818.722495,235.198037,78.9802510128943,209.933724914549
192.168.43.233,51489,216.58.196.194,443,9,535,5,295,4,240,3818.892779,58.188494,40.5578463673592,32.9962139937837
192.168.43.233,51490,52.84.110.163,443,7,402,4,228,3,174,3818.924727,72.3649679999999,25.2055663176691,19.2358269266422
192.168.43.233,51491,23.43.115.95,443,29,9444,15,2319,14,7125,3818.936553,237.700762,78.0477094137376,239.7972960642
192.168.43.233,51492,23.43.115.95,443,9,534,5,294,4,240,3819.023708,72.3471259999997,32.5099299728922,26.5387183452181
192.168.43.233,51493,35.177.33.121,443,31,9914,15,2782,16,7132,3828.395317,163.004452,136.536148104715,350.027249562484
192.168.43.233,51494,35.177.33.121,443,32,9913,16,2781,16,7132,3828.395531,163.004241,136.487246365571,350.027702653454
192.168.43.233,51495,35.177.33.121,443,37,10312,19,3072,18,7240,3828.395701,174.636893,140.726278266987,331.659588103185
192.168.43.233,51496,35.177.33.121,443,9,503,5,283,4,220,3828.575207,62.8419640000002,36.0268816550672,28.0067631240805
192.168.43.233,51497,198.252.206.25,443,40,8352,22,3439,18,4913,3828.871014,250.800511,109.696746192036,156.714194254572
192.168.43.233,51498,198.252.206.25,443,34,4359,19,3076,15,1283,3834.04698,240.986499,102.113604297808,42.5915976313677
192.168.43.233,51499,198.252.206.25,443,38,6009,22,4397,16,1612,3836.416664,239.580858,146.823082167942,53.8273387433982
192.168.43.233,51500,172.217.161.5,443,35,6892,19,4163,16,2729,3892.523053,156.755535,212.458207616082,139.274188946502
192.168.43.233,51501,172.217.161.5,443,10,590,6,350,4,240,3892.600144,103.556479,27.0383854978306,18.5406071985124
192.168.43.233,51502,13.107.54.254,443,39,16401,21,2317,18,14084,3897.282912,7.06248599999981,2624.57157437204,15953.5891469382
192.168.43.233,51503,13.107.42.254,443,9,534,4,240,5,294,3897.283397,0.903197999999975,2125.77972936173,2604.08016846812
192.168.43.233,51504,13.107.42.254,443,7,414,3,174,4,240,3897.284545,0.668393999999807,2082.60397310628,2872.55720428453
192.168.43.233,51505,13.107.54.254,443,55,17136,29,2872,26,14264,3897.41078,128.567979,178.707016931487,887.561591055266
192.168.43.233,51506,13.107.21.200,443,787,529846,453,391978,334,137868,3897.621321,118.632829,26433.0204921607,9297.12297428226
192.168.43.233,51507,13.107.21.200,443,31,11080,17,1921,14,9159,3897.621957,128.672553,119.434950513494,569.445451198903
192.168.43.233,51508,13.107.21.200,443,42,13421,22,2436,20,10985,3898.252703,126.762755,153.736008656486,693.263569413588
192.168.43.233,51509,13.107.21.200,443,35,13094,20,2537,15,10557,3898.277086,133.337335,152.215431634358,633.400990052785
192.168.43.233,51510,13.107.21.200,443,34,13040,19,2483,15,10557,3898.313959,130.041264,152.751514319332,649.45539132871
192.168.43.233,51511,13.107.21.200,443,48,16705,25,2855,23,13850,3898.543261,127.191878,179.571214444998,871.124805626346
192.168.43.233,51512,131.253.61.80,443,157,55666,74,12029,83,43637,3901.785287,79.4180959999999,1211.71376357348,4395.67324807183
192.168.43.233,51513,13.107.140.254,443,59,18270,31,3396,28,14874,3902.403089,133.045655,204.200580620239,894.369680843768
192.168.43.233,51514,131.253.33.254,443,36,11408,20,2481,16,8927,3905.374756,130.997904,151.513874603673,545.169028047961
192.168.43.233,51515,204.79.197.222,443,52,13912,28,3749,24,10163,3907.199154,11.1818120000003,2682.21286496315,7271.09345068564
192.168.43.233,51516,204.79.197.254,443,39,9625,20,1953,19,7672,3914.666487,130.082609,120.10829210844,471.823255020969
192.168.43.233,51517,13.107.51.254,443,37,9499,19,1881,18,7618,3916.028544,128.861569,116.776476623531,472.941626219063
192.168.43.233,51518,13.107.18.11,443,77,21822,40,6846,37,14976,3916.381886,166.664163,328.612936423531,718.858798696874
192.168.43.233,51519,13.107.18.11,443,34,7059,18,1685,16,5374,3916.381895,2.31358799999998,5826.44792417669,18582.3923706383
192.168.43.233,51520,13.107.18.11,443,34,7057,17,1631,17,5426,3916.382655,123.431915,105.710099369357,351.675658600938
192.168.43.233,51521,13.107.18.11,443,26,6285,13,1173,13,5112,3916.382673,123.193282,76.1729848223381,331.966153803745
192.168.43.233,51522,23.213.64.207,80,94,74203,42,3056,52,71147,3956.250256,4.68700100000024,5216.12860761045,121437.140721748
192.168.43.233,51523,13.107.3.254,443,52,18467,29,3428,23,15039,3962.052734,12.7429710000001,2152.08839445681,9441.44030461961
192.168.43.233,51524,49.44.164.114,443,23,7693,13,1416,10,6277,3975.130768,24.5153420000001,462.077991814266,2048.34996795067
192.168.43.233,51525,49.44.164.114,443,28,7928,15,1278,13,6650,3978.4601,24.7322380000001,413.387579401427,2151.03865650977
192.168.43.233,51526,172.217.161.5,443,35,5589,17,2909,18,2680,4002.016363,54.9762699999997,423.30991171282,389.986443241787
192.168.43.233,51527,172.217.161.5,443,11,643,6,349,5,294,4002.267153,59.402153,47.0016633908875,39.5945244610915
