Address A,Port A,Address B,Port B,Packets,Bytes,Packets A → B,Bytes A → B,Packets B → A,Bytes B → A,Rel Start,Duration,Bits/s A → B,Bits/s B → A
172.30.6.35,62078,172.30.6.255,56662,3,198,0,0,3,198,1094.411121,9.004183,0,175.9182371127
172.30.6.255,55246,172.217.194.189,443,174,21464,85,9981,89,11483,1.460485,1351.471882,59.0822502958,67.9732972794
172.30.6.255,55606,172.217.166.197,443,2,108,2,108,0,0,2.582405,0.00014,0,0
172.30.6.255,55613,157.240.16.39,443,711,447167,308,113780,403,333387,2.586415,56.01656,16249.4805107632,47612.6345494975
172.30.6.255,55614,157.240.16.35,443,27,7245,14,1942,13,5303,2.59219,56.010537,277.3763800908,757.4289102067
172.30.6.255,55615,157.240.16.20,443,1635,1627691,409,39411,1226,1588280,2.592748,56.010557,5629.0816747279,226854.376756153
172.30.6.255,55616,157.240.16.20,443,15,4921,8,1025,7,3896,2.597465,11.790041,695.502246345,2643.587074888
172.30.6.255,55589,161.69.226.19,443,554,148853,339,110227,215,38626,2.61996,1039.879404,847.9983319297,297.157534625
172.30.6.255,55617,157.240.189.81,443,17,4928,10,1157,7,3771,2.707268,11.679772,792.4812230924,2582.9271324817
172.30.6.255,55618,157.240.16.20,443,4051,3950747,1218,84495,2833,3866252,3.121596,120.474842,5610.7979788843,256734.231699594
172.30.6.255,55619,157.240.16.20,443,12,1688,6,917,6,771,3.43013,0.096315,76166.7445361576,64039.8691792558
172.30.6.255,55620,157.240.16.17,443,15,4922,8,1025,7,3897,5.264851,0.088609,92541.3897008205,351837.849428388
172.30.6.255,55621,157.240.16.17,443,349,329094,100,9295,249,319799,5.265445,53.337801,1394.1332152032,47965.8319622138
172.30.6.255,55622,157.240.16.17,443,15,4922,8,1025,7,3897,5.266089,0.087012,94239.874959776,358295.407529997
172.30.6.255,55623,157.240.16.17,443,16,4988,9,1091,7,3897,5.266771,0.087025,100293.019247343,358241.884515945
172.30.6.255,55624,157.240.16.17,443,14,4869,7,971,7,3898,5.26751,0.086798,89495.1496578263,359270.95094357
172.30.6.255,55625,157.240.16.17,443,14,4869,7,971,7,3898,5.268117,0.091219,85157.6974095312,341858.604018901
172.30.6.255,55626,157.240.16.16,443,802,61599,406,30374,396,31225,7.517553,5867.769455,41.411306607,42.5715430566
172.30.6.255,55627,157.240.16.16,443,65,27001,34,13908,31,13093,7.968098,67.855445,1639.7210275461,1543.6344128316
172.30.6.255,55291,157.240.16.16,443,312,83614,175,33566,137,50048,8.32668,1233.503719,217.6953306778,324.5908332766
172.30.6.255,55628,157.240.16.37,443,16,5369,9,1103,7,4266,14.479696,0.449343,19637.559726089,75950.8882969137
172.30.6.255,55629,157.240.16.37,443,1285,1159334,457,39811,828,1119523,14.479699,44.236335,7199.6922891555,202462.161478793
172.30.6.255,55608,172.217.194.189,443,5,283,3,163,2,120,15.170379,43.481068,29.9900637215,22.0785745189
172.30.6.255,55630,157.240.16.63,443,52,23051,31,17307,21,5744,15.361552,43.241566,3201.9191904382,1062.6812174194
172.30.6.255,55302,172.217.194.188,443,5,283,3,163,2,120,16.168816,44.281546,29.4479330058,21.6794598815
172.30.6.255,55631,157.240.16.63,443,100,68754,37,11528,63,57226,17.870868,40.732314,2264.1483123203,11239.4301978523
172.30.6.255,55632,157.240.16.36,443,88,21677,46,9455,42,12222,22.906631,35.696408,2118.9807108883,2739.0991272847
172.30.6.255,55351,157.240.16.16,443,928,68290,477,37465,451,30825,26.281069,4731.20153,63.3496582421,52.1220663369
172.30.6.255,55607,172.217.166.197,443,41,14779,15,2860,26,11919,27.267276,31.347316,729.887049979,3041.7915205244
172.30.6.255,55559,104.24.108.136,443,5,333,2,108,3,225,29.52997,0.001487,0,0
172.30.6.255,55633,117.18.232.131,80,286,199858,109,10892,177,188966,34.667034,23.913935,3643.7332459087,63215.3595800942
172.30.6.255,55634,117.18.232.131,80,197,216803,41,8526,156,208277,34.667074,23.913772,2852.2476504334,69676.0009253245
172.30.6.255,55635,117.18.232.131,80,138,124998,43,8535,95,116463,35.502246,23.078663,2958.5769331612,40370.7961765376
172.30.6.255,55636,117.18.232.131,80,73,52419,32,9299,41,43120,35.502951,23.078138,3223.4836276653,14947.4797316837
172.30.6.255,55637,35.186.249.84,80,6,348,4,228,2,120,36.44837,14.914893,122.2938709651,64.3651952448
172.30.6.255,55638,35.186.249.84,80,86,67650,34,3483,52,64167,36.448377,22.16385,1257.182303616,23160.9580465488
172.30.6.255,55639,117.18.232.131,80,56,39817,24,7864,32,31953,36.633659,21.947372,2866.4935373584,11647.1347913545
172.30.6.255,55640,117.18.232.131,80,237,152120,97,13176,140,138944,36.634069,21.947078,4802.8261438721,50646.9243878388
172.30.6.255,55641,122.15.34.40,80,8,480,5,294,3,186,36.774876,14.554396,161.6006600343,102.2371522666
172.30.6.255,55642,122.15.34.40,80,105,101053,32,4177,73,96876,36.774876,21.801884,1532.7115766693,35547.7535794613
172.30.6.255,55643,122.15.34.40,80,316,341288,74,8912,242,332376,36.774897,21.801824,3270.1851001091,121962.639456222
172.30.6.255,55644,122.15.34.40,80,138,138184,39,6582,99,131602,36.774919,21.801949,2415.1969165693,48289.9946238751
172.30.6.255,55645,122.15.34.40,80,148,163902,31,4879,117,159023,36.77495,21.801847,1790.3070322437,58352.1203501703
172.30.6.255,55646,122.15.34.40,80,211,222174,52,6867,159,215307,36.774988,21.803048,2519.6477116411,79000.6975171545
172.30.6.255,55647,122.15.34.40,80,198,212154,47,6209,151,205945,36.774998,21.801824,2278.341481887,75569.8238826256
172.30.6.255,55649,122.15.34.40,80,130,140819,29,1993,101,138826,36.775036,21.803275,731.266289124,50937.6687676507
172.30.6.255,55648,151.139.104.15,80,7,402,4,228,3,174,36.877302,14.793134,123.3004446522,94.0977077609
172.30.6.255,55650,151.139.104.15,80,30,23495,10,947,20,22548,36.877306,4.395045,1723.7593699268,41042.5831817421
172.30.6.255,55651,151.139.104.15,80,33,25316,10,1282,23,24034,36.877335,8.935019,1147.8431103504,21518.9245820294
172.30.6.255,55652,35.186.241.238,443,46,8870,21,2603,25,6267,37.014026,21.604745,963.8623367228,2320.6013308651
172.30.6.255,55653,172.217.166.194,80,17,8753,8,868,9,7885,37.313196,21.299548,326.0163079517,2961.5651937778
172.30.6.255,55654,159.180.93.4,443,48,24489,23,2695,25,21794,37.398433,21.264216,1013.9099414716,8199.3147548915
172.30.6.255,55656,159.180.93.4,443,6,348,4,228,2,120,37.477215,13.932498,130.9169396615,68.9036524534
172.30.6.255,55655,172.217.166.198,80,14,3078,8,1548,6,1530,37.486051,21.090548,587.1824667619,580.35476366
172.30.6.255,55657,35.190.43.164,80,36,10453,18,7661,18,2792,37.639212,20.97118,2922.4869559081,1065.0807441451
172.30.6.255,55658,35.190.43.164,80,44,15491,21,12429,23,3062,37.639266,20.972907,4740.9736761814,1167.9830554725
172.30.6.255,55659,35.190.43.164,80,23,6319,11,4529,12,1790,37.639297,20.972303,1727.6118888803,682.8053170889
172.30.6.255,55660,35.190.43.164,80,23,6237,11,4447,12,1790,37.639334,20.975518,1696.0725356103,682.7006608371
172.30.6.255,55661,35.190.43.164,80,20,5366,10,3910,10,1456,37.639378,20.972294,1491.4915840871,555.3994236396
172.30.6.255,55662,35.190.43.164,80,25,7155,12,5311,13,1844,37.639483,20.972245,2025.9156804624,703.4058585526
172.30.6.255,55663,172.217.166.200,80,10,1332,6,802,4,530,37.983567,20.633592,310.949252074,205.4901541137
172.30.6.255,55664,35.190.43.164,80,14,3049,8,2261,6,788,38.087798,20.522149,881.389176153,307.1803055323
172.30.6.255,55665,122.15.34.33,80,10,1997,6,740,4,1257,38.297415,20.280719,291.9028659684,495.8404088139
172.30.6.255,55666,122.15.34.33,80,6,348,4,228,2,120,38.297547,13.031323,139.9704389186,73.6686520624
172.30.6.255,55667,172.217.161.2,80,16,9497,7,734,9,8763,38.983946,19.62936,299.1437316347,3571.3849050606
172.30.6.255,55668,172.217.166.193,80,11,2997,6,808,5,2189,39.376097,34.260752,188.6706981797,511.1388097961
172.30.6.255,55670,172.217.161.2,80,98,94885,26,3498,72,91387,39.410526,19.167667,1459.9585854658,38142.148441957
172.30.6.255,55669,35.186.249.84,443,45,11811,19,5462,26,6349,39.459637,19.429675,2248.9310809368,2614.1456303309
172.30.6.255,55671,35.186.249.84,443,40,8232,17,2850,23,5382,39.923057,18.934373,1204.159229355,2273.9596394346
172.30.6.255,55672,172.217.166.202,80,242,261149,57,3925,185,257224,40.638106,17.971651,1747.1961813636,114502.112243333
172.30.6.255,55673,35.201.68.17,80,87,80799,27,1829,60,78970,41.156677,17.47471,837.3243390019,36152.8174144235
172.30.6.255,55674,35.201.68.223,80,263,269355,73,4329,190,265026,41.308125,17.305119,2001.2575469721,122519.122809846
172.30.6.255,55675,195.201.82.80,80,14,4694,8,873,6,3821,41.403263,17.356336,402.3890756667,1761.2012120531
172.30.6.255,55676,195.201.82.80,80,50,42097,18,1916,32,40181,41.403296,17.352717,883.3198858715,18524.3613435291
172.30.6.255,55678,195.201.82.80,80,13,5282,7,1200,6,4082,41.472445,17.288115,555.2947791011,1888.9277402424
172.30.6.255,55677,172.217.166.198,443,7,402,4,228,3,174,41.552318,11.505259,158.5361963603,120.9881498539
172.30.6.255,55679,172.217.166.198,443,16,5235,8,1219,8,4016,41.55235,11.485165,849.0953329795,2797.3477089794
172.30.6.255,55680,195.201.82.80,80,364,379728,100,6589,264,373139,41.815072,16.948404,3110.1453564595,176129.386578229
172.30.6.255,55681,195.201.82.80,80,38,33468,12,1084,26,32384,41.816283,16.943208,511.8275122397,15290.6108453606
172.30.6.255,55682,195.201.82.80,80,15,6637,8,870,7,5767,41.819123,16.936758,410.9405117556,2724.0160129819
172.30.6.255,55683,104.20.58.225,80,157,174617,33,2221,124,172396,41.953374,16.65556,1066.7909094621,82805.2614262144
172.30.6.255,55684,104.20.58.225,80,17,5570,9,935,8,4635,41.953374,16.649459,449.2638469514,2227.0993910373
172.30.6.255,55685,35.186.241.238,80,14,3371,8,875,6,2496,42.503518,16.107296,434.585668507,1239.6866612497
172.30.6.255,55686,104.25.171.105,443,37,16046,17,1904,20,14142,42.744949,15.871733,959.6935633935,7128.1441037346
172.30.6.255,55687,205.185.216.10,443,36,14368,16,2669,20,11699,43.883986,13.616884,1568.0533079374,6873.231790768
172.30.6.255,55688,172.217.161.2,80,111,109493,31,2619,80,106874,44.001325,14.576928,1437.3398839591,58653.7849401465
172.30.6.255,55689,205.185.216.10,443,7,402,4,228,3,174,44.027561,13.113131,139.0972148452,106.153137645
172.30.6.255,55690,35.190.43.247,443,28,9295,14,2073,14,7222,45.077799,13.54345,1224.5033577117,4265.9735887089
172.30.6.255,55691,205.185.216.10,443,65,53142,22,2393,43,50749,45.749007,11.752603,1628.9157389218,34544.8578497887
172.30.6.255,55692,172.217.166.195,443,15,5573,7,1165,8,4408,46.098146,0.225295,41367.9841984948,156523.668967352
172.30.6.255,55693,172.217.166.195,443,39,9968,17,3789,22,6179,46.166711,12.464499,2431.8666959659,3965.823255311
172.30.6.255,55694,103.231.98.53,80,19,6578,10,5844,9,734,53.102912,5.556256,8414.2991251663,1056.8267552827
172.30.6.255,55695,103.243.221.87,80,43,45057,9,4217,34,40840,53.188656,0.752604,44825.6985081133,434119.404095648
172.30.6.255,55696,103.243.221.87,80,13,4556,8,2995,5,1561,53.188723,5.573136,4299.1952825124,2240.7491939906
172.30.6.255,55697,103.243.221.87,80,27,23393,10,4271,17,19122,53.188802,0.753224,45362.3357726257,203094.962454729
172.30.6.255,55705,103.243.221.87,80,6,340,4,228,2,112,53.268979,5.491725,332.136077462,163.1545643673
172.30.6.255,55698,210.176.156.41,80,12,4223,7,2745,5,1478,53.27243,5.44306,4034.4953022748,2172.3074888023
172.30.6.255,55699,210.176.156.41,80,12,4235,7,2753,5,1482,53.27255,5.443123,4046.2065619315,2178.1613239311
172.30.6.255,55700,210.176.156.41,80,12,4187,7,2728,5,1459,53.272646,5.443243,4009.3745585123,2144.3099270049
172.30.6.255,55707,210.176.156.41,80,6,344,4,228,2,116,53.278334,5.437469,335.4501883137,170.6676396684
172.30.6.255,55701,173.241.248.220,80,6,535,4,228,2,307,53.405173,5.328422,342.315229537,460.9244538064
172.30.6.255,55702,52.84.110.25,443,26,9477,13,1859,13,7618,53.405279,5.177442,2872.4609565882,11771.0637801447
172.30.6.255,55703,180.149.59.210,80,12,5395,8,4171,4,1224,53.40544,5.168051,6456.5926303746,1894.7181442288
172.30.6.255,55708,52.84.110.25,443,8,480,5,294,3,186,53.40552,5.175226,454.4729061108,287.5236752946
172.30.6.255,55704,180.149.59.210,80,6,348,4,228,2,120,53.405653,5.167913,352.9471181113,185.7616411112
172.30.6.255,55706,173.241.248.220,80,10,2492,6,1342,4,1150,53.40579,5.327749,2015.1099460579,1726.8080759811
172.30.6.255,55709,54.194.27.245,443,24,8639,13,3162,11,5477,54.054152,4.697441,5385.0596526918,9327.6317893083
172.30.6.255,55710,54.194.27.245,443,6,348,4,228,2,120,54.189313,4.56213,399.8132451289,210.4280237521
172.30.6.255,55711,173.241.248.143,80,12,3258,8,1790,4,1468,57.09528,1.638036,8742.1766066192,7169.5615969368
172.30.6.255,55611,157.240.16.39,443,4,293,2,108,2,185,57.099119,0.027803,31075.783188866,53231.6656475945
172.30.6.255,55612,157.240.16.39,443,5,347,2,108,3,239,57.099484,0.032248,26792.3592160732,59290.4986355693
172.30.6.255,55713,157.240.16.39,443,25,5220,13,3166,12,2054,57.100765,61.015143,415.1100653816,269.3101940284
172.30.6.255,55712,157.240.16.39,443,18,1879,9,1071,9,808,57.100765,61.015399,140.4235674997,105.9404692248
172.30.6.255,55714,184.29.25.122,80,26,18665,10,3951,16,14714,57.164327,1.429377,22113.1304057642,82351.961728781
172.30.6.255,55715,173.241.248.143,80,9,1442,6,950,3,492,57.243842,1.489642,5101.8969658482,2642.2455865235
172.30.6.255,55716,104.36.113.23,80,20,10243,11,4007,9,6236,57.330883,1.529374,20960.2098636436,32619.8823832497
172.30.6.255,55718,50.116.239.135,443,19,6052,10,2084,9,3968,57.511584,1.20356,13852.2383595333,26375.0872411844
172.30.6.255,55719,104.36.113.23,80,7,402,4,228,3,174,57.574008,1.294263,1409.2962558615,1075.5155636837
172.30.6.255,55717,151.101.130.49,80,10,1622,5,950,5,672,57.599179,0.552246,13761.9828844391,9734.792103519
172.30.6.255,55720,103.229.206.238,80,13,3269,8,2012,5,1257,57.682583,1.033377,15576.1159770345,9731.2016814773
172.30.6.255,55724,151.101.130.49,80,10,1825,5,1069,5,756,57.750491,0.599274,14270.6007602532,10092.2115760069
172.30.6.255,55721,202.241.208.55,80,10,1947,6,855,4,1092,57.78902,0.944402,7242.6784356662,9250.2980722193
172.30.6.255,55722,54.169.20.177,80,17,6380,10,2839,7,3541,57.789062,0.871206,26069.609254298,32515.8458504647
172.30.6.255,55726,202.241.208.55,80,6,348,4,228,2,120,57.822842,0.904144,2017.3777628343,1061.7777699128
172.30.6.255,55727,54.169.20.177,80,6,348,4,228,2,120,57.825865,0.833389,2188.6537979263,1151.9230515402
172.30.6.255,55723,122.15.34.17,80,10,2158,6,748,4,1410,57.87302,0.703663,8504.0708407291,16030.4009163476
172.30.6.255,55725,173.241.248.143,443,25,5707,13,1959,12,3748,58.000971,0.732703,21389.2941614815,40922.4474309508
172.30.6.255,55730,173.241.248.143,443,6,348,4,228,2,120,58.006375,0.728634,2503.3144212321,1317.5339059116
172.30.6.255,55731,173.241.248.143,80,9,1434,6,942,3,492,58.030218,0.704898,10690.908471864,5583.7865904003
172.30.6.255,55728,52.215.35.189,80,10,1738,6,1274,4,464,58.0837,0.664596,15335.6324744656,5585.3480911712
172.30.6.255,55734,173.241.248.143,80,9,1500,6,1008,3,492,58.135345,0.599495,13451.3215289536,6565.5259843702
172.30.6.255,55738,172.217.167.2,80,10,2136,6,954,4,1182,58.139786,0.436869,17469.7678251375,21644.9324625917
172.30.6.255,55729,50.116.239.135,80,9,1824,6,995,3,829,58.16672,0.54577,14584.898400425,12151.6389687963
172.30.6.255,55741,103.231.98.48,80,15,4913,8,3727,7,1186,58.19651,0.46368,64302.9675638376,20462.3878536924
172.30.6.255,55742,52.215.35.189,80,6,348,4,228,2,120,58.211494,0.523451,3484.5668457984,1833.9825504202
172.30.6.255,55743,50.116.239.135,80,6,531,4,228,2,303,58.234688,0.47761,3819.0155147505,5075.2706182869
172.30.6.255,55744,103.231.98.48,80,15,4883,8,3642,7,1241,58.239737,0.422687,68930.4378890284,23487.8290555421
172.30.6.255,55745,103.231.98.48,80,15,4970,8,3722,7,1248,58.267143,0.392941,75777.2795406943,25408.3946444886
172.30.6.255,55747,173.241.248.143,80,6,535,4,228,2,307,58.278666,0.448165,4069.9296018208,5480.1245077149
172.30.6.255,55748,103.231.98.48,80,22,9113,11,7030,11,2083,58.285182,0.463235,121407.061210831,35973.1022051439
172.30.6.255,55732,182.161.72.94,80,12,1974,6,1020,6,954,58.29418,0.418496,19498.3942498851,18236.7334454808
172.30.6.255,55733,209.15.36.33,80,5,330,1,66,4,264,58.294289,7.492253,70.4727936977,281.8911747908
172.30.6.255,55735,205.180.87.172,80,6,344,4,228,2,116,58.29439,0.542291,3363.5077845659,1711.2583465335
172.30.6.255,55736,13.228.141.18,80,10,1324,6,804,4,520,58.294527,0.368046,17476.0763600202,11302.9349592171
172.30.6.255,55737,52.32.41.162,80,6,396,1,66,5,330,58.294633,15.831864,33.3504633441,166.7523167203
172.30.6.255,55739,103.15.158.128,80,13,4797,6,1931,7,2866,58.294681,10.240045,1508.5871204668,2239.0526604131
172.30.6.255,55746,182.161.72.94,80,7,402,4,228,3,174,58.300345,0.41224,4424.607025034,3376.6737822628
172.30.6.255,55749,184.29.25.122,443,23,11676,12,4477,11,7199,58.311693,0.28642,125047.133580057,201075.343900566
172.30.6.255,55750,209.15.36.33,80,5,330,1,66,4,264,58.374894,7.410987,71.2455709341,284.9822837363
172.30.6.255,55751,52.32.41.162,80,6,396,1,66,5,330,58.377911,15.748587,33.5268173583,167.6340867914
172.30.6.255,55752,13.228.141.18,80,6,348,4,228,2,120,58.378876,0.280149,6510.8210273818,3426.7479091483
172.30.6.255,55753,103.15.158.128,80,2,132,1,66,1,66,58.380199,0.216798,2435.4468214651,2435.4468214651
172.30.6.255,55754,205.180.87.172,80,6,376,1,66,5,310,58.381114,15.432009,34.2145990195,160.7049347885
172.30.6.255,55756,103.231.98.48,443,12,6047,5,799,7,5248,58.414575,0.188321,33942.0457622885,222938.493317259
172.30.6.255,55755,104.193.80.60,80,2,132,1,66,1,66,58.419291,0.292803,1803.2602124978,1803.2602124978
172.30.6.255,55740,104.193.80.60,80,2,132,1,66,1,66,58.419291,0.295855,1784.6580250461,1784.6580250461
172.30.6.255,55605,172.217.166.206,443,3,162,2,108,1,54,60.128353,0.04214,20503.0849549105,10251.5424774553
172.30.6.255,55604,172.217.166.206,443,3,162,2,108,1,54,60.128736,0.041894,20623.4783023826,10311.7391511913
172.30.6.255,55757,172.217.166.206,443,55,8882,29,5245,26,3637,61.400881,108.781753,385.7264554286,267.4713285784
172.30.6.255,55758,172.217.166.206,443,17,1779,10,1150,7,629,61.400882,108.777059,84.5766569218,46.2597540902
172.30.6.255,55759,195.201.82.80,80,355,379499,89,17610,266,361889,61.576043,40.473756,3480.7740601095,71530.5987415648
172.30.6.255,55760,103.231.98.48,80,68,37123,33,29094,35,8029,61.584397,104.338395,2230.7416172158,615.6123064764
172.30.6.255,55761,157.240.16.16,443,231,56073,113,27931,118,28142,61.585149,821.55066,271.9832274251,274.0378785649
172.30.6.255,55763,172.217.194.188,5228,53,8093,27,2350,26,5743,61.587486,796.379809,23.6068265262,57.6910658467
172.30.6.255,55762,103.231.98.43,80,64,27402,28,22047,36,5355,61.680377,167.845239,1050.8251592409,255.2351216825
172.30.6.255,55764,195.201.82.80,80,84,90712,19,3137,65,87575,62.195231,1.733119,14480.2520773242,404242.293806715
172.30.6.255,55765,195.201.82.80,80,66,66029,19,3314,47,62715,62.195494,1.586329,16712.80043421,316277.392646795
172.30.6.255,55766,195.201.82.80,80,59,59744,15,2858,44,56886,62.234169,1.680954,13601.7999302777,270731.977198662
172.30.6.255,55767,195.201.82.80,80,87,97173,18,2969,69,94204,62.234582,1.70945,13894.5274795987,440862.265640997
172.30.6.255,55768,195.201.82.80,80,64,60733,20,2984,44,57749,62.235038,1.669544,14298.5150436287,276717.474951245
172.30.6.255,55769,195.201.82.80,80,13,2866,7,899,6,1967,62.26489,30.755776,233.8422545411,511.6437315709
172.30.6.255,55770,195.201.82.80,80,184,187613,50,6203,134,181410,62.532845,36.363279,1364.673411328,39910.5922213451
172.30.6.255,55771,195.201.82.80,80,131,126200,39,6201,92,119999,62.533189,36.362459,1364.2641714632,26400.6347865528
172.30.6.255,55772,195.201.82.80,80,212,208221,64,17154,148,191067,62.619236,39.434059,3480.0373960997,38761.8226163327
172.30.6.255,55773,195.201.82.80,80,11,1537,6,956,5,581,62.685172,36.204715,211.2432040965,128.3810685984
172.30.6.255,55774,195.201.82.80,80,6,348,4,228,2,120,62.72897,17.433037,104.6289295434,55.0678576544
172.30.6.255,55775,172.217.166.197,443,3440,2539237,2178,2370820,1262,168417,62.844507,348.801687,54376.3425089168,3862.7565468168
172.30.6.255,55776,172.217.166.202,80,231,203850,82,6018,149,197832,63.419045,249.536733,192.9335189301,6342.3768555951
172.30.6.255,55777,195.201.82.80,80,169,178945,41,7479,128,171466,63.638968,35.253505,1697.1929457794,38910.4005403151
172.30.6.255,55778,195.201.82.80,80,234,257764,50,6274,184,251490,63.640135,35.254218,1423.7161635524,57068.9158386665
172.30.6.255,55779,195.201.82.80,80,391,421745,96,14830,295,406915,63.787338,38.266562,3100.3569121261,85069.5706606724
172.30.6.255,55780,195.201.82.80,80,175,182756,45,10029,130,172727,63.788511,38.260935,2096.9691409789,36115.5836886893
172.30.6.255,55781,195.201.82.80,80,268,284439,68,13392,200,271047,63.790599,38.259749,2800.2274662074,56675.1235090434
172.30.6.255,55782,195.201.82.80,80,580,650443,125,14929,455,635514,63.792255,38.259179,3121.656112903,132886.071601275
172.30.6.255,55784,172.217.166.197,443,17,1779,10,1150,7,629,64.405134,105.770791,86.9805351082,47.5745709418
172.30.6.255,55783,172.217.166.197,443,31,8220,17,5527,14,2693,64.405155,105.770219,418.0382759726,203.6868241712
172.30.6.255,55785,35.190.43.164,80,90,26841,46,19921,44,6920,64.453525,347.188842,459.0239682876,159.4521289368
172.30.6.255,55786,172.217.166.202,443,47,9594,25,4209,22,5385,69.428643,100.754424,334.1987246138,427.5742770362
172.30.6.255,55787,172.217.166.202,443,21,4414,11,1054,10,3360,69.428746,100.711605,83.7242143048,266.9007211235
172.30.6.255,55788,180.149.59.80,443,76,79785,16,3348,60,76437,79.974616,32.572987,822.2764464309,18773.1017729507
172.30.6.255,55789,180.149.59.80,443,82,78774,23,3659,59,75115,79.9748,32.572517,898.6717237725,18448.6817521655
172.30.6.255,55790,172.217.166.206,443,16,5628,8,1219,8,4409,80.056203,10.566094,922.9522281365,3338.2250810943
172.30.6.255,55791,172.217.166.206,443,16,5627,8,1219,8,4408,80.057759,10.564951,923.0520804119,3337.8290159604
172.30.6.255,55792,172.217.166.206,443,18,6559,9,1285,9,5274,80.058286,10.563505,973.1618435358,3994.1288426521
172.30.6.255,55793,172.217.166.206,443,16,5627,8,1219,8,4408,80.058717,10.564993,923.0484109171,3337.8157467781
172.30.6.255,55794,172.217.166.206,443,16,5626,8,1219,8,4407,80.059178,10.564053,923.1305446877,3337.3554638546
172.30.6.255,55795,172.217.166.206,443,16,5627,8,1219,8,4408,80.059884,10.564389,923.101184555,3338.006580409
172.30.6.255,55796,184.29.25.201,443,38,11107,20,3994,18,7113,86.365637,308.116698,103.7009685207,184.6832721802
172.30.6.255,55797,104.36.113.23,443,21,6749,10,1219,11,5530,89.111996,13.834431,704.9079214028,3197.8185441816
172.30.6.255,55798,184.29.25.122,80,17,4553,9,3806,8,747,89.137764,2.599472,11713.1479008045,2298.9283977669
172.30.6.255,55799,104.36.113.23,443,4,240,2,120,2,120,89.36124,10.576739,90.7652160085,90.7652160085
172.30.6.255,55800,104.36.113.23,80,62,33853,31,19422,31,14431,89.431949,322.452782,481.8565962938,358.030714711
172.30.6.255,55801,104.36.113.23,80,7,402,4,228,3,174,89.685962,12.477537,146.1826961523,111.5604786425
172.30.6.255,55812,119.81.99.200,443,28,7120,15,2208,13,4912,90.716428,222.174709,79.5049989241,176.869816447
172.30.6.255,55802,185.84.60.59,443,51,9999,26,3048,25,6951,90.759348,321.045819,75.9517755938,173.2089213098
172.30.6.255,55803,8.41.222.241,80,17,4253,8,1704,9,2549,90.846779,7.479597,1822.5580870199,2726.3500961349
172.30.6.255,55807,151.101.66.49,80,22,2387,12,1313,10,1074,90.846811,303.151178,34.6493787994,28.3422946158
172.30.6.255,55804,18.207.56.96,80,14,5407,8,2782,6,2625,90.847156,8.10415,2746.2472930536,2591.2649691825
172.30.6.255,55805,103.229.206.27,80,26,3833,14,2175,12,1658,90.848008,320.878203,54.226182512,41.3365566
172.30.6.255,55806,13.228.37.108,80,13,1533,7,893,6,640,90.848659,61.083012,116.9555947896,83.8203590877
172.30.6.255,55815,185.84.60.59,443,6,344,4,228,2,116,90.876222,11.200876,162.8444060982,82.8506627517
172.30.6.255,55816,151.101.66.49,80,6,348,4,228,2,120,90.876722,11.160809,163.429013076,86.01527004
172.30.6.255,55817,8.41.222.241,80,7,398,3,174,4,224,90.877117,7.449366,186.8615396263,240.5573843465
172.30.6.255,55818,18.207.56.96,80,7,402,4,228,3,174,90.877592,8.066094,226.1317559652,172.5742348155
172.30.6.255,55819,103.229.206.27,80,6,348,4,228,2,120,90.877971,11.12733,163.9207249178,86.2740657462
172.30.6.255,55820,13.228.37.108,80,7,402,4,228,3,174,90.878406,11.094084,164.4119514509,125.4722787388
172.30.6.255,55808,204.11.109.67,80,7,402,4,228,3,174,91.005879,11.138354,163.7584871158,124.9735822726
172.30.6.255,55809,35.187.221.61,80,11,1668,6,939,5,729,91.006016,11.010395,682.2643510973,529.6812693823
172.30.6.255,55810,204.2.197.204,80,6,348,4,228,2,120,91.006107,11.098887,164.340802821,86.4951593795
172.30.6.255,55826,35.187.221.61,80,6,348,4,228,2,120,91.00623,11.014968,165.5928551041,87.1541342653
172.30.6.255,55825,204.2.197.204,80,9,1315,5,813,4,502,91.006404,0.677403,9601.3746617597,5928.524083891
172.30.6.255,55824,204.11.109.67,80,23,3159,12,1650,11,1509,91.006572,303.092043,43.5511268107,39.829485065
172.30.6.255,55811,103.243.221.75,80,12,3186,7,2090,5,1096,91.141818,10.925962,1530.3000321619,802.4922656696
172.30.6.255,55813,4.78.226.233,80,14,2902,8,1467,6,1435,91.141818,134.303085,87.3844409456,85.4783045378
172.30.6.255,55814,52.9.25.50,80,13,2662,7,992,6,1670,91.141824,61.763209,128.4907330511,216.3100042292
172.30.6.255,55821,103.243.221.75,80,12,3361,7,2168,5,1193,91.141897,10.925794,1587.436116771,873.5291915626
172.30.6.255,55823,52.9.25.50,80,6,348,4,228,2,120,91.142,11.016916,165.5635751421,87.138723759
172.30.6.255,55822,4.78.226.233,80,5,294,3,174,2,120,91.142109,11.009749,126.4334000712,87.1954483249
172.30.6.255,55828,54.169.20.177,80,15,3450,8,1648,7,1802,91.295697,60.632687,217.4404706821,237.7595437919
172.30.6.255,55829,103.231.98.48,80,20,5266,14,4121,6,1145,91.304285,79.449468,414.9555790606,115.2934088873
172.30.6.255,55830,103.243.221.75,80,6,340,4,228,2,112,91.316421,10.751056,169.6577526896,83.340650444
172.30.6.255,55827,172.217.166.211,443,49,8220,21,2339,28,5881,91.391272,240.821525,77.700695567,195.3645962503
172.30.6.255,55831,103.231.98.48,80,44,23861,21,18384,23,5477,91.549448,74.373342,1977.4827383715,589.1358223488
172.30.6.255,55832,103.231.98.48,80,7,402,4,228,3,174,91.716504,10.260677,177.7660479908,135.6635629403
172.30.6.255,55833,103.231.98.48,80,7,402,4,228,3,174,91.721887,10.255955,177.8478942234,135.7260245389
172.30.6.255,55834,74.125.11.41,443,20,6384,11,1252,9,5132,98.80968,11.333562,883.7468749895,3622.5151457238
172.30.6.255,55835,74.125.11.41,443,7,402,4,228,3,174,98.971286,10.873067,167.7539557146,128.0227556769
172.30.6.255,55836,103.243.221.75,80,27,10679,16,7186,11,3493,101.880427,20.858682,2756.070589695,1339.6819607298
172.30.6.255,55837,103.243.221.75,80,60,46540,22,8678,38,37862,101.881106,20.781472,3340.6680720211,14575.2909129825
172.30.6.255,55838,103.243.221.75,80,63,50871,20,8569,43,42302,101.885505,20.452955,3351.6917237632,16546.0687709918
172.30.6.255,55839,35.190.43.164,80,80,23252,41,17054,39,6198,101.89335,309.750721,440.4574089757,160.0771092313
172.30.6.255,55840,173.241.248.220,80,81,46565,38,17038,43,29527,101.906916,309.852502,439.8996268231,762.3498228199
172.30.6.255,55841,103.231.98.53,80,70,46322,22,14495,48,31827,101.90731,57.076117,2031.6728974398,4460.9902246854
172.30.6.255,55842,210.176.156.41,80,223,122802,88,45504,135,77298,101.909957,223.059821,1631.9927020833,2772.2787422124
172.30.6.255,55843,180.149.59.232,80,115,72024,67,49804,48,22220,102.039934,309.572079,1287.0411352569,574.2119915149
172.30.6.255,55844,54.194.27.245,443,93,34749,55,29977,38,4772,102.830557,308.946488,776.2379872077,123.5683248809
172.30.6.255,55845,54.194.27.245,443,116,43222,69,37172,47,6050,102.830951,308.946034,962.5499837295,156.6616647359
172.30.6.255,55846,54.194.27.245,443,22,4865,13,3915,9,950,102.899395,125.378082,249.8044275394,60.6166554693
172.30.6.255,55848,54.194.27.245,443,6,348,4,228,2,120,103.0282,10.587205,172.2834308016,90.6754898956
172.30.6.255,55847,210.176.156.33,80,38,11127,20,9267,18,1860,103.112209,308.607192,240.2277131636,48.2166339144
172.30.6.255,55849,172.217.166.193,80,47,26801,20,2099,27,24702,103.204425,242.67022,69.1967889591,814.3397240914
172.30.6.255,55850,172.217.167.34,80,58,38698,23,3386,35,35312,103.295034,242.544785,111.6824672194,1164.7168583732
172.30.6.255,55851,209.191.163.208,443,21,8943,12,2404,9,6539,103.447322,17.791538,1080.9633208776,2940.2741910227
172.30.6.255,55852,52.84.110.71,443,45,14683,23,2540,22,12143,103.532372,180.189705,112.7700386656,539.1207005972
172.30.6.255,55854,209.191.163.208,443,6,348,4,228,2,120,103.607867,10.902807,167.2963668897,88.0507194157
172.30.6.255,55853,23.7.212.50,443,41,17734,20,5292,21,12442,103.61659,302.336085,140.0295965333,329.2230234443
172.30.6.255,55855,23.7.212.50,443,6,348,4,228,2,120,103.698616,10.253614,177.8884986308,93.6255255952
172.30.6.255,55856,172.217.167.34,80,51,17286,26,11886,25,5400,103.711993,307.902015,308.8255203526,140.3043757281
172.30.6.255,55858,103.243.221.75,443,21,7600,11,3121,10,4479,104.857239,16.381951,1524.1163888233,2187.2852629092
172.30.6.255,55860,152.163.13.4,443,30,7826,15,2652,15,5174,104.860253,303.219507,69.9691131679,136.5083678472
172.30.6.255,55861,103.15.158.128,443,18,8994,9,3070,9,5924,104.860861,10.246041,2397.0233966466,4625.3962872099
172.30.6.255,55863,50.116.239.135,443,22,6310,12,2272,10,4038,104.905195,7.635946,2380.3206570607,4230.5170832795
172.30.6.255,55857,52.203.61.66,443,19,5982,11,1965,8,4017,104.941671,7.599945,2068.4360215765,4228.4516532685
172.30.6.255,55859,54.169.196.206,443,22,8680,12,2305,10,6375,105.026329,61.359402,300.5244412258,831.1684654293
172.30.6.255,55864,52.203.61.66,443,7,402,4,228,3,174,105.084266,4.984593,365.9275692118,279.2605133458
172.30.6.255,55865,54.169.196.206,443,6,348,4,228,2,120,105.107078,10.287744,177.2983464596,93.3149191893
172.30.6.255,55866,152.163.13.4,443,6,348,4,228,2,120,105.107614,11.08528,164.5425284702,86.6013307738
172.30.6.255,55862,209.15.36.33,443,7,402,4,228,3,174,105.1536,6.340664,287.6670329795,219.5353672738
172.30.6.255,55867,209.15.36.33,443,18,6414,10,1928,8,4486,105.153605,7.387709,2087.7920340392,4857.7982700726
172.30.6.255,55868,210.176.156.55,443,80,44849,42,28725,38,16124,105.3198,306.39924,750.0018603179,420.9932113409
172.30.6.255,55869,210.176.156.55,443,85,47715,47,31391,38,16324,105.374932,306.694931,818.8201845436,425.8042334583
172.30.6.255,55870,210.176.156.55,443,36,10982,19,5104,17,5878,105.410071,302.482876,134.9894597009,155.4600399925
172.30.6.255,55871,210.176.156.55,443,105,54573,58,32111,47,22462,105.471567,306.304363,838.6690854939,586.6583101854
172.30.6.255,55872,210.176.156.55,443,15,4364,8,1279,7,3085,105.564588,15.823382,646.6379943302,1559.7171325321
172.30.6.255,55873,210.176.156.55,443,18,4550,10,1399,8,3151,105.84071,15.89421,704.1557900644,1585.9863434546
172.30.6.255,55874,52.74.163.34,443,93,86707,26,6908,67,79799,107.744089,60.679075,910.7587747506,10520.7932058951
172.30.6.255,55875,147.75.111.32,443,34,15388,15,5087,19,10301,108.154495,38.250527,1063.9330537851,2154.427833112
172.30.6.255,55876,54.207.34.156,443,21,5576,10,2093,11,3483,108.267821,1.735121,9650.047460667,16058.822410656
172.30.6.255,55877,147.75.111.32,443,5,294,3,174,2,120,108.316142,12.812206,108.6463954763,74.9285486044
172.30.6.255,55878,54.207.34.156,443,4,236,2,120,2,116,108.339951,10.714727,89.5963098267,86.6097661658
172.30.6.255,55879,199.166.0.200,443,19,8825,9,1710,10,7115,108.340608,0.617152,22166.3382764703,92230.1151094073
172.30.6.255,55880,52.89.235.78,80,51,38381,21,5771,30,32610,108.934973,64.204743,719.0746017004,4063.2512149453
172.30.6.255,55881,52.89.235.78,80,6,348,4,228,2,120,109.070591,12.069692,151.1223318706,79.5380694056
172.30.6.255,55882,52.77.195.144,443,30,8162,14,2780,16,5382,109.973668,60.391062,368.2664166429,712.953185026
172.30.6.255,55883,72.247.219.133,80,54,21290,29,19372,25,1918,110.31537,301.325902,514.3135687021,50.9216097858
172.30.6.255,55884,54.149.211.44,80,14,3580,8,2130,6,1450,110.428793,62.706297,271.7430436053,184.9893958816
172.30.6.255,55885,54.149.211.44,80,6,348,4,228,2,120,110.463538,10.671656,170.9200521456,89.9579221819
172.30.6.255,55886,184.84.52.113,80,42,36778,13,1733,29,35045,110.587871,1.688876,8209.0100161291,166003.898450805
172.30.6.255,55887,184.84.52.113,80,24,14072,10,2405,14,11667,111.140505,1.343688,14318.8001976649,69462.5538071338
172.30.6.255,55888,184.84.52.113,80,67,54381,23,4004,44,50377,112.010038,116.849112,274.13130876,3449.0292061441
172.30.6.255,55889,184.84.52.113,80,135,112322,45,6699,90,105623,112.010973,299.713103,178.8110011326,2819.3095047967
172.30.6.255,55890,63.251.88.51,443,21,6720,10,2005,11,4715,113.30237,1.140516,14063.8097141995,33072.7495274067
172.30.6.255,55891,52.69.18.116,443,6,348,4,228,2,120,113.43032,11.054869,164.9951709061,86.8395636348
172.30.6.255,55892,63.251.88.51,443,4,236,2,120,2,116,113.43032,10.518319,91.2693368589,88.2270256302
172.30.6.255,55893,52.69.18.116,443,33,9031,16,2107,17,6924,113.433179,60.676316,277.8019680694,912.9097422461
172.30.6.255,55894,63.251.88.56,443,20,7241,9,2176,11,5065,114.310147,1.209551,14392.1174055496,33500.0343102522
172.30.6.255,55895,63.251.88.56,443,4,236,2,120,2,116,114.468411,10.527118,91.1930501776,88.1532818384
172.30.6.255,55896,50.112.42.246,443,21,7603,12,2113,9,5490,115.413764,36.853654,458.6790769784,1191.7407158596
172.30.6.255,55897,50.112.42.246,443,6,348,4,228,2,120,115.533478,11.653635,156.5176873997,82.3777302104
172.30.6.255,55898,184.84.52.113,80,122,99588,42,6922,80,92666,115.902286,295.813891,187.1987816826,2506.0621646061
172.30.6.255,55899,184.84.52.113,80,71,56733,21,4667,50,52066,116.94126,111.914252,333.6125590153,3721.8494745424
172.30.6.255,55900,157.240.16.39,443,20,2025,11,1217,9,808,118.090974,61.041304,159.4985585498,105.8955097027
172.30.6.255,55901,157.240.16.39,443,26,5413,15,3412,11,2001,118.090975,61.041378,447.1720805517,262.2483391512
172.30.6.255,55902,184.29.25.122,80,40,18220,24,16132,16,2088,120.835253,290.788937,443.8133077944,57.4437259283
172.30.6.255,55903,104.24.246.16,443,7,402,4,228,3,174,121.706148,30.1657,60.4660259832,46.1451250924
172.30.6.255,55913,104.24.246.16,443,33,10399,17,2150,16,8249,121.706269,289.922319,59.3262362806,227.6195921294
172.30.6.255,55904,52.69.18.116,80,6,348,4,228,2,120,121.805396,30.19328,60.4107933951,31.7951544185
172.30.6.255,55905,185.84.60.59,80,11,1560,6,975,5,585,121.805514,30.655258,254.4424842224,152.6654905335
172.30.6.255,55906,35.186.239.238,80,21,2447,11,1115,10,1332,121.805594,247.076188,36.1022244685,43.1283973023
172.30.6.255,55907,151.101.192.166,80,26,6310,14,2969,12,3341,121.805765,289.820092,81.9542904569,92.2227296788
172.30.6.255,55908,72.251.245.181,80,9,534,5,294,4,240,121.805833,30.189905,77.906836739,63.5974177461
172.30.6.255,55909,13.250.69.79,80,13,2491,7,1303,6,1188,121.805939,61.115603,170.5620085267,155.5085695547
172.30.6.255,55910,52.212.169.136,80,6,348,4,228,2,120,121.805968,30.219857,60.3576648295,31.7671920155
172.30.6.255,55921,185.84.60.59,80,6,344,4,228,2,116,121.806034,30.238904,60.3196465057,30.688942959
172.30.6.255,55922,52.212.169.136,80,13,1872,7,891,6,981,121.806182,61.194898,116.4802987334,128.2459854741
172.30.6.255,55919,52.69.18.116,80,13,1674,7,996,6,678,121.806246,61.180333,130.2379311992,88.6559411175
172.30.6.255,55915,35.186.239.238,80,6,348,4,228,2,120,121.806615,30.080745,60.6367960634,31.9141031913
172.30.6.255,55920,13.250.69.79,80,6,348,4,228,2,120,121.80708,30.122275,60.5531952683,31.8701027728
172.30.6.255,55914,151.101.192.166,80,6,348,4,228,2,120,121.807224,30.066413,60.6657002949,31.9293159447
172.30.6.255,55916,72.251.245.181,80,11,1856,6,923,5,933,121.807391,30.18392,244.6335664818,247.2839843201
172.30.6.255,55923,103.243.221.51,443,21,7609,11,3149,10,4460,121.864819,30.402942,828.6040212819,1173.5706366838
172.30.6.255,55911,23.198.140.217,80,10,1973,5,872,5,1101,121.897631,0.408896,17060.5728596025,21540.9297229614
172.30.6.255,55917,23.198.140.217,80,9,534,5,294,4,240,121.897673,30.071299,78.2141137302,63.8482561063
172.30.6.255,55912,70.42.146.149,80,10,1217,6,818,4,399,122.051579,30.796091,212.4945013314,103.6495183756
172.30.6.255,55918,70.42.146.149,80,6,535,4,228,2,307,122.051777,30.018912,60.761695827,81.8150904337
172.30.6.255,55924,103.231.98.48,80,15,5133,8,3934,7,1199,122.150194,43.772912,718.9834663045,219.1309547786
172.30.6.255,55925,103.231.98.48,80,31,14952,16,11764,15,3188,122.182588,105.296351,893.7821596496,242.2116223192
172.30.6.255,55926,103.231.98.48,80,62,35956,33,28701,29,7255,122.186308,105.29263,2180.665446385,551.2256650822
172.30.6.255,55927,103.231.98.48,80,7,402,4,228,3,174,122.209035,29.721673,61.369358313,46.8345102915
172.30.6.255,55928,157.240.16.39,443,35,8390,18,5795,17,2595,126.856123,65.22198,710.8033212117,318.2976045805
172.30.6.255,55934,217.12.15.54,443,21,8156,11,1844,10,6312,152.295529,21.222444,695.1131547337,2379.3678051406
172.30.6.255,55936,77.238.185.35,443,48,9795,20,2407,28,7388,152.296869,217.7332,88.438510985,271.4514828239
172.30.6.255,55929,52.203.61.66,80,11,1793,6,976,5,817,152.349429,6.780777,1151.4904560348,963.9013346111
172.30.6.255,55930,52.23.112.47,80,15,2789,8,1422,7,1367,152.439411,100.618441,113.060785746,108.6878298979
172.30.6.255,55931,202.58.9.200,80,11,1722,6,955,5,767,152.439445,6.539618,1168.2639567021,938.2811044926
172.30.6.255,55932,52.68.71.55,80,14,2587,8,1624,6,963,152.439465,6.607198,1966.3403457865,1166.0010794288
172.30.6.255,55933,74.217.250.101,80,13,1968,7,902,6,1066,152.44155,71.617183,100.7579424061,119.0775682981
172.30.6.255,55935,139.162.37.98,80,10,1717,5,803,5,914,152.441559,0.273384,23498.0832821239,26746.2616685694
172.30.6.255,55938,52.23.112.47,80,6,348,4,228,2,120,152.489593,10.576943,172.4505842567,90.7634653983
172.30.6.255,55939,202.58.9.200,80,7,402,4,228,3,174,152.503232,6.480194,281.4730546647,214.8083838231
172.30.6.255,55940,52.68.71.55,80,7,402,4,228,3,174,152.511247,6.533269,279.186422601,213.0633225113
172.30.6.255,55941,52.203.61.66,80,7,402,4,228,3,174,152.515457,6.603472,276.2183287822,210.7981982811
172.30.6.255,55942,74.217.250.101,80,6,348,4,228,2,120,152.515649,10.551061,172.873609583,90.9861103068
172.30.6.255,55943,139.162.37.98,80,7,402,4,228,3,174,152.521682,1.534602,1188.5817951495,907.0755805088
172.30.6.255,55937,35.201.85.114,80,24,3571,13,1947,11,1624,152.568713,259.075415,60.1214901074,50.1475603156
172.30.6.255,55944,35.201.85.114,80,7,402,4,228,3,174,152.568719,10.309335,176.927027786,135.0232580472
172.30.6.255,55945,103.231.98.43,443,33,11952,13,4975,20,6977,152.827427,71.829217,554.0920764875,777.0654105836
172.30.6.255,55946,52.23.112.47,443,36,13439,21,6472,15,6967,152.97847,100.431394,515.5360085911,554.9659103607
172.30.6.255,55947,52.23.112.47,443,6,348,4,228,2,120,153.143971,11.259852,161.9914720016,85.2586694745
172.30.6.255,55948,54.251.146.208,443,45,14478,22,4656,23,9822,154.000614,72.677265,512.5124067341,1081.1634147212
172.30.6.255,55949,54.236.156.42,443,29,7461,13,2157,16,5304,158.986032,60.933313,283.1948428604,696.3678472562
172.30.6.255,55950,54.236.156.42,443,6,348,4,228,2,120,159.14797,13.899337,131.2292809362,69.068042598
172.30.6.255,55951,52.206.154.207,443,36,7585,16,2482,20,5103,159.806672,11.548873,1719.3019613256,3534.8903741517
172.30.6.255,55952,54.82.135.50,443,34,7768,16,2676,18,5092,161.006854,65.612873,326.2774364415,620.8537766667
172.30.6.255,55954,54.82.135.50,443,6,348,4,228,2,120,161.171257,11.874286,153.6092359574,80.8469662934
172.30.6.255,55953,54.86.11.75,443,136,17387,66,6765,70,10622,161.231571,147.992625,365.693898598,574.1907747092
172.30.6.255,55955,103.243.221.75,80,35,20933,16,7582,19,13351,162.849098,20.198362,3003.0157891021,5287.9535479164
172.30.6.255,55956,103.243.221.75,80,37,23284,16,8248,21,15036,162.856328,51.177797,1289.3091119182,2350.394253977
172.30.6.255,55957,103.243.221.75,80,80,61458,29,11316,51,50142,162.86358,51.170167,1769.1558442637,7839.2552441738
172.30.6.255,55958,103.231.98.53,80,190,111736,80,68623,110,43113,162.865093,248.822526,2206.3275734127,1386.1445968923
172.30.6.255,55959,52.212.169.136,443,31,8961,15,2015,16,6946,165.835247,60.77575,265.2373685228,914.3120405754
172.30.6.255,55960,103.243.221.51,443,17,4553,10,3067,7,1486,165.84502,17.605445,1393.6597456071,675.2456413343
172.30.6.255,55961,8.41.222.241,443,32,13039,15,2352,17,10687,165.858187,87.767323,214.3850280132,974.1210860447
172.30.6.255,55963,210.176.156.81,443,29,8291,15,4041,14,4250,165.859275,245.861429,131.4887013042,138.2892800155
172.30.6.255,55962,159.127.41.108,443,19,8143,9,1735,10,6408,165.947189,1.405737,9873.824193288,36467.7034182073
172.30.6.255,55964,52.220.13.130,443,23,8515,12,1999,11,6516,166.030486,61.368016,260.5917714531,849.432707748
172.30.6.255,55967,159.127.41.108,443,6,344,4,228,2,116,166.09417,10.702899,170.421116746,86.7054804497
172.30.6.255,55968,52.220.13.130,443,7,402,4,228,3,174,166.099612,10.531148,173.2004905828,132.1793217606
172.30.6.255,55965,207.244.121.27,443,22,8721,12,2605,10,6116,166.157892,7.36027,2831.4178691814,6647.5822218479
172.30.6.255,55966,52.76.187.108,443,6,340,4,228,2,112,166.157996,10.472706,174.1670204434,85.5557293406
172.30.6.255,55969,207.244.121.27,443,7,402,4,228,3,174,166.158028,6.907834,264.0480358966,201.5103431843
172.30.6.255,55970,52.76.187.108,443,25,8351,13,2839,12,5512,166.158118,61.240092,370.8681561092,720.0511717063
172.30.6.255,55971,35.201.85.114,443,55,9816,25,3038,30,6778,166.387776,240.551219,101.0346158337,225.4156109681
172.30.6.255,55972,104.122.118.96,443,30,7116,15,2271,15,4845,166.860915,244.766086,74.2259693608,158.3552714897
172.30.6.255,55973,52.77.203.173,443,240,246823,59,17359,181,229464,174.017771,125.413869,1107.3097505668,14637.2328247046
172.30.6.255,55974,199.166.0.200,443,20,8889,10,1775,10,7114,174.522329,0.611935,23205.0789708062,93003.3418582057
172.30.6.255,55975,52.89.235.78,80,116,104290,41,18086,75,86204,174.779424,129.47278,1117.5167475357,5326.4632148935
172.30.6.255,55976,52.89.235.78,80,6,348,4,228,2,120,175.002335,11.134191,163.8197153255,86.2209028029
172.30.6.255,55977,54.254.228.105,443,60,16225,29,8546,31,7679,176.010674,124.922245,547.2844328086,491.7618955695
172.30.6.255,55978,54.254.228.105,443,6,348,4,228,2,120,176.099485,37.825925,48.2208961182,25.3794190096
172.30.6.255,55979,54.149.211.44,80,26,9825,15,5889,11,3936,176.110131,128.142074,367.6544208267,245.7272542662
172.30.6.255,55980,54.149.211.44,80,6,348,4,228,2,120,176.330612,37.804984,48.2476067177,25.3934772198
172.30.6.255,55982,157.240.16.39,443,27,5369,14,3220,13,2149,179.108612,61.014771,422.192849007,281.7678361851
172.30.6.255,55983,157.240.16.39,443,18,1879,9,1071,9,808,179.108748,61.015204,140.4240162829,105.9408078026
172.30.6.255,55984,103.243.221.75,80,6,340,4,228,2,112,183.047652,30.986561,58.8642282698,28.9157612553
172.30.6.255,55985,207.244.121.27,80,11,1949,6,955,5,994,183.342557,30.720556,248.6934155749,258.8494817607
172.30.6.255,55986,34.226.161.213,80,13,1581,7,977,6,604,183.435812,69.629344,112.2515242999,69.3960293522
172.30.6.255,55988,207.244.121.27,80,7,402,4,228,3,174,183.508026,2.58737,704.9629546605,537.9980443462
172.30.6.255,55989,34.226.161.213,80,6,348,4,228,2,120,183.520646,30.547469,59.7103478524,31.4264988697
172.30.6.255,55987,119.42.60.92,80,6,348,4,228,2,120,183.56132,30.409006,59.9822302643,31.5695948759
172.30.6.255,55990,119.42.60.92,80,11,1868,6,943,5,925,183.561399,30.471643,247.5744415882,242.8487364465
172.30.6.255,55991,103.243.221.46,80,21,9609,11,8271,10,1338,183.912841,30.121693,2196.6892763963,355.3585118871
172.30.6.255,55993,103.243.221.46,80,24,13719,15,11615,9,2104,183.912863,30.120777,3084.9137789507,558.8169256059
172.30.6.255,55994,103.231.98.48,443,28,12129,12,5224,16,6905,183.921387,43.47641,961.2569207071,1270.5740883389
172.30.6.255,55992,151.101.153.108,80,44,33477,14,2428,30,31049,183.9998,227.627251,85.3324894742,1091.2225970695
172.30.6.255,55995,103.243.221.46,80,6,348,4,228,2,120,184.07883,29.955792,60.8897271019,32.0472247905
172.30.6.255,55997,13.107.3.128,443,31,21674,10,1445,21,20229,221.943315,17.357269,666.0033902799,9323.5865619183
172.30.6.255,55996,51.140.98.69,443,54,51327,15,1870,39,49457,221.973456,17.327423,863.3713160924,22834.0936791351
172.30.6.255,55998,52.109.124.5,443,58,41027,30,22986,28,18041,222.719927,1.191254,154365.064041759,121156.361279796
172.30.6.255,55999,103.243.221.75,80,29,21026,10,2947,19,18079,223.859391,14.182853,1662.2889625945,10197.6661536293
172.30.6.255,56000,103.243.221.75,80,23,15328,9,2893,14,12435,223.859783,14.182461,1631.8747500875,7014.2974480945
172.30.6.255,56001,103.243.221.75,80,14,3768,8,2587,6,1181,223.86379,14.178454,1459.6795955328,666.3632015169
172.30.6.255,56002,52.109.120.4,443,17,8977,8,2132,9,6845,225.248614,14.052961,1213.6943950816,3896.687680269
172.30.6.255,56003,52.109.120.4,443,17,8977,8,2132,9,6845,225.271246,14.030118,1215.6704597923,3903.0320343706
172.30.6.255,56004,199.166.0.200,443,19,8827,9,1711,10,7116,225.297846,0.617089,22181.5653819782,92252.4951830255
172.30.6.255,56005,34.234.151.4,443,86,72559,32,18750,54,53809,227.520166,122.914731,1220.3582010036,3502.2002366828
172.30.6.255,56006,34.234.151.4,443,8,480,5,294,3,186,227.651273,11.221532,209.597049672,132.6022150986
172.30.6.255,56007,202.58.9.200,443,24,8571,13,2074,11,6497,227.849513,76.757461,216.1613970009,677.1458998624
172.30.6.255,56011,35.187.209.5,443,30,13691,16,2219,14,11472,227.862074,10.778726,1646.9478860489,8514.5498642418
172.30.6.255,56012,141.170.25.54,443,18,6663,8,2012,10,4651,227.883964,0.821722,19588.1332129352,45280.5206627046
172.30.6.255,56014,54.179.181.44,443,23,7942,12,1893,11,6049,227.894798,76.711981,197.413752097,630.8271455016
172.30.6.255,56008,204.11.109.67,443,29,9485,14,2682,15,6803,227.942517,183.918495,116.6603717587,295.9136872015
172.30.6.255,56009,54.183.78.192,443,25,8548,14,2043,11,6505,228.028891,76.577746,213.4301524101,679.5707985451
172.30.6.255,56015,54.183.78.192,443,6,340,4,228,2,112,228.101729,10.819305,168.5875386635,82.8149312733
172.30.6.255,56017,204.11.109.67,443,7,402,4,228,3,174,228.109942,10.799521,168.8963797561,128.8946056033
172.30.6.255,56010,139.162.30.99,443,20,8035,9,1742,11,6293,228.151552,0.459707,30314.9614863393,109513.233429124
172.30.6.255,56013,18.210.163.206,443,6,348,4,228,2,120,228.151607,10.719408,170.1586505523,89.5571845012
172.30.6.255,56016,18.210.163.206,443,30,8860,14,1951,16,6909,228.151667,60.933425,256.1484111553,907.0883509338
172.30.6.255,56018,139.162.30.99,443,7,402,4,228,3,174,228.151785,1.373987,1327.5234772964,1013.1100221472
172.30.6.255,56019,34.234.151.4,443,38,19032,21,13708,17,5324,229.437197,120.991608,906.3769116946,352.0244147842
172.30.6.255,56020,34.234.151.4,443,36,13625,21,11890,15,1735,229.690735,121.733941,781.3761652553,114.0191460654
172.30.6.255,56021,52.114.74.44,443,62,42533,39,34346,23,8187,230.884719,8.417326,32643.1458161416,7781.0934256319
172.30.6.255,56022,52.114.74.44,443,270,240690,177,228719,93,11971,230.884779,8.417355,217378.499540533,11377.4457653265
172.30.6.255,56023,34.234.151.4,443,12,1408,6,904,6,504,232.188384,21.450628,337.1463063925,187.9665248029
172.30.6.255,56024,184.84.52.113,80,9,534,5,294,4,240,233.034686,19.926658,118.032838221,96.3533373233
172.30.6.255,56025,103.243.221.75,80,14,3815,8,2641,6,1174,237.855958,15.172857,1392.486596295,619.0000999812
172.30.6.255,56026,103.243.221.75,80,27,20100,10,3668,17,16432,237.858998,15.170113,1934.3296915455,8665.4595123978
172.30.6.255,56027,103.243.221.75,80,21,11743,9,3613,12,8130,237.859588,15.169524,1905.3992729106,4287.5438939284
172.30.6.255,56028,52.213.19.114,443,18,6378,9,1141,9,5237,238.761771,14.827201,615.6252956981,2825.6175929631
172.30.6.255,56029,199.166.0.200,443,27,13459,14,2041,13,11418,239.319932,0.621214,26284.0180678474,147041.11626589
172.30.6.255,56030,157.240.16.39,443,27,5478,15,3422,12,2056,240.100349,61.029443,448.5703728281,269.5092596536
172.30.6.255,56031,157.240.16.39,443,19,1933,10,1125,9,808,240.100381,61.029234,147.4703090653,105.9164530887
172.30.6.255,56032,172.217.166.206,443,32,5656,18,3623,14,2033,250.409939,116.048254,249.7581738714,140.1485971517
172.30.6.255,56033,172.217.166.206,443,17,1779,10,1150,7,629,250.410195,116.042894,79.2810286169,43.3632756522
172.30.6.255,56034,103.243.221.46,80,48,32058,28,27738,20,4320,252.837695,29.189374,7602.2185333608,1183.9925035734
172.30.6.255,56035,103.243.221.75,80,25,12653,11,4617,14,8036,252.843557,29.183354,1265.6530157569,2202.8996392944
172.30.6.255,56036,103.243.221.75,80,28,12556,14,6415,14,6141,252.845051,29.18047,1758.71053482,1683.5917995838
172.30.6.255,56037,103.243.221.75,80,24,15233,9,2612,15,12621,252.851002,29.174832,716.233773,3460.7911366893
172.30.6.255,56038,103.243.221.46,80,6,348,4,228,2,120,253.718647,28.307069,64.4362014308,33.9137902267
172.30.6.255,56039,151.101.153.108,80,32,20876,13,2494,19,18382,253.723338,157.906389,126.3533421691,931.2859405581
172.30.6.255,56040,172.217.166.194,80,20,4188,11,1898,9,2290,254.211903,157.430157,96.4491193387,116.3690639018
172.30.6.255,56046,204.79.197.200,443,33,10566,16,2128,17,8438,254.231101,124.248844,137.0153592737,543.2968052403
172.30.6.255,56041,210.176.156.35,80,22,7588,12,4480,10,3108,254.310392,157.91723,226.9543355085,157.4495702591
172.30.6.255,56042,161.170.232.82,80,17,2015,9,962,8,1053,254.39964,157.476032,48.8709291329,53.4938548617
172.30.6.255,56048,103.243.221.75,443,18,5463,10,3038,8,2425,254.410095,30.434925,798.5562638975,637.4255891874
172.30.6.255,56049,161.170.232.82,80,7,398,4,228,3,170,254.463556,27.658936,65.9461376244,49.1703657726
172.30.6.255,56043,52.76.32.254,80,19,5210,11,2186,8,3024,254.482382,69.432396,251.8708989965,348.4252509448
172.30.6.255,56044,13.250.67.150,80,13,1509,7,869,6,640,254.482535,69.434008,100.1238470923,73.7390818632
172.30.6.255,56045,54.239.17.112,80,6,344,4,228,2,116,254.482627,27.572141,66.1537310432,33.657161408
172.30.6.255,56051,13.250.67.150,80,6,348,4,228,2,120,254.482763,27.439015,66.4746894158,34.9866786399
172.30.6.255,56052,54.239.17.112,80,15,2074,9,1018,6,1056,254.482979,157.339657,51.7606314599,53.6927571922
172.30.6.255,56050,52.76.32.254,80,6,348,4,228,2,120,254.48326,27.442489,66.4662742509,34.9822496057
172.30.6.255,56047,103.243.220.234,443,33,17003,17,7753,16,9250,254.616457,30.228825,2051.816436795,2447.9945879471
172.30.6.255,56053,103.243.220.234,443,6,348,4,228,2,120,254.629168,27.39682,66.5770698935,35.0405631018
172.30.6.255,56054,54.251.186.7,80,20,6280,11,2893,9,3387,254.748213,92.418682,250.4255578975,293.1874748008
172.30.6.255,56055,52.76.32.254,443,28,9889,16,3309,12,6580,255.649145,69.16762,382.7224357293,761.0497513143
172.30.6.255,56056,13.250.69.79,443,24,8633,13,2188,11,6445,256.637565,68.179844,256.732766945,756.2352298723
172.30.6.255,56057,23.198.119.161,80,15,5642,7,615,8,5027,275.5389,60.451058,81.3881537028,665.265444982
172.30.6.255,56058,34.234.151.4,443,22,5803,13,4892,9,911,284.848479,121.224848,322.8381032905,60.1196876733
172.30.6.255,56059,103.243.221.87,80,51,33289,21,9342,30,23947,284.902713,19.212596,3889.9480320098,9971.3750291736
172.30.6.255,56060,103.243.221.87,80,14,3896,8,2714,6,1182,284.903264,19.211923,1130.1315334233,492.1943524342
172.30.6.255,56061,103.243.221.87,80,37,25425,14,5218,23,20207,284.903716,19.211923,2172.8173697136,8414.3581045999
172.30.6.255,56062,103.243.221.46,80,20,9439,11,8154,9,1285,286.021005,18.094634,3605.0466674264,568.1242295368
172.30.6.255,56063,103.243.221.46,80,24,13830,14,11673,10,2157,286.033446,18.082193,5164.4178336112,954.3090265655
172.30.6.255,56064,103.15.158.128,443,22,9387,11,3094,11,6293,286.389657,10.317192,2399.1023914259,4879.6222848233
172.30.6.255,56065,52.54.208.77,80,15,1843,8,1021,7,822,286.544266,107.512164,75.9727987616,61.1651719707
172.30.6.255,56066,103.71.26.126,80,8,1499,4,702,4,797,286.544361,35.231148,159.4043997658,180.9762202469
172.30.6.255,56067,184.29.25.121,80,14,1586,8,920,6,666,286.54469,125.078701,58.8429520067,42.5971804744
172.30.6.255,56068,52.0.91.50,80,13,1699,7,998,6,701,286.544844,64.879217,123.059438279,86.4375413162
172.30.6.255,56069,52.4.123.24,80,13,1420,7,800,6,620,286.544943,61.170907,104.6248995458,81.084297148
172.30.6.255,56072,52.54.208.77,80,6,348,4,228,2,120,286.645189,17.606776,103.596478992,54.5244626273
172.30.6.255,56073,52.0.91.50,80,6,348,4,228,2,120,286.645654,17.606117,103.6003566261,54.5265034874
172.30.6.255,56074,52.4.123.24,80,6,348,4,228,2,120,286.646145,17.605115,103.6062530691,54.5296068785
172.30.6.255,56070,13.228.225.25,80,6,348,4,228,2,120,286.66907,17.397462,104.8428788061,55.1804625295
172.30.6.255,56071,37.157.6.251,80,11,1354,6,780,5,574,286.669194,37.31988,167.2031099778,123.0443399068
172.30.6.255,56076,37.157.6.251,80,6,344,4,228,2,116,286.669369,17.427278,104.6635051096,53.2498534768
172.30.6.255,56075,13.228.225.25,80,13,2332,7,1212,6,1120,286.669523,82.26705,117.8600666974,108.9135929877
172.30.6.255,56078,157.240.16.39,443,28,5421,15,3273,13,2148,301.10273,60.690445,431.4352943037,283.1417696805
172.30.6.255,56077,157.240.16.39,443,19,1933,10,1125,9,808,301.102731,60.090204,149.7748285228,107.5716101746
172.30.6.255,56079,103.243.221.87,80,35,21330,14,7964,21,13366,303.860234,20.163755,3159.7289294578,5302.9805212373
172.30.6.255,56080,103.243.221.87,80,25,16506,10,3874,15,12632,303.864244,22.196359,1396.2650360809,4552.8187753676
172.30.6.255,56081,103.243.221.87,80,14,4375,8,2848,6,1527,303.86752,20.155925,1130.3872186466,606.0748886494
172.30.6.255,56082,103.243.221.87,80,6,348,4,228,2,120,304.112093,19.912285,91.6017423415,48.2114433376
172.30.6.255,56083,103.243.221.46,80,25,14033,15,11877,10,2156,305.079048,19.751632,4810.5392000013,873.2442969776
172.30.6.255,56084,103.243.221.46,80,15,4481,9,3358,6,1123,305.089621,19.772249,1358.6719447039,454.374209024
172.30.6.255,56085,103.243.221.46,80,7,394,4,228,3,166,305.333653,18.691451,97.5847193458,71.0485237342
172.30.6.255,56086,50.116.239.135,80,10,1596,6,898,4,698,305.506264,7.508448,956.7889396051,743.6956345706
172.30.6.255,56087,184.29.25.201,80,17,6725,9,3884,8,2841,305.651602,7.286872,4264.1067388037,3119.0337911796
172.30.6.255,56088,151.101.194.49,80,6,348,4,228,2,120,305.824794,18.178693,100.3372464676,52.8090770882
172.30.6.255,56089,72.247.228.146,80,19,3776,10,1981,9,1795,305.824855,105.821306,149.7619014454,135.7004609261
172.30.6.255,56090,13.228.114.100,80,6,348,4,228,2,120,305.824907,18.097097,100.7896459858,53.0471820978
172.30.6.255,56091,52.198.158.144,80,6,348,4,228,2,120,305.824948,18.160571,100.4373706091,52.8617740048
172.30.6.255,56092,54.169.211.49,443,30,8435,14,2157,16,6278,305.825011,60.477661,285.3284950951,830.455397407
172.30.6.255,56096,72.247.228.146,80,9,534,5,294,4,240,305.825065,18.048839,130.3130910526,106.3780335123
172.30.6.255,56097,54.169.211.49,443,6,348,4,228,2,120,305.825612,18.095382,100.7991983811,53.0522096743
172.30.6.255,56100,52.198.158.144,80,13,1648,7,943,6,705,305.8258,63.160832,119.4411118587,89.2958471478
172.30.6.255,56098,151.101.194.49,80,10,1572,5,904,5,668,305.825942,0.485545,14894.6029719181,11006.1889217271
172.30.6.255,56099,13.228.114.100,80,13,1669,7,855,6,814,305.826042,63.110987,108.3804948257,103.1833015066
172.30.6.255,56093,54.193.113.6,80,13,1900,7,860,6,1040,305.960619,63.15399,108.9400685531,131.7414782502
172.30.6.255,56094,18.195.210.3,80,13,1959,7,1144,6,815,305.960839,63.022043,145.2190307445,103.4558654343
172.30.6.255,56095,35.186.202.217,443,38,9886,18,2331,20,7555,305.96108,105.691827,176.4374836665,571.8512179754
172.30.6.255,56101,54.193.113.6,80,6,348,4,228,2,120,305.961259,18.156748,100.4585182325,52.8729043329
172.30.6.255,56102,18.195.210.3,80,7,402,4,228,3,174,305.961463,18.033826,101.1432626665,77.1882794034
172.30.6.255,56103,35.186.202.217,443,7,402,4,228,3,174,305.961639,17.910796,101.8380199294,77.7184888935
172.30.6.255,56104,103.243.221.87,443,22,8887,11,3303,11,5584,306.239935,18.575521,1422.5173011298,2404.8854403599
172.30.6.255,56105,75.98.70.37,80,13,1591,8,917,5,674,306.362824,105.465651,69.5581919842,51.1256503788
172.30.6.255,56106,75.98.70.37,80,6,348,4,228,2,120,306.397014,17.660454,103.2816030664,54.358738456
172.30.6.255,56107,103.243.221.87,443,23,8950,12,3378,11,5572,306.405193,18.410856,1467.8296326906,2421.1801993346
172.30.6.255,56108,103.243.221.87,443,6,340,4,228,2,112,306.556602,17.468304,104.4176927537,51.2929017036
172.30.6.255,56109,157.240.16.39,443,148,101894,55,13570,93,88324,306.842488,72.178245,1504.0543033431,9789.5425415234
172.30.6.255,56110,157.240.16.20,443,2240,2157761,736,54045,1504,2103716,312.910159,65.503422,6600.5711884793,256928.989145025
172.30.6.255,56111,157.240.16.17,443,2099,1999847,693,48608,1406,1951239,313.016272,72.878105,5335.8138222721,214192.067699894
172.30.6.255,56112,157.240.16.20,443,47,19136,19,2268,28,16868,313.021661,66.073227,274.6044173081,2042.3400842826
172.30.6.255,56114,103.243.221.87,80,7,414,5,294,2,120,323.859741,16.592522,141.7506030729,57.8573890093
172.30.6.255,56115,103.243.221.87,80,23,15191,8,2867,15,12324,323.861793,16.590033,1382.516840081,5942.8453216458
172.30.6.255,56116,103.243.221.87,80,23,15112,8,2867,15,12245,323.862652,16.589173,1382.5885111934,5905.0562677236
172.30.6.255,56113,103.243.221.109,80,7,406,5,294,2,112,323.932672,16.520819,142.3658233893,54.2345993864
172.30.6.255,56117,103.243.221.109,80,7,406,5,294,2,112,324.084031,16.369735,143.6797846758,54.735156067
172.30.6.255,56118,103.243.221.87,80,15,4446,8,2866,7,1580,324.111285,16.340863,1403.1082691288,773.5209578588
172.30.6.255,56119,103.243.221.109,80,27,13806,15,11564,12,2242,325.147564,15.304859,6044.6162881997,1171.9154028142
172.30.6.255,56120,103.243.221.109,80,32,19493,18,17087,14,2406,325.171573,15.281006,8945.4843483472,1259.6029345188
172.30.6.255,56121,172.217.160.234,443,16,4518,9,1120,7,3398,327.509606,11.485811,780.0929337946,2366.7462402089
172.30.6.255,56122,52.84.108.179,443,16,2608,9,1663,7,945,332.766194,78.848074,168.7295494371,95.8805918328
172.30.6.255,56124,172.64.128.2,443,83,42345,37,3334,46,39011,333.0944,78.656152,339.0961713967,3967.750672573
172.30.6.255,56123,172.64.128.2,443,20,7901,10,1169,10,6732,333.0944,0.479756,19493.2423982187,112257.064007535
172.30.6.255,56125,172.64.128.2,443,6,348,4,228,2,120,333.229161,12.750213,143.0564336455,75.2928598134
172.30.6.255,56126,18.211.245.141,443,27,6171,13,1765,14,4406,340.265851,60.796294,232.2509987204,579.7721815083
172.30.6.255,56127,103.243.221.109,80,48,33586,28,29276,20,4310,345.83748,23.188727,10100.080094953,1486.9294032398
172.30.6.255,56128,103.243.221.87,80,14,4069,8,2896,6,1173,345.848861,23.177219,999.6022387328,404.880326669
172.30.6.255,56129,103.243.221.87,80,25,15701,10,3256,15,12445,345.849232,23.17668,1123.8883222273,4295.6972266951
172.30.6.255,56130,103.243.221.87,80,29,22264,9,3202,20,19062,345.852267,23.173812,1105.3856827699,6580.5315068578
172.30.6.255,56131,210.176.156.21,80,41,21355,20,14921,21,6434,345.944281,65.774974,1814.7935717922,782.5468695738
172.30.6.255,56132,103.243.221.109,80,6,340,4,228,2,112,347.064022,21.962543,83.0504919216,40.7967328738
172.30.6.255,56133,66.117.28.68,443,26,9715,14,2480,12,7235,351.298845,43.154306,459.7455465974,1341.2334796903
172.30.6.255,56134,66.117.28.68,443,6,348,4,228,2,120,351.456625,17.526482,104.0710851157,54.774255324
172.30.6.255,56136,157.240.16.39,443,19,1933,10,1125,9,808,362.08887,61.029262,147.4702414065,105.9164044946
172.30.6.255,56135,157.240.16.39,443,28,5420,15,3274,13,2146,362.08887,61.028743,429.1748234107,281.3100705679
172.30.6.255,56137,172.217.166.206,443,17,1779,10,1150,7,629,366.407989,64.043857,143.6515605236,78.5711578864
172.30.6.255,56138,172.217.166.206,443,35,5941,19,3730,16,2211,366.407989,64.046942,465.908270843,276.1724361485
172.30.6.255,56139,161.69.38.37,80,7,398,4,228,3,170,367.095595,0.639118,2853.9330765211,2127.9325570552
172.30.6.255,56140,161.69.38.37,80,7,398,4,228,3,170,367.501561,0.597507,3052.6839016112,2276.1239617276
172.30.6.255,56141,103.243.221.109,80,38,23520,22,19426,16,4094,368.83522,25.190457,6169.3203898603,1300.1749035359
172.30.6.255,56142,103.243.221.87,80,15,4177,8,2950,7,1227,368.848818,25.176553,937.3801091833,389.8865742264
172.30.6.255,56143,103.243.221.87,80,34,29055,9,3923,25,25132,368.850351,25.174605,1246.6531252427,7986.4609593676
172.30.6.255,56144,103.243.221.87,80,20,11995,8,3868,12,8127,368.851379,25.173993,1229.2050768426,2582.6653721561
172.30.6.255,56145,172.217.161.1,80,11,3009,6,822,5,2187,370.375184,41.267448,159.3507793358,423.9661245832
172.30.6.255,56146,172.217.161.1,80,6,348,4,228,2,120,370.438575,23.401311,77.9443510665,41.0233426666
172.30.6.255,56147,103.243.221.109,80,46,32527,27,28272,19,4255,393.837189,12.1912,18552.398451342,2792.1779644334
172.30.6.255,56148,103.243.221.87,80,24,15228,9,2921,15,12307,393.844612,12.18351,1918.0022834142,8081.0866490855
172.30.6.255,56149,103.243.221.87,80,15,4447,8,2866,7,1581,393.847372,12.181017,1882.2730483013,1038.3369467426
172.30.6.255,56150,103.243.221.87,80,23,15062,9,2921,14,12141,393.848726,12.178801,1918.7438894847,7975.1693126442
172.30.6.255,56151,103.243.221.109,80,6,340,4,228,2,112,394.759279,11.269186,161.8572983,79.5088482877
172.30.6.255,56152,172.217.166.195,443,34,7898,17,2357,17,5541,395.1762,16.474902,1144.5288111577,2690.63815979
172.30.6.255,56153,172.217.166.210,443,32,6969,15,2189,17,4780,406.059295,5.597375,3128.6093927957,6831.7738225508
172.30.6.255,56154,172.217.166.210,443,6,348,4,228,2,120,406.059315,5.586802,326.4837379238,171.8335462757
172.30.6.255,56155,172.217.166.210,443,32,6972,15,2189,17,4783,406.085045,5.571685,3143.0348269868,6867.5813510635
172.30.6.255,56156,103.243.221.109,80,47,33697,29,29486,18,4211,406.839261,4.954623,47609.6768613881,6799.3064255343
172.30.6.255,56157,103.243.221.17,80,31,21376,13,3418,18,17958,406.952649,4.840153,5649.4081901957,29681.7063427541
172.30.6.255,56158,103.243.221.17,80,13,4016,8,2896,5,1120,406.952686,4.84045,4786.3318493116,1851.0675660321
172.30.6.255,56159,103.243.221.17,80,29,21266,11,3310,18,17956,406.952789,4.840304,5470.7307640181,29677.4748032355
172.30.6.255,56160,103.243.221.17,80,7,394,4,228,3,166,407.105208,4.688634,389.0258868575,283.2381456945
172.30.6.255,56161,103.243.221.109,80,6,340,4,228,2,112,408.085839,3.70733,491.9982844797,241.6833678146
172.30.6.255,56163,157.240.16.39,443,18,1879,9,1071,9,808,423.09304,61.02206,140.4082392499,105.928905055
172.30.6.255,56162,157.240.16.39,443,28,5421,15,3274,13,2147,423.093043,61.021429,429.2262641047,281.4748897473
172.30.6.255,56164,103.243.221.109,80,32,18696,19,14765,13,3931,434.845137,30.185387,3913.15175121,1041.828617271
172.30.6.255,56165,103.243.221.17,80,14,4124,8,2950,6,1174,434.85981,30.169813,782.2388557728,311.3045480262
172.30.6.255,56166,103.243.221.17,80,31,26461,9,3923,22,22538,434.860818,30.168803,1040.2799209501,5976.5049345842
172.30.6.255,56167,173.241.248.220,80,95,49955,47,22218,48,27737,434.861298,421.390513,421.8035160179,526.5804358533
172.30.6.255,56168,103.243.221.17,80,19,11949,8,3869,11,8080,434.862925,30.166699,1026.0320494463,2142.7601342792
172.30.6.255,56169,103.231.98.53,80,187,96977,95,87985,92,8992,434.866675,383.079069,1837.4274580896,187.7836870278
172.30.6.255,56170,210.176.156.41,80,116,67250,59,48753,57,18497,434.870705,384.699639,1013.840306723,384.6533373014
172.30.6.255,56171,35.190.43.164,80,97,29107,50,21561,47,7546,434.87665,421.236584,409.480103466,143.3113891171
172.30.6.255,56172,35.190.43.164,80,93,27697,48,20485,45,7212,434.877407,421.234374,389.0470724025,136.9688789928
172.30.6.255,56173,180.149.59.210,80,153,109920,96,86678,57,23242,435.051176,421.028072,1646.9780665837,441.6237594723
172.30.6.255,56174,52.213.19.114,443,175,71227,106,57698,69,13529,435.653653,420.595164,1097.454368258,257.3305859503
172.30.6.255,56175,52.213.19.114,443,73,26674,41,18587,32,8087,435.654208,420.590774,353.540803061,153.8217288618
172.30.6.255,56176,52.213.19.114,443,19,6444,10,1207,9,5237,435.97973,29.646211,325.7077270347,1413.1991437287
172.30.6.255,56177,172.217.166.195,443,41,8576,19,2430,22,6146,437.094998,241.212264,80.5929171164,203.8370652663
172.30.6.255,56178,172.217.166.206,443,18,1837,11,1208,7,629,448.420761,162.029521,59.6434522571,31.0560690974
172.30.6.255,56179,172.217.166.206,443,38,6531,19,3895,19,2636,448.420761,161.790648,192.5945682596,130.3412790584
172.30.6.255,56180,103.243.221.75,80,86,65952,52,57659,34,8293,464.865536,26.172176,17624.518496284,2534.9057716867
172.30.6.255,56181,103.243.221.17,80,82,59236,32,17883,50,41353,464.86925,26.167288,5467.2841908569,12642.6552113463
172.30.6.255,56182,103.243.221.17,80,35,24218,14,5966,21,18252,464.870238,26.166302,1824.0254201759,5580.3070682284
172.30.6.255,56183,103.243.221.17,80,35,17551,18,9996,17,7555,464.872024,26.164053,3056.407201132,2310.0396563178
172.30.6.255,56184,103.243.221.75,80,6,348,4,228,2,120,466.107361,24.930577,73.1631682652,38.5069306659
172.30.6.255,56185,8.41.222.241,80,13,1968,6,834,7,1134,466.613953,7.450855,895.4677013578,1217.5783852994
172.30.6.255,56190,151.101.66.49,80,10,1609,5,941,5,668,466.617251,0.510589,14743.7567201806,10466.3437716053
172.30.6.255,56191,77.238.185.35,443,32,8346,14,1858,18,6488,466.618826,119.098589,124.8041653961,435.8070102745
172.30.6.255,56186,185.86.137.17,80,21,2291,12,1298,9,993,466.705287,303.374732,34.2282955853,26.1854372236
172.30.6.255,56187,54.85.156.219,80,13,1684,7,856,6,828,466.791342,61.307378,111.6994434177,108.0457233059
172.30.6.255,56188,54.169.126.196,80,16,4100,9,2196,7,1904,466.791484,64.326924,273.1049288164,236.7904300849
172.30.6.255,56189,192.132.33.27,443,35,15248,21,2582,14,12666,466.791698,96.950879,213.056345781,1045.1478217129
172.30.6.255,56192,151.101.130.2,80,25,2665,12,1256,13,1409,466.791856,303.230242,33.1365365596,37.1730732583
172.30.6.255,56193,176.34.37.52,443,22,7536,11,1734,11,5802,466.792056,61.996243,223.755494345,748.6905295213
172.30.6.255,56195,54.169.126.196,80,6,348,4,228,2,120,466.860209,24.070089,75.7786977855,39.8835251502
172.30.6.255,56196,54.85.156.219,80,6,348,4,228,2,120,466.86151,24.210619,75.338842018,39.6520221148
172.30.6.255,56197,185.86.137.17,80,7,394,4,228,3,166,466.863094,24.141848,75.5534539029,55.0082164381
172.30.6.255,56198,176.34.37.52,443,6,340,4,228,2,112,466.864519,24.132664,75.5822067551,37.1281015639
172.30.6.255,56199,192.132.33.27,443,7,402,4,228,3,174,466.866877,24.251377,75.2122240316,57.3988025505
172.30.6.255,56194,52.84.111.68,80,8,480,5,294,3,186,466.917745,23.934848,98.2667615019,62.1687674808
172.30.6.255,56200,52.84.111.68,80,14,2348,8,892,6,1456,466.918069,121.975668,58.5034713645,95.4944555007
172.30.6.255,56202,103.243.221.17,80,15,4983,7,2509,8,2474,466.978799,24.058407,834.3029528098,822.6646095064
172.30.6.255,56201,103.243.221.17,443,28,13546,14,5695,14,7851,467.047777,23.794585,1914.7213536189,2639.5921593085
172.30.6.255,56203,103.243.221.17,80,6,340,4,228,2,112,467.051395,23.985388,76.046299522,37.3560769582
172.30.6.255,56204,103.243.221.17,443,6,340,4,228,2,112,467.215331,23.822832,76.5652043384,37.6109775698
172.30.6.255,56205,54.149.221.157,80,12,2338,6,1168,6,1170,467.332771,23.818197,392.3050934544,392.9768487514
172.30.6.255,56206,54.149.221.157,80,7,402,4,228,3,174,467.495472,23.6609,77.0892062432,58.8312363435
172.30.6.255,56207,157.240.16.39,443,61,17173,31,4421,30,12752,469.26986,161.821049,218.562419528,630.4247848498
172.30.6.255,56208,119.42.60.92,80,11,1676,6,807,5,869,469.716408,31.283851,206.3684550857,222.2232806313
172.30.6.255,56209,173.198.245.125,80,11,1226,6,787,5,439,469.803126,6.248369,1007.6229492849,562.06667692
172.30.6.255,56210,104.198.91.84,80,14,2760,8,1472,6,1288,469.888213,21.096996,558.1837338359,488.4107671064
172.30.6.255,56211,54.209.69.152,80,7,414,5,294,2,120,469.888227,21.179766,111.0493855315,45.3262798088
172.30.6.255,56212,139.99.8.179,80,13,1520,7,763,6,757,469.888248,60.536504,100.8317229551,100.038812945
172.30.6.255,56213,104.16.231.152,80,13,1751,7,801,6,950,469.888305,52.021177,123.1806039298,146.0943492301
172.30.6.255,56214,54.221.241.51,80,13,1480,7,865,6,615,469.888335,61.536873,112.4529028311,79.9520638626
172.30.6.255,56220,104.198.91.84,80,6,348,4,228,2,120,469.965651,21.019902,86.77490504,45.6710026526
172.30.6.255,56221,54.209.69.152,80,16,2858,9,1649,7,1209,469.966402,61.545231,214.3464210899,157.1527126123
172.30.6.255,56222,173.198.245.125,80,6,348,4,228,2,120,469.967223,21.108318,86.4114326873,45.4797014144
172.30.6.255,56223,139.99.8.179,80,6,348,4,228,2,120,469.968024,20.958874,87.0275760043,45.8039873707
172.30.6.255,56225,54.221.241.51,80,6,348,4,228,2,120,469.969819,21.092578,86.4759158411,45.5136399164
172.30.6.255,56215,54.36.212.191,80,7,614,5,282,2,332,470.031303,20.813731,108.389985438,127.6080679624
172.30.6.255,56216,162.210.199.69,80,14,3360,8,1447,6,1913,470.031396,6.349581,1823.1124226937,2410.2377778943
172.30.6.255,56217,159.127.41.210,80,6,344,4,228,2,116,470.031509,21.075938,86.5441908208,44.031254979
172.30.6.255,56218,54.36.212.191,80,10,1543,6,851,4,692,470.031621,20.961574,324.7847704566,264.1023045311
172.30.6.255,56219,162.210.199.69,80,7,402,4,228,3,174,470.03193,6.022211,302.8787931874,231.1443421693
172.30.6.255,56224,159.127.41.210,80,11,1476,6,806,5,670,470.032266,6.05755,1064.4567523174,884.8461836881
172.30.6.255,56226,103.243.221.51,80,14,4939,7,2545,7,2394,470.17184,20.86587,975.7561031483,917.8625190323
172.30.6.255,56227,103.243.221.51,80,6,340,4,228,2,112,470.32594,20.711457,88.067198749,43.2610800872
172.30.6.255,56228,103.229.206.182,80,23,2650,13,1537,10,1113,470.513652,347.474149,35.3868051347,25.6249278561
172.30.6.255,56229,104.122.118.96,80,33,6314,19,3728,14,2586,470.599544,385.506032,77.3632512189,53.6645299496
172.30.6.255,56230,103.229.206.182,80,6,348,4,228,2,120,470.670753,20.350518,89.6291681617,47.1732464009
172.30.6.255,56231,18.214.153.193,80,14,1785,7,895,7,890,476.276334,60.873559,117.6208540723,116.9637543289
172.30.6.255,56232,18.214.153.193,80,6,348,4,228,2,120,476.416732,14.643494,124.560436191,65.558124311
172.30.6.255,56233,157.240.16.39,443,26,5276,14,3220,12,2056,484.088275,61.061602,421.8690495543,269.3673185974
172.30.6.255,56234,157.240.16.39,443,18,1879,10,1125,8,754,484.088279,61.061826,147.3915961832,98.7851231308
172.30.6.255,56235,172.217.166.197,443,1137,1062406,383,29475,754,1032931,490.85284,365.265355,645.5580765386,22623.1365413783
172.30.6.255,56236,103.243.221.75,80,35,19697,21,15711,14,3986,500.850502,21.540314,5835.0124329664,1480.3869618614
172.30.6.255,56237,103.243.221.17,80,31,22385,11,4240,20,18145,500.85749,21.594694,1570.7562237279,6722.0216225338
172.30.6.255,56238,103.243.221.17,80,16,4442,9,3214,7,1228,500.863073,21.582922,1191.3122792178,455.1746978468
172.30.6.255,56239,103.243.221.17,80,23,12036,11,4253,12,7783,500.864819,21.581543,1576.5323174529,2885.0578478101
172.30.6.255,56240,172.217.166.206,443,17,1783,10,1154,7,629,506.499266,103.711247,89.0163821866,48.5193278989
172.30.6.255,56241,172.217.166.206,443,30,4540,17,3255,13,1285,506.499277,103.992472,250.4027406907,98.8533093049
172.30.6.255,56242,103.243.221.17,80,47,30171,30,26025,17,4146,527.864189,38.790294,5367.322041952,855.0592578649
172.30.6.255,56243,103.243.221.46,80,77,58002,29,16747,48,41255,527.879058,38.745145,3457.8783999905,8518.2285419244
172.30.6.255,56244,103.243.221.46,80,29,19544,15,6355,14,13189,527.879403,39.972779,1271.8655362941,2639.5963112797
172.30.6.255,56245,103.243.221.46,80,14,4986,8,3358,6,1628,527.879684,3.515119,7642.4155199297,3705.1377207998
172.30.6.255,56246,103.243.221.46,80,14,4500,10,3434,4,1066,528.111997,38.827363,707.5422557025,219.6389180486
172.30.6.255,56247,103.243.221.17,80,56,40403,34,35985,22,4418,529.130817,37.587106,7659.0094486125,940.32246058
172.30.6.255,56248,210.176.156.35,80,26,6278,14,4852,12,1426,529.675176,301.136655,128.8982903792,37.8831331576
172.30.6.255,56249,202.241.208.52,80,11,1966,6,831,5,1135,529.831116,36.532429,181.9753074727,248.5462984134
172.30.6.255,56257,202.241.208.52,80,6,348,4,228,2,120,529.925736,36.434164,50.0629025,26.3488960526
172.30.6.255,56250,23.56.26.27,80,11,3817,7,2458,4,1359,529.951518,6.039647,3255.8194212344,1800.105204824
172.30.6.255,56251,31.172.81.158,80,25,4366,14,2136,11,2230,529.95165,217.33273,78.6259851427,82.0861174477
172.30.6.255,56252,202.241.208.4,80,11,1970,6,808,5,1162,529.951741,36.410052,177.5333910537,255.3141094113
172.30.6.255,56253,104.16.91.60,80,8,456,5,282,3,174,529.951828,36.558767,61.7088645249,38.0756823664
172.30.6.255,56254,151.101.128.166,80,21,2987,12,1658,9,1329,529.951931,300.722411,44.1071217669,35.3548641907
172.30.6.255,56261,202.241.208.4,80,7,402,4,228,3,174,529.951984,36.425584,50.074694753,38.2148986273
172.30.6.255,56262,104.16.91.60,80,13,1666,7,942,6,724,529.952133,58.956374,127.823329162,98.2421340905
172.30.6.255,56258,23.56.26.27,80,9,948,5,294,4,654,529.952428,37.404518,62.8801044836,139.8761507901
172.30.6.255,56260,31.172.81.158,80,6,348,4,228,2,120,529.952633,36.405468,50.1023637438,26.3696651283
172.30.6.255,56259,151.101.128.166,80,6,348,4,228,2,120,529.952783,36.28399,50.270105355,26.4579501868
172.30.6.255,56255,52.8.9.72,80,6,348,4,228,2,120,530.107591,37.273271,48.9358714989,25.7557218415
172.30.6.255,56256,192.99.18.118,443,6,348,4,228,2,120,530.107627,36.327714,50.2096003068,26.4261054246
172.30.6.255,56264,52.8.9.72,80,13,2134,7,837,6,1297,530.107737,61.274044,109.2795507344,169.3376072909
172.30.6.255,56263,192.99.18.118,443,34,9255,18,2145,16,7110,530.107792,181.161628,94.7220456641,313.9737737398
172.30.6.255,56265,103.243.223.145,443,30,12689,17,4760,13,7929,530.275373,76.155751,500.027896777,832.9246204925
172.30.6.255,56266,103.243.223.145,443,29,13440,16,5859,13,7581,530.275464,76.155525,615.4773406132,796.3703224421
172.30.6.255,56267,103.243.223.145,443,19,7650,11,1273,8,6377,530.275489,35.897766,283.6945340833,1421.1469315389
172.30.6.255,56268,103.243.223.145,443,41,20877,23,7915,18,12962,530.307663,76.123161,831.8099139367,1362.2135318317
172.30.6.255,56269,103.243.223.145,443,7,402,5,282,2,120,530.338126,36.61118,61.6205213817,26.2214984603
172.30.6.255,56270,31.172.81.172,80,21,3308,11,1570,10,1738,530.519504,216.522958,58.0077055847,64.2148995581
172.30.6.255,56271,31.172.81.172,80,6,348,4,228,2,120,530.584018,35.763136,51.0022387298,26.843283542
172.30.6.255,56272,147.75.111.32,443,31,12050,16,5020,15,7030,531.274171,36.898299,1088.3970559185,1524.189502611
172.30.6.255,56273,147.75.111.32,443,5,294,3,174,2,120,531.522878,34.923986,39.8579933001,27.4882712414
172.30.6.255,56275,157.240.16.39,443,19,1933,10,1125,9,808,545.09327,61.034327,147.4580034281,105.9076149066
172.30.6.255,56274,157.240.16.39,443,57,18431,30,6834,27,11597,545.093303,122.056349,447.9242616048,760.1079399811
172.30.6.255,56276,157.240.16.20,443,29,8400,16,1897,13,6503,566.218215,65.802847,230.6283191668,790.6040904279
172.30.6.255,56277,103.243.221.17,80,37,24782,22,20742,15,4040,566.837036,22.223066,7466.8364842187,1454.3447785288
172.30.6.255,56278,103.243.221.46,80,15,4626,8,3398,7,1228,566.846736,22.210624,1223.9187876937,442.3108508793
172.30.6.255,56279,103.243.221.46,80,29,17879,12,7111,17,10768,566.851232,22.206486,2561.7740690715,3879.2269970134
172.30.6.255,56280,103.243.221.46,80,50,37628,19,12573,31,25055,566.864445,22.193504,4532.1369712507,9031.4715513152
172.30.6.255,56281,157.240.16.20,443,34,9102,18,2090,16,7012,566.962362,65.335097,255.9114590432,858.5890673737
172.30.6.255,56282,157.240.16.20,443,29,8368,15,1769,14,6599,567.158235,65.306782,216.7003114623,808.3693359749
172.30.6.255,56283,157.240.16.20,443,22,2123,12,1261,10,862,567.158285,65.309424,154.4646910375,105.5896619146
172.30.6.255,56284,103.243.221.17,80,6,348,4,228,2,120,568.224164,20.837845,87.533043844,46.0700230758
172.30.6.255,56285,95.142.20.29,80,7,609,5,282,2,327,569.021713,19.820972,113.818837946,131.9814184693
172.30.6.255,56299,95.142.20.29,80,10,1236,6,780,4,456,569.021769,20.005451,311.9149875701,182.3503004256
172.30.6.255,56286,104.20.68.222,80,7,402,4,228,3,174,569.159706,19.751353,92.3481039501,70.4761845935
172.30.6.255,56287,52.84.110.150,80,15,2034,8,919,7,1115,569.159747,128.713376,57.119160638,69.3012667153
172.30.6.255,56288,52.212.77.226,80,13,1892,7,842,6,1050,569.159886,62.891607,107.1049114709,133.5631318818
172.30.6.255,56289,209.205.217.82,80,11,1469,6,750,5,719,569.159972,36.908472,162.5643023098,155.8449778143
172.30.6.255,56290,54.246.129.36,80,10,1555,6,872,4,683,569.160113,19.885061,350.8161227164,274.7791419901
172.30.6.255,56298,209.205.217.82,80,6,348,4,228,2,120,569.160183,19.931701,91.5125106482,48.1644792885
172.30.6.255,56295,52.212.77.226,80,6,348,4,228,2,120,569.160396,19.87842,91.7577956397,48.2935766525
172.30.6.255,56297,104.20.68.222,80,14,1745,8,844,6,901,569.160645,63.128558,106.9563477119,114.1797029484
172.30.6.255,56300,54.246.129.36,80,7,614,5,282,2,332,569.160915,19.680595,114.6306806273,134.955269391
172.30.6.255,56296,52.84.110.150,80,9,534,5,294,4,240,569.161073,19.732807,119.1923683235,97.299892509
172.30.6.255,56291,52.84.107.243,80,15,1676,8,853,7,823,569.288291,128.583448,53.0705942805,51.2041021019
172.30.6.255,56292,52.5.131.6,80,13,1942,7,981,6,961,569.288433,62.814704,124.9388996564,122.3917253514
172.30.6.255,56301,52.84.107.243,80,8,480,5,294,3,186,569.28858,19.596569,120.0210098002,75.9316592614
172.30.6.255,56303,52.5.131.6,80,6,348,4,228,2,120,569.288757,19.820172,92.0274556649,48.4355029815
172.30.6.255,56293,34.226.179.16,443,21,6120,12,1771,9,4349,569.402157,63.399272,223.4725976033,548.7760174912
172.30.6.255,56302,34.226.179.16,443,6,348,4,228,2,120,569.402157,19.68841,92.6433368667,48.7596509825
172.30.6.255,56294,139.162.49.205,80,10,1165,5,748,5,417,569.654552,0.469395,12748.3249715038,7107.0207394613
172.30.6.255,56304,139.162.49.205,80,7,402,4,228,3,174,569.654554,19.332245,94.3501388483,72.0040533316
172.30.6.255,56305,103.243.221.17,80,51,35809,30,31445,21,4364,588.850687,17.189485,14634.5280268723,2031.0090732794
172.30.6.255,56306,103.243.221.46,80,30,14549,16,9376,14,5173,588.856728,17.182387,4365.4004533829,2408.5128567992
172.30.6.255,56307,103.243.221.46,80,44,33549,18,10888,26,22661,588.857298,17.181818,5069.545027191,10551.1535508058
172.30.6.255,56308,103.243.221.46,80,23,16209,8,3726,15,12483,588.858292,17.180627,1734.9774254455,5812.5934519154
172.30.6.255,56309,103.243.221.17,80,6,348,4,228,2,120,590.110983,15.92955,114.5041762008,60.2653558952
172.30.6.255,56315,204.2.197.204,80,9,1227,5,725,4,502,590.771027,0.792544,7318.2056769086,5067.2265514595
172.30.6.255,56318,35.201.85.114,80,25,4034,13,1847,12,2187,590.812536,241.909367,61.0807269815,72.3246074221
172.30.6.255,56310,147.75.111.32,80,17,5978,9,4775,8,1203,590.816576,15.2701,2501.620814533,630.2512753682
172.30.6.255,56319,50.57.31.206,80,7,398,4,228,3,170,590.941584,15.139916,120.4762298549,89.8287678743
172.30.6.255,56311,52.221.7.77,80,14,3328,8,2216,6,1112,590.941644,61.101056,290.1422849386,145.5948650053
172.30.6.255,56312,50.57.31.206,80,21,1891,11,1094,10,797,590.941688,265.355869,32.9821233387,24.0281099643
172.30.6.255,56313,205.251.72.175,80,7,402,4,228,3,174,590.9417,15.12919,120.5616427581,92.0075694733
172.30.6.255,56314,63.251.88.56,80,10,1747,5,936,5,811,590.941735,0.748644,10002.0837674514,8666.3354010717
172.30.6.255,56316,66.117.28.68,80,6,348,4,228,2,120,590.941749,15.054568,121.1592388437,63.768020444
172.30.6.255,56320,63.251.88.56,80,7,398,4,228,3,170,590.942006,15.129099,120.5623679242,89.8929936277
172.30.6.255,56321,204.2.197.204,80,7,402,4,228,3,174,590.942284,15.131459,120.5435642392,91.9937727089
172.30.6.255,56322,205.251.72.175,80,9,1005,5,705,4,300,590.942671,0.749181,7528.2208171321,3203.4982200562
172.30.6.255,56323,66.117.28.68,80,10,2060,6,964,4,1096,590.94301,41.095219,187.6617326215,213.358152441
172.30.6.255,56324,52.221.7.77,80,6,348,4,228,2,120,590.943302,14.993798,121.6502983434,64.0264728123
172.30.6.255,56326,147.75.111.32,80,5,294,3,174,2,120,590.944036,15.137583,91.9565560764,63.4183145354
172.30.6.255,56317,152.163.13.4,80,7,414,5,294,2,120,591.077486,15.063698,156.1369591982,63.7293711013
172.30.6.255,56325,152.163.13.4,80,20,2755,11,1421,9,1334,591.077615,265.285643,42.8519232004,40.2283360657
172.30.6.255,56327,54.169.155.247,80,15,3674,8,1622,7,2052,591.169262,60.87344,213.1635734731,269.6742618784
172.30.6.255,56328,52.32.120.236,80,12,2008,7,1028,5,980,591.605078,41.091837,200.1370734533,190.7921517356
172.30.6.255,56332,52.32.120.236,80,6,348,4,228,2,120,591.690186,14.444081,126.2801004785,66.4632107782
172.30.6.255,56329,77.66.11.200,80,7,402,4,228,3,174,591.729486,14.273287,127.7911668139,97.5248378317
172.30.6.255,56333,77.66.11.200,80,10,1557,6,815,4,742,591.729486,14.270971,456.8715050994,415.9492721273
172.30.6.255,56330,203.174.85.172,80,18,5635,10,4795,8,840,591.895982,15.973915,2401.4150569851,420.6858493988
172.30.6.255,56331,203.174.85.172,80,6,348,4,228,2,120,591.896042,14.096648,129.392462662,68.1012961379
172.30.6.255,56335,51.140.98.69,443,81,54290,40,3614,41,50676,600.856182,69.987099,413.104706626,5792.6104352461
172.30.6.255,56334,13.107.3.128,443,34,21698,12,1583,22,20115,600.856182,66.540974,190.3188252099,2418.3595509137
172.30.6.255,56336,52.109.120.3,443,58,41859,31,23680,27,18179,601.467654,5.789319,32722.3288265858,25120.743907876
172.30.6.255,56338,52.114.76.35,443,25,11987,16,5458,9,6529,602.435243,3.157293,13829.5685576221,16543.2856564153
172.30.6.255,56337,52.114.76.35,443,35,22041,24,15028,11,7013,602.43532,3.156783,38084.3409255573,17772.5234835596
172.30.6.255,56339,52.109.120.4,443,19,9069,9,2170,10,6899,604.034702,106.880055,162.4250661173,516.3919498357
172.30.6.255,56340,52.109.120.4,443,24,9399,15,2554,9,6845,604.034926,132.047343,154.7323826122,414.6997490135
172.30.6.255,56341,103.243.221.17,80,48,36629,31,32471,17,4158,605.841525,26.490716,9806.00146859,1255.6851992978
172.30.6.255,56342,103.243.221.46,80,35,21220,16,9610,19,11610,605.847583,26.229465,2931.0548270809,3541.0558316763
172.30.6.255,56343,103.243.221.46,80,16,4877,9,3649,7,1228,605.855689,26.221963,1113.2652425755,374.6477714121
172.30.6.255,56344,103.243.221.46,80,40,26098,18,9870,22,16228,605.857659,26.220441,3011.3909983436,4951.251582687
172.30.6.255,56345,103.243.221.17,80,7,402,5,282,2,120,606.888525,25.727165,87.6894131164,37.3146438793
172.30.6.255,56346,202.58.9.200,80,11,1646,6,879,5,767,607.491564,24.482992,287.2197973189,250.6229630758
172.30.6.255,56348,18.207.56.96,80,15,5361,9,2805,6,2556,607.536173,24.938276,899.8216235958,819.9444099504
172.30.6.255,56352,72.251.245.181,80,7,402,4,228,3,174,607.55993,24.472438,74.5328275017,56.880315725
172.30.6.255,56354,217.12.15.83,443,25,10065,14,2514,11,7551,607.586948,25.213946,797.6538063499,2395.8169816022
172.30.6.255,56347,185.84.60.60,80,11,1297,6,788,5,509,607.669614,34.392041,183.2982229813,118.3994866719
172.30.6.255,56356,72.251.245.181,80,11,1701,6,817,5,884,607.743045,24.298759,268.984930465,291.0436701726
172.30.6.255,56357,185.84.60.60,80,8,452,5,282,3,170,607.744415,26.49261,85.1558226992,51.3350704215
172.30.6.255,56358,18.207.56.96,80,7,402,4,228,3,174,607.745194,24.367672,74.8532728116,57.1248660931
172.30.6.255,56364,217.12.15.83,443,5,294,3,174,2,120,607.751081,24.297324,57.2902596187,39.510523875
172.30.6.255,56349,209.15.36.31,80,10,1606,6,861,4,745,607.828062,24.379006,282.5381805969,244.4726417476
172.30.6.255,56350,172.217.166.226,80,24,4351,12,1921,12,2430,607.828107,248.251616,61.9049343872,78.3076473508
172.30.6.255,56353,139.162.146.37,80,14,1434,8,857,6,577,607.828387,69.593169,98.5154160748,66.3283489792
172.30.6.255,56351,35.186.236.204,80,20,2052,11,997,9,1055,607.828397,248.282203,32.1247350943,33.9935762532
172.30.6.255,56355,54.72.26.137,80,12,1638,7,806,5,832,607.828443,69.256779,93.1027993664,96.106115475
172.30.6.255,56359,209.15.36.31,80,7,614,5,282,2,332,607.828521,24.019068,93.9253762885,110.5788118007
172.30.6.255,56363,139.162.146.37,80,7,402,4,228,3,174,607.82858,24.215033,75.3251089932,57.4849516001
172.30.6.255,56360,35.186.236.204,80,7,402,5,282,2,120,607.828748,24.641917,91.5513188361,38.9580080154
172.30.6.255,56362,54.72.26.137,80,6,348,4,228,2,120,607.828864,24.266846,75.1642796925,39.5601472066
172.30.6.255,56361,172.217.166.226,80,6,348,4,228,2,120,607.829,24.099685,75.685636555,39.8345455553
172.30.6.255,56365,52.84.111.68,80,15,2044,8,923,7,1121,608.196796,138.691897,53.2403129507,64.6613118285
172.30.6.255,56366,23.56.25.36,80,11,2141,6,712,5,1429,608.519375,68.511411,83.1394349768,166.8627143003
172.30.6.255,56367,23.56.25.36,80,8,480,5,294,3,186,608.572987,23.468026,100.2214672849,63.4054180782
172.30.6.255,56368,103.243.221.46,443,22,8575,12,4253,10,4322,609.536375,23.264799,1462.4669656506,1486.1937986226
172.30.6.255,56369,103.243.221.46,443,6,348,4,228,2,120,609.58353,22.497891,81.0742660279,42.6706663305
172.30.6.255,56370,52.114.76.35,443,22,12315,13,5840,9,6475,611.619061,130.653898,357.5859634896,396.4673139718
172.30.6.255,56371,52.114.76.35,443,44,32332,26,25329,18,7003,611.629622,128.481575,1577.1288606946,436.0469584841
172.30.6.255,56372,172.217.166.206,443,49,9461,26,5861,23,3600,630.498355,199.705205,234.7860687958,144.2125657166
172.30.6.255,56373,172.217.166.206,443,17,1904,11,1329,6,575,630.498356,89.714292,118.5095458369,51.2738817579
172.30.6.255,56374,103.243.221.17,80,46,27539,26,23219,20,4320,631.862126,17.201155,10798.8097310908,2009.1674076537
172.30.6.255,56375,103.243.221.46,80,6,348,4,228,2,120,631.874302,18.183141,100.3127017494,52.7961588155
172.30.6.255,56376,103.243.221.46,80,31,22207,12,4984,19,17223,631.878453,17.596746,2265.8734745617,7830.0840394014
172.30.6.255,56377,103.243.221.46,80,14,6401,10,5337,4,1064,631.879888,3.575169,11942.3725144183,2380.8664709277
172.30.6.255,56378,103.243.221.46,80,23,13083,11,4930,12,8153,632.126859,17.355266,2272.5091047294,3758.1676938861
172.30.6.255,56379,103.243.221.17,80,50,36705,30,32396,20,4309,648.841905,28.224655,9182.3265864543,1221.343538123
172.30.6.255,56380,103.243.221.75,80,50,35839,21,10604,29,25235,648.896632,28.168653,3011.5746038691,7166.8318680343
172.30.6.255,56381,103.243.221.75,80,15,5023,9,3849,6,1174,648.896986,28.167792,1093.1634258021,333.4304655473
172.30.6.255,56382,103.243.221.75,80,27,16903,11,4209,16,12694,648.897304,28.167475,1195.4213148321,3605.2929841954
172.30.6.255,56383,103.243.221.75,80,6,340,4,228,2,112,649.11547,27.949542,65.2604611553,32.0577703921
172.30.6.255,56384,103.243.220.231,80,6,340,4,228,2,112,650.180678,26.88753,67.8381390927,33.3239981508
172.30.6.255,56389,119.81.99.200,443,29,7567,15,2452,14,5115,650.67256,205.518169,95.4465490591,199.1064838652
172.30.6.255,56385,151.101.2.2,80,6,348,4,228,2,120,650.763285,26.146579,69.760560263,36.7160843489
172.30.6.255,56394,151.101.2.2,80,16,2339,10,1254,6,1085,650.861545,205.241575,48.8789856539,42.2916263432
172.30.6.255,56402,23.198.140.217,80,10,1736,5,780,5,956,650.868515,0.611283,10208.0378482641,12511.3899781288
172.30.6.255,56386,104.90.192.189,443,8,480,5,294,3,186,650.888091,26.146471,89.9547782184,56.9101658117
172.30.6.255,56387,209.191.163.209,80,10,2464,6,1283,4,1181,650.888136,26.248746,391.0282037854,359.9410044198
172.30.6.255,56388,70.42.132.21,80,13,1598,7,855,6,743,650.888338,96.316953,71.0155355517,61.7129156899
172.30.6.255,56390,54.175.180.42,80,13,1401,7,897,6,504,650.888681,96.210383,74.586544365,41.9081587067
172.30.6.255,56391,173.239.42.221,443,7,402,4,228,3,174,650.88881,27.057451,67.4121150584,51.4460878078
172.30.6.255,56399,173.239.42.221,443,27,8279,14,1949,13,6330,650.888875,167.673601,92.9901899107,302.0153422959
172.30.6.255,56398,209.191.163.209,80,6,535,4,228,2,307,650.889358,26.271715,69.4282805671,93.4845707637
172.30.6.255,56395,54.175.180.42,80,6,348,4,228,2,120,650.889478,26.224953,69.5520788922,36.6063573117
172.30.6.255,56397,70.42.132.21,80,7,402,4,228,3,174,650.889672,26.306214,69.3372295991,52.9152541677
172.30.6.255,56396,104.90.192.189,443,28,7393,15,2256,13,5137,650.889859,205.322021,87.9009465819,200.1538841272
172.30.6.255,56392,176.34.247.152,80,15,2923,8,1444,7,1479,651.413808,95.639826,120.78650164,123.714152303
172.30.6.255,56393,144.76.83.254,80,6,348,4,228,2,120,651.413968,25.637672,71.1453052368,37.444897493
172.30.6.255,56400,144.76.83.254,80,11,1878,6,992,5,886,651.41404,25.635444,309.5713887382,276.4921879254
172.30.6.255,56401,176.34.247.152,80,6,348,4,228,2,120,651.41425,25.639575,71.1400247469,37.4421182878
172.30.6.255,56403,151.101.2.49,80,18,2065,10,1309,8,756,651.572542,204.65962,51.1678854871,29.5515060567
172.30.6.255,56404,151.101.2.49,80,6,348,4,228,2,120,651.572634,25.470796,71.6114251003,37.690223737
172.30.6.255,56405,103.243.221.75,443,32,16862,16,7568,16,9294,652.048594,25.652707,2360.1407835828,2898.407563771
172.30.6.255,56407,172.217.166.197,443,17,1779,10,1150,7,629,665.456076,164.750374,55.8420583616,30.5431780082
172.30.6.255,56406,172.217.166.197,443,29,8218,16,5473,13,2745,665.456076,164.749801,265.7605638018,133.2930289852
172.30.6.255,56408,157.240.16.39,443,28,5555,15,3407,13,2148,667.085645,61.074538,446.2743541343,281.3611132024
172.30.6.255,56409,157.240.16.39,443,19,1933,10,1125,9,808,667.085645,61.074769,147.3603608718,105.8374858528
172.30.6.255,56410,103.243.220.231,80,30,18128,17,15791,13,2337,676.84873,21.203362,5957.9230878575,881.7469606943
172.30.6.255,56411,103.243.221.75,80,16,5142,9,3914,7,1228,676.858656,21.1932,1477.4550327464,463.5449106317
172.30.6.255,56412,103.243.221.75,80,44,29446,18,10810,26,18636,676.86356,21.188533,4081.4529255046,7036.2587159762
172.30.6.255,56413,103.243.221.75,80,43,29214,21,10683,22,18531,676.865519,21.186337,4033.9205403935,6997.3398421822
172.30.6.255,56414,103.243.220.231,80,33,21324,20,19004,13,2320,678.09631,19.956082,7618.3290888462,930.0422798423
172.30.6.255,56415,103.243.223.145,443,28,13508,15,5579,13,7929,678.696102,85.046872,524.792963579,745.8475368735
172.30.6.255,56416,107.178.242.85,80,6,348,4,228,2,120,678.86081,19.052425,95.7358446497,50.3872866577
172.30.6.255,56427,107.178.242.85,80,16,1888,9,981,7,907,678.944725,177.169973,44.2964451995,40.9550211988
172.30.6.255,56417,205.180.87.204,80,11,1476,6,844,5,632,678.978696,1.685016,4007.0836122624,3000.5649797984
172.30.6.255,56418,217.182.126.163,80,10,2038,6,1236,4,802,678.978745,1.391281,7107.1192663449,4611.5773880329
172.30.6.255,56419,52.212.134.173,80,7,402,4,228,3,174,678.978791,19.059632,95.6996441484,73.0339389554
172.30.6.255,56420,52.206.38.25,443,22,6462,12,2421,10,4041,678.978863,20.299732,954.1012659675,1592.533339849
172.30.6.255,56421,38.106.10.133,80,12,1927,7,1278,5,649,678.978892,19.157767,533.673887985,271.0127960111
172.30.6.255,56428,52.206.38.25,443,7,402,4,228,3,174,678.979005,19.106578,95.4645044236,72.854490218
172.30.6.255,56425,38.106.10.133,80,6,348,4,228,2,120,678.979124,19.170656,95.1454139076,50.0765336356
172.30.6.255,56429,52.212.134.173,80,11,1658,6,850,5,808,678.979292,68.067184,99.9012975181,94.9649981113
172.30.6.255,56424,205.180.87.204,80,7,398,4,228,3,170,678.979428,19.178039,95.1087856271,70.9144454237
172.30.6.255,56426,217.182.126.163,80,8,1289,5,686,3,603,678.979565,0.567172,9676.0770983048,8505.3563998219
172.30.6.255,56422,35.201.123.46,443,7,402,4,228,3,174,679.144675,18.768416,97.1845466341,74.1671540102
172.30.6.255,56423,85.114.159.93,80,11,1430,6,758,5,672,679.144747,0.923423,6566.871303834,5821.8173036628
172.30.6.255,56430,85.114.159.93,80,7,402,4,228,3,174,679.144805,1.895193,962.43496045,734.4898382381
172.30.6.255,56431,35.201.123.46,443,18,5644,11,2027,7,3617,679.144914,10.61955,1526.9950233296,2724.7858901743
172.30.6.255,56432,103.243.221.75,443,21,7958,11,4400,10,3558,680.783779,18.494679,1903.2501185882,1539.0372549856
172.30.6.255,56433,103.243.221.75,443,6,340,4,228,2,112,681.037406,17.01504,107.1992778154,52.6592943655
172.30.6.255,56434,103.243.220.231,80,91,72366,56,64019,35,8347,697.83478,49.236049,10401.971937269,1356.2420493976
172.30.6.255,56435,103.243.221.75,80,22,13321,10,5137,12,8184,697.838402,11.227644,3660.2514294183,5831.3213350904
172.30.6.255,56436,103.243.221.75,80,87,71631,31,19966,56,51665,697.839504,49.230452,3244.4959067205,8395.6165992545
172.30.6.255,56437,103.243.221.75,80,17,5445,9,4164,8,1281,697.842958,11.223374,2968.091413509,913.0944045881
172.30.6.255,56438,103.243.220.231,80,6,340,4,228,2,112,699.753599,11.128047,163.9101632119,80.5172731567
172.30.6.255,56439,54.64.58.164,80,16,2447,9,1489,7,958,700.445336,61.581806,193.433755418,124.4523423038
172.30.6.255,56447,54.64.58.164,80,6,348,4,228,2,120,700.534891,10.390078,175.5520988389,92.3958414942
172.30.6.255,56440,13.251.188.142,80,14,2296,8,1475,6,821,700.568525,61.381874,192.2391616783,107.0022723646
172.30.6.255,56441,52.68.71.55,443,7,402,4,228,3,174,700.568648,8.465471,215.4634987232,164.4326700783
172.30.6.255,56443,54.251.174.92,80,13,2140,7,1216,6,924,700.568905,61.3786,158.4917218705,120.4328544476
172.30.6.255,56442,213.155.156.183,443,18,5810,10,1651,8,4159,700.568928,1.507113,8763.7755098655,22076.6458785771
172.30.6.255,56444,34.246.69.20,80,13,1520,7,914,6,606,700.568986,61.472633,118.9472394976,78.8643622927
172.30.6.255,56448,54.251.174.92,80,6,348,4,228,2,120,700.569092,10.29271,177.2128040137,93.2698968493
172.30.6.255,56450,213.155.156.183,443,6,348,4,228,2,120,700.569339,11.009421,165.6762876086,87.1980461098
172.30.6.255,56446,34.246.69.20,80,6,348,4,228,2,120,700.569589,10.776358,169.2594102757,89.0839001451
172.30.6.255,56449,13.251.188.142,80,6,348,4,228,2,120,700.569805,10.290216,177.2557543982,93.2925023148
172.30.6.255,56451,52.68.71.55,443,27,9325,16,2423,11,6902,700.570026,46.889536,413.3971383295,1177.5761653944
172.30.6.255,56445,35.168.107.25,80,13,1577,7,794,6,783,700.729649,62.369525,101.8446108095,100.4336653197
172.30.6.255,56452,35.168.107.25,80,6,348,4,228,2,120,700.729786,10.678488,170.8106990428,89.9003679173
172.30.6.255,56453,103.243.221.75,443,22,8201,12,4544,10,3657,707.092922,40.366422,900.5504624611,724.7607925221
172.30.6.255,56454,103.243.221.75,443,6,340,4,228,2,112,707.346035,39.725045,45.9156182202,22.5550405292
172.30.6.255,56455,103.243.221.75,80,16,5482,9,4254,7,1228,708.851955,38.217997,890.4705288454,257.0516712323
172.30.6.255,56456,103.243.221.75,80,23,15666,10,4560,13,11106,708.853313,1.56921,23247.3665092626,56619.5729061121
172.30.6.255,56457,210.176.156.41,80,64,36502,33,26317,31,10185,708.858014,147.358102,1428.7371860965,552.9387179539
172.30.6.255,56458,103.243.220.231,80,6,340,4,228,2,112,710.666404,36.404188,50.1041253825,24.6125528195
172.30.6.255,56459,157.240.16.39,443,27,5488,15,3434,12,2054,728.102079,61.054536,449.9583781949,269.1364323856
172.30.6.255,56460,157.240.16.39,443,19,1933,10,1125,9,808,728.102235,61.054594,147.4090549189,105.8724589996
172.30.6.255,56461,103.243.220.231,80,47,29255,27,24945,20,4310,746.845161,15.558888,12826.1094237583,2216.0966773461
172.30.6.255,56462,103.243.221.75,80,18,5559,10,4278,8,1281,746.871319,15.629962,2189.6406402012,655.663782164
172.30.6.255,56463,103.243.221.75,80,20,9645,10,4279,10,5366,746.871678,15.629895,2190.1618660906,2746.5315665908
172.30.6.255,56464,103.243.221.75,80,26,16610,10,4279,16,12331,746.871979,15.629593,2190.2041850994,6311.6166876514
172.30.6.255,56465,103.243.220.231,80,63,42568,36,37043,27,5525,762.846888,55.206953,5367.8745863768,800.6237909924
172.30.6.255,56466,103.243.221.75,80,50,39070,20,9829,30,29241,762.859797,9.953265,7900.1212165054,23502.6395861057
172.30.6.255,56467,103.243.221.75,80,25,11030,15,8796,10,2234,762.865936,55.187904,1275.0620135891,323.8390789402
172.30.6.255,56468,103.243.221.75,80,36,23657,17,9731,19,13926,762.868804,8.747993,8898.955451839,12735.2639628312
172.30.6.255,56469,176.34.147.227,443,20,6499,10,1196,10,5303,764.015423,54.753153,174.747927302,774.8229585975
172.30.6.255,56470,52.220.16.13,443,26,9625,14,2650,12,6975,771.471941,73.369474,288.9485073861,760.5342788746
172.30.6.255,56471,52.220.16.13,443,8,469,5,283,3,186,771.472017,46.482706,48.7062865918,32.0119056752
172.30.6.255,56472,13.107.3.128,443,19,8809,8,1319,11,7490,776.253751,10.492818,1005.6402388758,5710.5726983923
172.30.6.255,56473,40.121.213.159,443,25,17073,11,1636,14,15437,776.378454,10.367951,1262.3516449875,11911.3217259611
172.30.6.255,56474,52.114.76.35,443,25,11329,14,3327,11,8002,777.577072,9.168559,2902.9643589576,6982.1222724313
172.30.6.255,56475,52.114.76.35,443,33,22147,21,15092,12,7055,777.577088,9.168784,13168.1583948319,6155.669061459
172.30.6.255,56476,52.114.76.35,443,32,17275,19,10058,13,7217,782.704202,1.394826,57687.4821662357,41392.9766150053
172.30.6.255,56477,52.114.76.35,443,20,9779,12,3370,8,6409,782.704855,1.394494,19333.1774822981,36767.458303872
172.30.6.255,56478,157.240.16.39,443,28,5562,15,3415,13,2147,789.09674,61.064575,447.3952369275,281.2760098633
172.30.6.255,56479,157.240.16.39,443,19,1933,10,1125,9,808,789.096771,61.064711,147.3846326727,105.8549183996
172.30.6.255,56480,13.107.3.128,443,18,8754,9,1372,9,7382,803.629867,9.272252,1183.7469473435,6369.1107618732
172.30.6.255,56481,52.232.69.150,443,31,18789,15,1977,16,16812,803.688619,9.21363,1716.5872734199,14597.503915395
172.30.6.255,56482,52.109.120.4,443,17,8961,8,2116,9,6845,805.613973,7.288632,2322.5208790895,7513.0696679432
172.30.6.255,56483,52.109.120.4,443,17,8977,8,2132,9,6845,805.631647,7.271174,2345.7009830875,7531.1084564886
172.30.6.255,56484,52.114.128.10,443,23,11005,14,4488,9,6517,810.904946,1.996241,17985.8043192175,26117.0870651382
172.30.6.255,56485,52.114.128.10,443,42,25831,27,18560,15,7271,810.905078,1.996322,74376.7788963918,29137.5840170078
172.30.6.255,56487,204.79.197.200,443,652,384059,323,298462,329,85597,814.683107,213.71325,11172.428476007,3204.1813036861
172.30.6.255,56486,13.107.6.158,443,36,8001,18,2743,18,5258,814.683541,61.872056,354.6673800528,679.8545695653
172.30.6.255,56488,103.243.221.109,80,25,12258,14,10047,11,2211,817.860414,12.97706,6193.6987268303,1363.0205917211
172.30.6.255,56489,103.243.221.17,80,17,5506,9,4224,8,1282,817.860743,11.1964,3018.1129648816,916.0087170876
172.30.6.255,56490,103.243.221.17,80,19,9620,9,4225,10,5395,817.860988,11.196519,3018.7953952474,3854.7695047005
172.30.6.255,56491,103.243.221.17,80,54,39475,25,16921,29,22554,817.861223,12.68513,10671.3924098531,14223.8983754996
172.30.6.255,56492,103.231.98.53,80,35,17195,20,15665,15,1530,817.868164,38.290373,3272.8853281215,319.6625950862
172.30.6.255,56493,103.243.221.109,80,96,72636,58,63334,38,9302,818.0831,26.991967,18771.2144135327,2756.9683973013
172.30.6.255,56494,103.243.221.17,80,6,340,4,228,2,112,818.086574,10.970988,166.2566762447,81.6699462254
172.30.6.255,56495,184.29.26.80,80,12,2526,7,617,5,1909,820.135819,61.078317,80.8142765296,250.0396335413
172.30.6.255,56496,184.85.113.82,443,21,8944,10,1008,11,7936,820.135902,61.26027,131.6350711481,1036.3650045943
172.30.6.255,56497,131.253.33.254,443,30,8037,15,1323,15,6714,821.683909,102.529381,103.2289466373,523.8693482408
172.30.6.255,56498,204.79.197.254,443,26,7812,13,1206,13,6606,821.684302,102.510394,94.1172853165,515.5379658379
172.30.6.255,56499,72.247.228.186,443,14,1391,8,904,6,487,821.722585,102.432395,70.6026643231,38.0348423953
172.30.6.255,56500,13.107.3.128,443,20,8862,9,1372,11,7490,822.498451,51.084719,214.8587721506,1172.9535010264
172.30.6.255,56501,52.232.69.150,443,25,16960,11,1648,14,15312,822.530817,51.052582,258.2435497582,2399.4085157143
172.30.6.255,56502,52.109.120.3,443,57,41437,30,23258,27,18179,823.919668,2.238928,83104.0569415368,64956.0861269326
172.30.6.255,56503,52.109.124.1,443,16,8359,8,1139,8,7220,824.019052,49.564632,183.8407677475,1165.3470966959
172.30.6.255,56505,52.109.120.4,443,18,9059,9,2214,9,6845,824.608475,48.974403,361.6583136297,1118.1351205037
172.30.6.255,56506,52.109.120.4,443,22,9460,12,2549,10,6911,824.610186,48.973864,416.3853601586,1128.9286873505
172.30.6.255,56504,40.100.140.130,443,18,7094,9,1151,9,5943,824.616705,48.966877,188.0454822553,970.9420512972
172.30.6.255,56507,103.243.221.17,80,62,51593,22,13693,40,37900,828.848538,16.225513,6751.3427772669,18686.6202627922
172.30.6.255,56508,103.243.221.17,80,28,21136,11,4614,17,16522,828.851104,3.488988,10579.572070755,37883.7645758591
172.30.6.255,56509,103.243.221.17,80,6,340,4,228,2,112,830.83509,14.240182,128.0882505575,62.9205441335
172.30.6.255,56510,52.109.120.3,443,60,42979,34,24854,26,18125,831.542119,2.973652,66864.5826747713,48761.5901255423
172.30.6.255,56527,23.198.119.247,443,13,3675,7,1177,6,2498,831.966108,41.619664,226.2392123108,480.1576485577
172.30.6.255,56512,23.198.119.247,443,20,8977,10,1396,10,7581,831.967943,41.616413,268.3556605419,1457.3096436735
172.30.6.255,56517,23.198.119.247,443,14,3363,8,1243,6,2120,831.967943,41.617122,238.9401170028,407.5245760627
172.30.6.255,56514,23.198.119.247,443,19,9253,9,1168,10,8085,831.967943,41.616627,224.5256445218,1554.1865033896
172.30.6.255,56515,23.198.119.247,443,18,9577,9,1168,9,8409,831.967943,41.616777,224.5248352606,1616.4634757757
172.30.6.255,56511,23.198.119.247,443,13,3675,8,1231,5,2444,831.967944,41.616296,236.6380708173,469.8159586331
172.30.6.255,56513,23.198.119.247,443,20,9319,10,1234,10,8085,831.967945,41.616698,237.2124765881,1554.183851876
172.30.6.255,56516,23.198.119.247,443,13,3675,7,1177,6,2498,831.967988,41.616158,226.2582720875,480.1980999784
172.30.6.255,56518,23.198.119.247,443,13,3346,7,1179,6,2167,831.968082,41.616915,226.6386155725,416.5613909633
172.30.6.255,56519,23.198.119.247,443,22,9439,12,1354,10,8085,831.968134,41.617003,260.2782329136,1554.1724616739
172.30.6.255,56520,23.198.119.247,443,12,3621,6,1123,6,2498,831.968176,41.616266,215.8771284286,480.1968537975
172.30.6.255,56521,23.198.119.247,443,12,3827,6,1125,6,2702,831.968216,41.617062,216.2574570978,519.4023547361
172.30.6.255,56522,23.198.119.247,443,21,9981,11,1314,10,8667,831.968258,41.617138,252.5882486201,1666.0444069941
172.30.6.255,56523,23.198.119.247,443,22,9500,12,1368,10,8132,831.968349,41.616574,262.9721514318,1563.2233446223
172.30.6.255,56524,23.198.119.247,443,13,3881,7,1179,6,2702,831.968358,41.617109,226.6375590866,519.4017681526
172.30.6.255,56525,23.198.119.247,443,24,10153,13,1624,11,8529,831.968408,41.616801,312.1816114602,1639.5301503352
172.30.6.255,56526,23.198.119.247,443,18,9248,9,1170,9,8078,831.96855,41.617002,224.9080796353,1552.8268951233
172.30.6.255,56528,23.198.119.247,443,21,9397,11,1312,10,8085,831.969349,41.616349,252.2085731259,1554.1968854596
172.30.6.255,56529,23.198.119.247,443,13,3675,7,1177,6,2498,831.969744,41.61588,226.2597835249,480.20130777
172.30.6.255,56530,23.198.119.247,443,20,9343,11,1312,9,8031,831.971604,41.614248,252.2213065102,1543.8942931277
172.30.6.255,56531,23.198.119.247,443,22,9500,12,1368,10,8132,832.121744,41.464797,263.9347299831,1568.9453393441
172.30.6.255,56532,23.198.119.247,443,21,9775,11,1312,10,8463,832.126241,41.459733,253.1613023171,1633.0061749312
172.30.6.255,56533,23.198.119.247,443,25,9890,14,1692,11,8198,832.133408,41.453063,326.5379931032,1582.1267538179
172.30.6.255,56534,23.198.119.247,443,13,3297,7,1177,6,2120,832.1359,41.450211,227.1641029765,409.1655890485
172.30.6.255,56535,23.198.119.247,443,19,9837,9,1170,10,8667,832.138985,41.447638,225.8271026204,1672.8576909497
172.30.6.255,56536,23.198.119.247,443,23,10431,12,1698,11,8733,832.141489,41.445207,327.7580444947,1685.6955256612
172.30.6.255,56537,23.198.119.247,443,19,9631,9,1168,10,8463,832.144215,41.442177,225.4707806494,1633.6979594484
172.30.6.255,56538,23.198.119.247,443,20,9368,10,1236,10,8132,832.148823,41.437365,238.6252118106,1569.9839987412
172.30.6.255,56539,23.198.119.247,443,21,9385,11,1300,10,8085,832.151469,41.434849,250.9964498724,1561.0048440143
172.30.6.255,56540,23.198.119.247,443,23,10431,12,1698,11,8733,832.153515,41.433259,327.8525592206,1686.1816252494
172.30.6.255,56541,23.198.119.247,443,22,9830,11,1632,11,8198,832.251918,41.335581,315.8537919184,1586.6233983744
172.30.6.255,56542,23.198.119.247,443,22,10365,11,1632,11,8733,832.253522,41.334069,315.8653458482,1690.2279811842
172.30.6.255,56543,23.198.119.247,443,22,10157,11,1628,11,8529,832.254806,41.332861,315.1003749777,1650.7930578529
172.30.6.255,56544,23.198.119.247,443,13,3297,7,1177,6,2120,832.256414,41.331327,227.8175099483,410.3424988024
172.30.6.255,56545,23.198.119.247,443,19,8821,11,1360,8,7461,832.258219,41.3296,263.2495838334,1444.1949595447
172.30.6.255,56546,103.243.221.109,80,6,348,4,228,2,120,832.683036,12.392434,147.1865817482,77.4666219727
172.30.6.255,56549,172.217.166.195,443,7,402,4,228,3,174,833.252031,11.665387,156.360007602,119.3273742226
172.30.6.255,56547,52.114.74.43,443,32,14715,19,7504,13,7211,833.273241,40.315697,1489.0478019021,1430.9066763747
172.30.6.255,56548,52.114.74.43,443,48,29382,29,21876,19,7506,833.273343,40.363931,4335.7521347462,1487.6648163926
172.30.6.255,56550,172.217.166.195,443,28,7561,16,2323,12,5238,833.442871,22.672091,819.6861948022,1848.2635765709
172.30.6.255,56551,52.109.120.3,443,61,41189,32,23094,29,18095,844.442612,2.814855,65634.6419264943,51427.1605464586
172.30.6.255,56552,172.217.166.210,443,32,6918,16,2238,16,4680,845.003514,11.112114,1611.2145717728,3369.2958873532
172.30.6.255,56553,172.217.166.210,443,32,7017,17,2364,15,4653,845.159249,10.956581,1726.0859021624,3397.4101957536
172.30.6.255,56555,157.240.16.39,443,19,1933,10,1125,9,808,850.099465,61.061317,147.3928248223,105.8608021835
172.30.6.255,56554,157.240.16.39,443,30,5737,17,3551,13,2186,850.099469,61.060145,465.2461929136,286.4061328384
172.30.6.255,55224,52.230.83.250,443,15,1482,9,774,6,708,854.504061,387.239009,15.99012459,14.6266255939
172.30.6.255,56556,13.107.4.52,80,10,1519,5,436,5,1083,855.949446,0.531355,6564.3496344243,16305.483151563
172.30.6.255,56557,74.125.68.188,5228,32,1759,17,937,15,822,859.216094,367.418397,20.4018091125,17.8978517507
172.30.6.255,56558,74.125.68.188,5228,29,2909,15,1612,14,1297,859.299202,292.690791,44.0601494702,35.4503808082
172.30.6.255,56559,172.217.166.197,443,55,22651,23,4333,32,18318,864.892568,240.521557,144.1201380548,609.2759494318
172.30.6.255,56560,157.240.16.16,443,62,7750,29,4283,33,3467,867.62879,316.648287,108.2083857918,87.5924523792
172.30.6.255,56561,172.217.166.195,443,83,13444,39,4709,44,8735,875.99771,274.112853,137.4324464822,254.9314971378
172.30.6.255,56562,13.107.6.158,443,30,7664,14,2515,16,5149,876.493865,125.247701,160.6416711793,328.8842802791
172.30.6.255,56563,13.107.6.158,443,23,5461,11,1027,12,4434,876.566047,122.436168,67.1043543277,289.7183126476
172.30.6.255,56564,35.190.43.164,80,68,19885,36,14933,32,4952,881.904889,268.225411,445.3865856878,147.6966699475
172.30.6.255,56565,103.231.98.53,80,44,17682,26,15990,18,1692,887.874181,82.870048,1543.6216472326,163.3400767428
172.30.6.255,56566,103.243.221.87,80,91,63992,54,55538,37,8454,887.893706,63.900513,6953.0584206734,1058.3952588925
172.30.6.255,56567,35.190.43.164,80,69,20383,36,15175,33,5208,887.901767,262.192993,463.017713063,158.9058484107
172.30.6.255,56568,103.243.221.109,80,50,32843,25,17317,25,15526,887.913309,61.583068,2249.5793811377,2016.9180268836
172.30.6.255,56569,103.243.221.109,80,59,51363,22,13663,37,37700,887.913701,61.583017,1774.904922245,4897.4541146628
172.30.6.255,56570,103.243.221.109,80,66,50598,28,17270,38,33328,887.914021,61.582696,2243.4873588516,4329.5278920559
172.30.6.255,56571,210.176.156.41,80,101,68194,59,50127,42,18067,887.923032,262.30163,1528.8353335814,551.0297438868
172.30.6.255,56572,103.243.221.87,80,58,40042,34,35516,24,4526,888.103332,59.617576,4765.8428782814,607.3376750507
172.30.6.255,56573,173.241.248.220,80,67,35002,35,15022,32,19980,888.11878,262.12275,458.4722234144,609.7906419798
172.30.6.255,56574,103.243.221.109,80,10,577,6,337,4,240,888.119214,64.45568,41.8271904043,29.7879100802
172.30.6.255,56575,173.241.248.220,80,8,669,6,337,2,332,888.1266,63.70193,42.322108608,41.694184148
172.30.6.255,56576,180.149.59.210,80,85,56383,55,41848,30,14535,888.14807,261.932177,1278.1323922643,443.9317129029
172.30.6.255,56577,176.34.147.227,443,110,42538,67,36932,43,5606,888.827228,261.414092,1130.2221610915,171.5592287198
172.30.6.255,56578,176.34.147.227,443,56,14821,30,12113,26,2708,889.016559,261.224354,370.9608178417,82.932543112
172.30.6.255,56579,204.79.197.222,443,35,10000,15,1944,20,8056,894.917574,133.479314,116.5124357771,482.8313696608
172.30.6.255,56580,204.79.197.200,443,236,190513,93,6855,143,183658,896.45214,61.210934,895.9183664801,24003.2932678335
172.30.6.255,56581,204.79.197.200,443,27,8860,12,1079,15,7781,897.057555,109.60591,78.7548773602,567.9255799254
172.30.6.255,56582,204.79.197.200,443,140,77169,64,15089,76,62080,897.057567,109.608392,1101.3025353022,4531.0399225636
172.30.6.255,56583,13.107.136.254,443,35,9418,17,1799,18,7619,897.796922,128.24281,112.2246151656,475.2859049174
172.30.6.255,56584,23.58.55.14,443,34,9953,18,1853,16,8100,899.075774,70.759711,209.4977465355,915.7753626213
172.30.6.255,56585,13.107.246.254,443,36,10878,18,1880,18,8998,899.701297,127.923793,117.5699973186,562.7100190814
172.30.6.255,56587,131.253.61.68,443,33,9486,15,1239,18,8247,900.095339,64.650502,153.3166749424,1020.5025167477
172.30.6.255,56586,131.253.61.68,443,33,14088,13,5072,20,9016,900.096017,65.276604,621.6009644129,1104.9594430495
172.30.6.255,56589,13.107.21.200,443,28,9074,15,1302,13,7772,901.258923,105.40555,98.81832598,589.8740626087
172.30.6.255,56588,13.107.21.200,443,28,10028,14,1891,14,8137,901.259083,105.40425,143.5236245218,617.5842055705
172.30.6.255,56591,157.240.16.39,443,19,1933,10,1125,9,808,911.094618,61.056428,147.4046270771,105.8692788252
172.30.6.255,56590,157.240.16.39,443,28,5547,15,3399,13,2148,911.094619,61.054316,445.3739191837,281.4543037383
172.30.6.255,56592,192.168.1.35,7680,3,198,3,198,0,0,914.592204,9.008514,175.8336613564,0
172.30.6.255,56593,172.30.16.59,7680,3,198,3,198,0,0,914.663278,8.96296,176.7273311495,0
172.30.6.255,56595,52.175.23.79,443,32,10536,18,2436,14,8100,914.667742,84.787374,229.8455428045,764.2647359264
172.30.6.255,56596,52.175.23.79,443,30,10184,16,2281,14,7903,914.667769,70.23121,259.8275040399,900.2265516997
172.30.6.255,56597,52.229.173.178,443,29,10102,16,2253,13,7849,914.696617,73.657271,244.7008931406,852.4888194677
172.30.6.255,56598,52.229.174.172,443,29,10110,16,2260,13,7850,914.716995,65.498494,276.0368810923,958.8006710505
172.30.6.255,56599,103.243.221.87,80,116,92868,70,82292,46,10576,951.830728,45.220748,14558.2731183483,1870.9995686051
172.30.6.255,56600,103.243.221.109,80,54,33638,25,17567,29,16071,951.837151,20.494332,6857.3105969006,6273.344259281
172.30.6.255,56601,103.243.221.109,80,40,28528,21,13381,19,15147,951.840429,9.551772,11207.1351786872,12686.2324603225
172.30.6.255,56602,103.243.221.109,80,18,9168,10,4584,8,4584,951.842213,2.32535,15770.5291676525,15770.5291676525
172.30.6.255,56603,103.231.98.53,80,39,17411,20,15665,19,1746,951.842701,60.112245,2084.7665895692,232.3653026101
172.30.6.255,56604,103.243.221.87,80,21,11739,14,9760,7,1979,953.868998,43.182759,1808.1290266794,366.6278016187
172.30.6.255,56605,172.30.6.35,7680,15,1137,9,671,6,466,954.791051,10.7921,497.4008765671,345.4378665876
172.30.6.255,56608,103.243.221.109,80,40,33690,18,10868,22,22822,958.871338,2.479039,35071.654782358,73647.8933974029
172.30.6.255,56609,172.30.16.59,80,3,198,3,198,0,0,959.370644,9.004836,175.905480122,0
172.30.6.255,56610,172.30.6.35,80,3,198,3,198,0,0,959.371959,9.003521,175.931171816,0
172.30.6.255,56611,103.243.221.87,80,7,406,5,294,2,112,960.088245,36.963755,63.6298990728,24.2399615515
172.30.6.255,56612,172.217.166.210,443,7,402,4,228,3,174,965.971941,30.864648,59.0967374713,45.1001417544
172.30.6.255,56613,172.217.166.210,443,7,402,4,228,3,174,966.058788,30.824351,59.1739952611,45.1591016466
172.30.6.255,56614,172.217.166.210,443,50,8478,23,2887,27,5591,966.091994,184.018398,125.5091895757,243.0626528984
172.30.6.255,56615,172.217.166.210,443,47,8237,22,2797,25,5440,966.093123,184.017548,121.5970989897,236.4991843061
172.30.6.255,56617,172.217.166.206,443,42,6798,23,4355,19,2443,968.423267,81.789096,425.973653016,238.9560583968
172.30.6.255,56616,172.217.166.206,443,17,1779,10,1150,7,629,968.423268,81.789292,112.4841623522,61.5239461909
172.30.6.255,56619,157.240.16.39,443,19,1933,10,1125,9,808,972.086254,61.071382,147.3685334319,105.8433555671
172.30.6.255,56618,157.240.16.39,443,36,7955,20,5263,16,2692,972.086254,122.066607,344.9264383993,176.4282675605
172.30.6.255,56620,172.30.16.59,445,6,583,4,463,2,120,980.542948,3.237854,1143.9675785258,296.4926769397
172.30.6.255,56621,172.30.16.59,139,9,750,6,571,3,179,983.782252,3.307808,1380.9749538063,432.9150905978
172.30.6.255,56622,172.30.16.59,445,5,345,3,225,2,120,987.018879,0.176621,10191.3136037012,5435.3672553073
172.30.6.255,56623,172.30.16.59,139,8,512,5,333,3,179,987.197841,0.272713,9768.5112187555,5250.9414659376
172.30.6.255,56624,172.30.6.35,445,3,198,3,198,0,0,990.367606,9.008859,175.8269276942,0
172.30.6.255,56625,192.168.240.1,7680,3,198,3,198,0,0,994.913768,9.003462,175.9323246991,0
172.30.6.255,56629,172.30.6.35,139,3,198,3,198,0,0,1011.380834,9.002294,175.9551509871,0
172.30.6.255,56630,103.243.221.109,80,31,18482,18,16162,13,2320,1011.873944,13.198077,9796.5786985484,1406.2654733716
172.30.6.255,56631,103.243.221.17,80,31,23654,11,4614,20,19040,1011.893073,13.178368,2800.9538055091,11558.3355996736
172.30.6.255,56632,103.243.221.17,80,34,26443,15,8110,19,18333,1011.893467,13.177668,4923.4811500791,11129.7385850062
172.30.6.255,56633,103.243.221.17,80,15,5427,9,4254,6,1173,1011.893799,13.177639,2582.5567083755,712.1154252291
172.30.6.255,56634,103.231.98.53,80,81,39992,41,36168,40,3824,1011.90474,138.24305,2093.0093773249,221.2914139264
172.30.6.255,56635,103.243.221.109,80,33,23273,20,20934,13,2339,1012.096099,12.975341,12906.9440255944,1442.1200953409
172.30.6.255,56636,103.243.221.17,80,6,340,4,228,2,112,1012.113208,12.958463,140.7574339642,69.1440026491
172.30.6.255,56637,103.243.221.109,80,77,61766,51,53907,26,7859,1024.841932,47.233213,9130.3549474816,1331.0972514193
172.30.6.255,56638,103.243.221.17,80,46,32430,19,12774,27,19656,1024.849022,47.225362,2163.9220044518,3329.7362548539
172.30.6.255,56639,103.243.221.17,80,29,15803,14,8305,15,7498,1024.849979,47.224635,1406.892821935,1270.1845128078
172.30.6.255,56640,103.243.221.17,80,33,19131,15,9278,18,9853,1024.850524,47.22386,1571.7478410278,1669.1562273817
172.30.6.255,56641,103.243.221.109,80,8,449,5,283,3,166,1025.991235,46.084725,49.1269070175,28.8164896286
172.30.6.255,56642,172.30.6.35,445,3,198,3,198,0,0,1032.387744,9.000178,175.99651918,0
172.30.6.255,56643,192.168.1.44,7680,3,198,3,198,0,0,1035.106206,9.008379,175.836296408,0
172.30.6.255,56646,172.30.6.35,139,3,198,3,198,0,0,1053.39495,9.00415,175.9188818489,0
172.30.6.255,56647,103.243.221.109,80,46,29183,26,24866,20,4317,1071.838187,19.228963,10345.2276651632,1796.0406913259
172.30.6.255,56648,103.243.221.17,80,13,5328,9,4254,4,1074,1071.848946,19.218108,1770.8298860637,447.0783492319
172.30.6.255,56649,103.243.221.17,80,20,11418,9,4506,11,6912,1071.850084,19.218097,1875.7320248722,2877.2880061954
172.30.6.255,56650,103.243.221.17,80,17,6258,9,4506,8,1752,1071.851133,19.217279,1875.8118670182,729.3436287208
172.30.6.255,56652,172.30.16.59,7680,3,198,3,198,0,0,1075.255215,9.004814,175.9059098833,0
172.30.6.255,56651,172.30.10.168,7680,3,198,3,198,0,0,1075.283536,8.972441,176.5405868927,0
172.30.6.255,56653,172.30.10.168,80,3,198,3,198,0,0,1079.360258,9.002024,175.9604284548,0
172.30.6.255,56654,103.243.221.109,80,52,36018,32,30088,20,5930,1090.84732,31.302916,7689.507265074,1515.51376236
172.30.6.255,56655,103.243.221.17,80,13,6834,8,5172,5,1662,1090.866624,1.725009,23985.9618123732,7707.7858724215
172.30.6.255,56656,103.243.221.17,80,47,33950,25,13687,22,20263,1090.86953,31.280705,3500.4326149299,5182.2361420562
172.30.6.255,56657,103.243.221.17,80,22,10418,10,4291,12,6127,1090.870337,31.280055,1097.4405256001,1567.0049173507
172.30.6.255,56658,103.243.221.109,80,31,17254,17,14873,14,2381,1091.099863,31.050373,3831.9668494804,613.4547884497
172.30.6.255,56659,103.243.221.17,80,17,5869,9,4225,8,1644,1091.120064,31.030329,1089.2569008856,423.8433952795
172.30.6.255,56661,157.240.16.39,443,26,5399,15,3398,11,2001,1094.088796,61.445629,442.4073842584,260.5230064453
172.30.6.255,56660,157.240.16.39,443,19,1933,11,1179,8,754,1094.088797,61.583944,153.1568033382,97.9476079025
172.30.6.255,56663,172.30.10.168,445,3,198,3,198,0,0,1110.366209,9.002432,175.9524537369,0
172.30.6.255,56667,172.30.10.168,139,3,198,3,198,0,0,1131.388743,9.009226,175.8197652051,0
172.30.6.255,56668,103.243.221.109,80,16,6535,9,5326,7,1209,1132.843274,17.40437,2448.120788055,555.7224995791
172.30.6.255,56669,103.243.221.17,80,26,11347,14,8532,12,2815,1132.853221,17.391491,3924.6778783947,1294.8861026349
172.30.6.255,56670,103.243.221.17,80,3,198,3,198,0,0,1132.85599,9.001246,175.9756371507,0
172.30.6.255,56671,103.243.221.17,80,3,198,3,198,0,0,1132.868962,9.00443,175.9134115097,0
172.30.6.255,56672,103.243.221.17,80,16,6188,9,4506,7,1682,1133.106823,3.562376,10119.089057416,3777.2542819738
172.30.6.255,56673,173.241.248.220,80,9,2032,6,1554,3,478,1134.696485,15.551252,799.4211655756,245.8966004795
172.30.6.255,56674,173.241.248.220,80,6,535,4,228,2,307,1134.901875,15.352025,118.811687709,159.9788952923
172.30.6.255,56675,172.217.166.226,80,10,2169,6,1499,4,670,1135.602688,14.477634,828.3121399533,370.2262400058
172.30.6.255,56676,13.107.4.52,80,10,1519,5,436,5,1083,1146.981618,0.228365,15273.7941453415,37939.2638977176
172.30.6.255,56678,161.69.226.28,443,52,13002,31,8466,21,4536,1153.253718,229.910305,294.5844467476,157.8354654438
172.30.6.255,56677,74.125.24.188,5228,7,403,4,229,3,174,1154.114562,55.377559,33.0819926534,25.1365359026
172.30.6.255,56679,74.125.24.188,5228,19,2304,10,1337,9,967,1154.11464,88.084998,121.4281687331,87.8242626514
172.30.6.255,56680,157.240.16.39,443,4,264,1,66,3,198,1155.094456,7.171886,73.6208021154,220.8624063461
172.30.6.255,56681,157.240.16.39,443,5,330,1,66,4,264,1155.094468,15.091458,34.9866792195,139.9467168779
172.30.6.255,56683,157.240.16.39,443,25,5351,14,3349,11,2002,1155.47707,61.269182,437.283461692,261.4038490019
172.30.6.255,56682,157.240.16.39,443,15,1686,9,1071,6,615,1155.47707,60.690802,141.1746050085,81.0666499349
172.30.6.255,56686,35.190.43.164,80,23,6319,13,4851,10,1468,1155.903106,86.579985,448.2329258893,135.6433591436
172.30.6.255,56687,35.190.43.164,80,22,5302,12,3846,10,1456,1155.903579,85.585613,359.4996743203,136.0976406163
172.30.6.255,56688,103.243.220.231,80,23,13284,10,5284,13,8000,1155.904018,13.695413,3086.5808866078,4673.0974816166
172.30.6.255,56689,103.243.220.231,80,17,6965,10,5283,7,1682,1155.904394,3.644263,11597.4066635691,3692.378952891
172.30.6.255,56690,103.243.220.231,80,15,5837,9,4309,6,1528,1155.904776,13.714889,2513.4727667136,891.2941256761
172.30.6.255,56691,173.241.248.220,80,22,8835,12,4421,10,4414,1155.905173,86.223983,410.187499689,409.5380284161
172.30.6.255,56692,210.176.156.41,80,14,5511,8,3958,6,1553,1155.905592,3.60284,8788.6223090673,3448.3907139923
172.30.6.255,56693,103.231.98.53,80,50,23679,27,21245,23,2434,1155.906066,85.858344,1979.5396938939,226.792168272
172.30.6.255,56694,103.243.221.46,80,40,24283,23,20126,17,4157,1155.917847,13.675065,11773.8380036949,2431.8714390023
172.30.6.255,56695,103.243.221.46,80,6,340,4,228,2,112,1156.092128,13.551632,134.5963349654,66.1174978777
172.30.6.255,56696,103.243.220.231,80,6,340,4,228,2,112,1156.101479,13.55643,134.5486975553,66.0940970447
172.30.6.255,56697,173.241.248.220,80,6,535,4,228,2,307,1156.105508,13.482582,135.2856596756,182.1609540368
172.30.6.255,56698,210.176.156.41,80,9,520,7,392,2,128,1156.108415,134.213492,23.3657581907,7.6296353276
172.30.6.255,56699,180.149.59.210,80,30,18920,20,14360,10,4560,1156.233931,85.218582,1348.0627969144,428.0756513879
172.30.6.255,56700,52.213.19.114,443,20,6522,11,1285,9,5237,1157.350894,12.231001,840.4872176856,3425.3942093537
172.30.6.255,56701,52.213.19.114,443,54,21138,30,13879,24,7259,1157.351536,85.363857,1300.6909938477,680.2879115455
172.30.6.255,56702,52.213.19.114,443,28,9267,15,3538,13,5729,1157.538253,84.402188,335.3467566504,543.0190980357
172.30.6.255,56703,172.217.166.195,443,71,13679,33,5561,38,8118,1158.386464,83.100857,535.3494729904,781.5081858903
172.30.6.255,56704,172.30.10.168,445,3,198,3,198,0,0,1162.760123,8.955081,176.8828221654,0
172.30.6.255,56706,172.217.166.206,443,18,1887,11,1246,7,641,1168.402712,74.010969,134.6827387167,69.2870269
172.30.6.255,56705,172.217.166.206,443,42,6960,24,4233,18,2727,1168.402766,74.180128,456.5104012762,294.0949360454
172.30.6.255,56707,157.240.16.16,443,47,12800,23,3531,24,9269,1169.39426,117.025416,241.3834615209,633.6401316446
172.30.6.255,56708,172.217.166.210,443,45,8207,21,2811,24,5396,1169.988738,72.892052,308.5110019951,592.2182023357
172.30.6.255,56709,172.217.166.210,443,38,7814,18,2637,20,5177,1170.044012,71.445267,295.274983016,579.6885047683
172.30.6.255,56710,172.217.166.210,443,7,402,4,228,3,174,1170.104918,20.708792,88.0785320554,67.2178270949
172.30.6.255,56711,103.243.221.46,80,25,13717,15,11561,10,2156,1170.836756,20.178821,4583.4194178144,854.7575698303
172.30.6.255,56712,103.243.220.231,80,16,5452,9,4225,7,1227,1170.840165,20.175412,1675.3065563172,486.5328152902
172.30.6.255,56713,103.243.220.231,80,20,9682,9,4226,11,5456,1170.840987,20.17459,1675.7713539656,2163.5136079593
172.30.6.255,56714,103.243.220.231,80,28,16775,12,4388,16,12387,1170.844172,20.171405,1740.2853197385,4912.6969588881
172.30.6.255,56715,210.176.156.41,80,30,15789,16,11385,14,4404,1170.844851,70.993737,1282.9300702962,496.2691286416
172.30.6.255,56716,103.243.220.231,80,7,394,4,228,3,166,1171.092014,19.92366,91.5494442286,66.6544199208
172.30.6.255,56717,103.243.221.46,80,23,12377,13,10220,10,2157,1172.238124,18.777453,4354.1581491377,918.9744743337
172.30.6.255,56718,172.30.10.168,139,3,198,3,198,0,0,1183.717399,9.006366,175.8755973275,0
172.30.6.255,56719,34.210.162.213,443,23,7670,13,2126,10,5544,1190.949358,41.886592,406.0487900281,1058.859121315
172.30.6.255,56720,34.210.162.213,443,6,340,4,228,2,112,1191.015173,11.187831,163.0342825164,80.087015973
172.30.6.255,56721,103.243.220.231,80,22,11005,10,4562,12,6443,1193.834729,28.62777,1274.8460672976,1800.4895246818
172.30.6.255,56722,103.243.220.231,80,31,23026,11,4616,20,18410,1193.835437,28.627061,1289.9682576566,5144.7824140941
172.30.6.255,56723,103.243.220.231,80,17,5891,10,4309,7,1582,1193.836674,28.622018,1204.3874754044,442.1770680181
172.30.6.255,56724,103.243.221.46,80,19,6369,11,5138,8,1231,1195.1925,30.837373,1332.9280675108,319.3527542051
172.30.6.255,56725,103.243.221.46,80,26,12710,15,10498,11,2212,1195.443934,27.027656,3107.3356860839,654.736762966
172.30.6.255,56728,157.240.16.39,443,5,330,1,66,4,264,1216.097129,15.083253,35.0057113011,140.0228452045
172.30.6.255,56729,157.240.16.39,443,5,330,1,66,4,264,1216.097131,15.083252,35.005713622,140.0228544879
172.30.6.255,56730,157.240.16.39,443,28,5555,15,3410,13,2145,1216.399608,24.976733,1092.216504056,687.0394138417
172.30.6.255,56731,157.240.16.39,443,20,2063,11,1255,9,808,1216.39988,25.06468,400.5636616945,257.8927798001
172.30.6.255,56732,103.243.221.46,80,17,6576,9,5321,8,1255,1221.841492,11.228591,3791.0366492109,894.1460241984
172.30.6.255,56733,157.240.16.39,443,23,5047,11,2174,12,2873,1222.886708,19.588962,887.8469415582,1173.3138284714
172.30.6.255,56734,103.243.221.75,80,14,5429,8,4255,6,1174,1222.955296,0.557749,61031.0372587138,16839.1158029918
172.30.6.255,56735,103.243.221.75,80,14,5505,9,5231,5,274,1222.955589,0.568375,73627.4466681251,3856.6087530236
172.30.6.255,56736,103.243.221.75,80,15,5567,9,5231,6,336,1222.955791,0.554845,75422.8658454317,4844.5962385902
172.30.6.255,56737,103.243.221.75,80,6,340,4,228,2,112,1223.133434,20.046343,90.9891644576,44.6964316634
172.30.6.255,56738,103.243.221.46,80,15,7537,10,6468,5,1069,1223.664015,18.982788,2725.8377431176,450.5133808585
172.30.6.255,56739,103.243.221.46,80,24,12441,13,10222,11,2219,1224.069177,18.666687,4380.8523708573,950.9989640904
172.30.6.255,56742,172.30.16.59,7680,3,198,3,198,0,0,1235.933492,8.999616,176.0075096537,0
172.30.6.255,56743,172.217.194.189,443,31,5277,18,3584,13,1693,1242.462231,0.83006,34542.0812953279,16316.8927547406
172.30.6.255,56744,184.29.25.174,443,28,18259,12,1527,16,16732,1242.655419,4.125115,2961.3719859931,32449.0347541822
172.30.6.255,56745,52.229.173.178,443,24,9101,13,1344,11,7757,1243.288024,0.746737,14398.6436991884,83102.8862906285
172.30.6.255,56746,209.67.99.89,443,24,7043,12,1455,12,5588,1243.462786,2.24822,5177.4292551442,19884.1750362514
172.30.6.255,56747,13.107.4.52,80,10,1476,5,393,5,1083,1243.49165,0.127835,24594.2034654037,67774.86603825
172.30.6.255,56748,23.198.126.238,443,17,6725,8,1113,9,5612,1244.006823,0.801138,11114.1900646325,56040.2826978597
172.30.6.255,56749,74.125.24.188,5228,17,2183,9,1282,8,901,1244.342484,2.100227,4883.2816643156,3432.0099684464
172.30.6.255,56750,103.243.220.231,80,6,340,4,228,2,112,1244.347616,0.424934,4292.431295214,2108.5627415086
172.30.6.255,56751,35.190.43.164,80,9,1517,5,1063,4,454,1244.368561,0.518199,16410.6839264422,7008.8904069659
172.30.6.255,56752,35.190.43.164,80,9,1573,5,1119,4,454,1244.369646,0.513735,17425.326286899,7069.7927920037
172.30.6.255,56753,35.190.43.164,80,9,1649,5,1195,4,454,1244.370619,0.540217,17696.5922953189,6723.2241858366
172.30.6.255,56754,54.194.27.245,443,6,396,1,66,5,330,1244.397425,15.225623,34.6783839321,173.3919196607
172.30.6.255,56755,184.29.25.174,443,16,7773,9,1029,7,6744,1244.637254,0.575213,14311.2203653236,93794.8203534914
172.30.6.255,56757,23.198.126.238,443,17,6647,8,1327,9,5320,1244.683714,0.774903,13699.7791981707,54923.0032662156
172.30.6.255,56756,23.198.126.238,443,17,6649,8,1327,9,5322,1244.684017,0.769575,13794.6269044597,55324.042490983
172.30.6.255,56758,23.198.126.238,443,17,6691,8,1318,9,5373,1244.684138,0.797078,13228.3164257479,53926.9682515504
172.30.6.255,56759,23.198.126.238,443,17,6644,8,1322,9,5322,1244.684221,0.773336,13675.8149109836,55054.9825690276
172.30.6.255,56760,23.198.126.238,443,17,6653,8,1326,9,5327,1244.684335,0.762087,13919.6705887899,55920.1246051912
172.30.6.255,56761,23.198.126.238,443,17,6692,8,1317,9,5375,1244.684415,0.785347,13415.7257874544,54752.8672039238
172.30.6.255,56762,23.198.126.238,443,17,6647,8,1326,9,5321,1244.684505,0.805989,13161.4699456204,52814.616576656
172.30.6.255,56763,23.198.126.238,443,17,6651,8,1327,9,5324,1244.684585,0.806625,13161.0103827687,52802.72741361
172.30.6.255,56764,23.198.126.238,443,17,6654,8,1326,9,5328,1244.684666,0.80246,13219.350497223,53116.6662512851
172.30.6.255,56765,23.198.126.238,443,17,6656,8,1327,9,5329,1244.684752,0.796793,13323.4102207189,53504.4861086743
172.30.6.255,56767,23.198.126.238,443,17,6648,8,1326,9,5322,1244.684833,0.776486,13661.5470208095,54831.638947774
172.30.6.255,56766,23.198.126.238,443,17,6697,8,1316,9,5381,1244.684909,0.78064,13486.3701578201,55144.4968231231
172.30.6.255,56768,52.230.3.194,443,69,15766,36,7408,33,8358,1244.911012,4469.255607,13.2603738097,14.9608807103
172.30.6.255,56769,23.198.126.238,443,17,6374,8,1309,9,5065,1245.554182,0.78188,13393.3595948227,51823.8092801964
172.30.6.255,56770,23.198.126.238,443,19,6516,10,1451,9,5065,1245.554338,1.282955,9047.8621619611,31583.3369058119
172.30.6.255,56771,23.198.126.238,443,19,6483,8,1310,11,5173,1245.55445,0.876625,11954.9408241853,47208.327391993
172.30.6.255,56772,23.198.126.238,443,19,6491,9,1372,10,5119,1245.554561,1.767821,6208.7733995688,23165.2412772542
172.30.6.255,56773,23.198.126.238,443,18,6437,8,1318,10,5119,1245.554664,0.881236,11965.0127775087,46471.0928741025
172.30.6.255,56774,23.198.126.238,443,18,6438,9,1373,9,5065,1245.554772,1.767508,6214.3990295937,22924.9315986105
172.30.6.255,56776,23.198.126.238,443,21,6611,10,1439,11,5172,1245.554959,1.536683,7491.4605029142,26925.5272557834
172.30.6.255,56775,23.198.126.238,443,18,6428,9,1363,9,5065,1245.554968,1.763362,6183.642383129,22978.8324802262
172.30.6.255,56777,23.198.126.238,443,18,6433,9,1368,9,5065,1245.555039,1.761233,6213.8286075723,23006.6095740888
172.30.6.255,56778,23.198.126.238,443,17,6384,8,1319,9,5065,1245.555124,0.763026,13829.1486790737,53104.3503104687
172.30.6.255,56779,23.198.126.238,443,18,6437,8,1318,10,5119,1245.555216,0.879158,11993.293583179,46580.9331201011
172.30.6.255,56780,23.198.126.238,443,16,6330,8,1319,8,5011,1245.555296,0.776761,13584.6161174402,51609.1822323674
172.30.6.255,56781,184.29.25.174,443,17,7111,9,1032,8,6079,1245.639604,0.246699,33465.8835260736,197130.916623063
172.30.6.255,56782,184.29.25.174,443,40,30788,16,1435,24,29353,1246.302422,0.464105,24735.7817735201,505971.708988248
172.30.6.255,56783,74.125.24.188,5228,98,7147,51,3654,47,3493,1247.552157,1803.354284,16.2097931945,15.4955685901
172.30.6.255,56784,157.240.16.16,443,19,1941,11,1187,8,754,1251.125183,65.992784,143.8945203463,91.4039328906
172.30.6.255,56785,157.240.16.16,443,831,221798,479,97193,352,124605,1251.125239,4605.583866,168.8263687347,216.4416128342
172.30.6.255,56786,35.190.43.164,80,109,32215,57,24315,52,7900,1253.8374,668.048068,291.1766522765,94.6039709226
172.30.6.255,56787,103.243.220.231,80,16,6615,9,5414,7,1201,1253.84033,17.931353,2415.4340166077,535.8212511906
172.30.6.255,56788,35.190.43.164,80,6,348,4,228,2,120,1253.869836,11.047358,165.1073496487,86.8986050782
172.30.6.255,56789,103.231.98.53,80,22,13193,15,12519,7,674,1253.880795,4.591501,21812.4748312159,1174.3436405655
172.30.6.255,56790,173.241.248.220,80,99,56049,47,22187,52,33862,1253.884707,486.796648,364.6204235983,556.4869871495
172.30.6.255,56791,103.243.221.51,80,13,5319,9,4254,4,1065,1253.885348,11.159256,3049.6656766365,763.4917596657
172.30.6.255,56792,103.243.221.51,80,18,9776,10,4574,8,5202,1253.885746,1.541295,23741.0748753485,27000.6715132406
172.30.6.255,56793,103.243.221.51,80,15,6136,9,4508,6,1628,1253.886052,3.647492,9887.3417679879,3570.6726704269
172.30.6.255,56794,210.176.156.41,80,176,103876,90,74949,86,28927,1253.9228,729.041361,822.438934298,317.4250630754
172.30.6.255,56795,35.190.43.164,80,104,30141,54,22587,50,7554,1254.089788,667.760158,270.6001516191,90.4995592744
172.30.6.255,56796,103.231.98.53,80,7,402,4,228,3,174,1254.101837,10.942986,166.682110349,127.2047684243
172.30.6.255,56797,103.243.221.51,80,6,340,4,228,2,112,1254.102953,10.942089,166.695774454,81.8856435915
172.30.6.255,56798,180.149.59.210,80,139,90846,88,67992,51,22854,1254.161207,728.688674,746.45869959,250.9055053599
172.30.6.255,56799,54.194.27.245,443,624,256773,367,217900,257,38873,1255.262123,1793.921469,971.7259256459,173.3542997138
172.30.6.255,56800,172.30.20.1,80,6,360,3,198,3,162,1261.29238,1.110666,1426.1713242327,1166.8674470995
172.30.6.255,56801,172.217.166.197,443,4571,2972240,1578,270884,2993,2701356,1264.882142,1784.173522,1214.6083176769,12112.5259026235
172.30.6.255,56803,172.217.166.206,443,51,10844,29,7396,22,3448,1265.462077,87.032877,679.8350467031,316.9377015998
172.30.6.255,56802,172.217.166.206,443,18,2279,11,1638,7,641,1265.462078,86.992734,150.6332701304,58.9474518642
172.30.6.255,56805,172.217.166.197,443,17,1779,10,1150,7,629,1266.453487,86.042661,106.9237038125,58.4826171287
172.30.6.255,56804,172.217.166.197,443,29,8024,16,5470,13,2554,1266.453487,86.041044,508.59447963,237.4680623355
172.30.6.255,56806,161.69.38.37,80,7,398,4,228,3,170,1267.073937,0.621284,2935.8554219968,2189.0150076292
172.30.6.255,56807,161.69.38.37,80,7,398,4,228,3,170,1267.448596,0.647979,2814.9060386213,2098.8334498492
172.30.6.255,56808,157.240.16.16,443,319,61577,142,18961,177,42616,1271.588343,1823.334361,83.1926404967,186.9805161863
172.30.6.255,56809,172.30.20.1,445,6,360,3,198,3,162,1272.405194,1.124231,1408.9631045577,1152.7879946381
172.30.6.255,56810,172.30.20.1,139,6,360,3,198,3,162,1273.531876,1.115707,1419.7275808076,1161.595293388
172.30.6.255,56811,172.30.20.1,445,6,360,3,198,3,162,1274.649974,1.113291,1422.8085918236,1164.1161205829
172.30.6.255,56812,172.30.20.1,139,4,252,3,198,1,54,1275.764382,6.542994,242.091006044,66.0248198302
172.30.6.255,56815,157.240.16.39,443,25,5255,14,3256,11,1999,1277.146152,61.013761,426.9200844708,262.10480616
172.30.6.255,56816,157.240.16.39,443,17,1825,9,1071,8,754,1277.146193,61.013898,140.4270220532,98.8627214082
172.30.6.255,56817,103.243.220.231,80,25,13648,15,11491,10,2157,1286.840603,25.224743,3644.3582398441,684.0902204633
172.30.6.255,56818,103.231.98.53,80,38,16344,21,13750,17,2594,1286.851563,26.48721,4152.9477812121,783.472475961
172.30.6.255,56819,103.243.221.51,80,18,7020,10,5284,8,1736,1286.853935,3.585761,11788.8504002364,3873.0969520837
172.30.6.255,56820,103.243.221.51,80,23,9917,13,7806,10,2111,1286.855914,25.209433,2477.1679712114,669.9079665933
172.30.6.255,56821,103.243.221.51,80,16,6913,9,5231,7,1682,1286.863091,3.592054,11650.1589341364,3746.0461340504
172.30.6.255,56822,103.243.220.231,80,28,16749,17,14529,11,2220,1289.123611,22.941734,5066.3999504135,774.1350326876
172.30.6.255,56823,103.243.221.51,80,30,19796,16,8613,14,11183,1311.845817,16.715973,4122.0454232607,5352.0067303291
172.30.6.255,56824,103.243.221.51,80,3,198,3,198,0,0,1311.848671,9.007433,175.8547635048,0
172.30.6.255,56825,103.243.221.51,80,38,27457,19,10180,19,17277,1311.849508,4.530879,17974.4371897818,30505.3390302417
172.30.6.255,56826,103.243.221.51,80,32,16658,19,13183,13,3475,1312.100519,16.374829,6440.6168760603,1697.7276526063
172.30.6.255,56827,103.243.220.231,80,24,11197,13,9796,11,1401,1313.613688,13.771358,5690.6515682766,813.863091788
172.30.6.255,56828,103.243.220.231,80,51,34665,31,29561,20,5104,1313.679142,14.796056,15983.1782199255,2759.6543295051
172.30.6.255,56829,103.243.220.231,80,7,402,5,282,2,120,1313.865559,13.620567,165.6318712723,70.4816473499
172.30.6.255,56831,103.231.98.53,80,16,10495,12,10267,4,228,1314.884364,2.603109,31553.0390775043,700.7005853386
172.30.6.255,56832,103.231.98.53,80,9,510,6,336,3,174,1315.092454,12.601982,213.2997809392,110.4588151292
172.30.6.255,56835,122.15.34.105,443,2577,1726686,1208,100896,1369,1625790,1319.893884,614.47651,1313.5864217169,21166.5048026002
172.30.6.255,56836,122.15.34.105,443,17,4802,8,1099,9,3703,1319.893977,1.247389,7048.3225361128,23748.8065070298
172.30.6.255,56837,122.15.34.105,443,8,480,5,294,3,186,1319.894002,18.796385,125.1304439657,79.1641584273
172.30.6.255,56838,104.122.112.145,443,137,79828,70,14373,67,65455,1326.922449,80.74302,1424.0735607858,6485.2664663769
172.30.6.255,56839,104.122.112.145,443,34,7519,17,2342,17,5177,1328.287682,336.165035,55.7345293213,123.2013912452
172.30.6.255,56840,103.243.221.46,80,6,348,4,228,2,120,1332.861577,20.197757,90.3070573629,47.530030191
172.30.6.255,56844,157.240.16.39,443,22,2889,13,2081,9,808,1338.09348,61.568882,270.3963343041,104.9881009696
172.30.6.255,56845,157.240.16.39,443,41,9435,23,6188,18,3247,1338.093488,122.052458,405.5960921328,212.8265208719
172.30.6.255,56841,115.114.126.194,443,294,207277,123,39320,171,167957,1338.777655,792.064432,397.1394084768,1696.3973456139
172.30.6.255,56842,115.114.126.194,443,17,6860,10,1174,7,5686,1338.777785,15.478787,606.7658919268,2938.7315685654
172.30.6.255,56843,115.114.126.194,443,7,402,4,228,3,174,1338.777892,14.104801,129.3176699196,98.6898007281
172.30.6.255,56846,104.122.99.56,80,20,8904,11,1301,9,7603,1339.214517,86.189104,120.7577236213,705.7040528
172.30.6.255,56848,172.217.194.189,443,5,330,1,66,4,264,1352.422251,14.46971,36.4900194959,145.9600779836
172.30.6.255,56847,172.217.194.189,443,5,330,1,66,4,264,1352.42226,14.469427,36.4907331852,145.9629327409
172.30.6.255,56849,172.217.194.189,443,19,2345,11,1650,8,695,1352.726095,137.477095,96.0159945189,40.4431007216
172.30.6.255,56850,172.217.194.189,443,453,87858,231,48063,222,39795,1352.726338,3890.504999,98.8313856681,81.8299938136
172.30.6.255,56851,103.243.220.231,80,52,38236,31,33871,21,4365,1352.831115,23.228089,11665.5313314841,1503.3522559691
172.30.6.255,56852,103.231.98.53,80,22,14959,15,14285,7,674,1352.83983,4.129168,27676.2776423714,1305.8320707706
172.30.6.255,56853,103.243.220.231,80,23,13621,10,5285,13,8336,1352.88302,23.176181,1824.286753715,2877.4369685843
172.30.6.255,56854,103.243.220.231,80,16,5537,9,4309,7,1228,1352.883274,23.175929,1487.4053160933,423.888078014
172.30.6.255,56855,103.243.220.231,80,46,36951,16,8890,30,28061,1352.883498,23.175702,3068.7312082284,9686.3516798758
172.30.6.255,56856,103.243.220.231,80,6,340,4,228,2,112,1353.091483,22.968003,79.4148276626,39.010792536
172.30.6.255,56857,103.243.220.231,80,6,340,4,228,2,112,1354.628309,21.432036,85.1062400231,41.8065740464
172.30.6.255,56858,52.213.19.114,443,20,6522,11,1285,9,5237,1354.659484,22.887792,449.1477377984,1830.4954885993
172.30.6.255,56859,52.213.19.114,443,20,6624,10,1321,10,5303,1354.659616,22.889227,461.7019176751,1853.4483493042
172.30.6.255,56860,52.213.19.114,443,19,6432,10,1195,9,5237,1354.659874,22.886454,417.7143387962,1830.6025039965
172.30.6.255,56863,103.243.220.231,80,27,15384,15,8687,12,6697,1375.854359,8.655154,8029.4354092371,6190.0689462024
172.30.6.255,56864,103.243.220.231,80,73,48868,39,25367,34,23501,1375.860939,28.923001,7016.4226734286,6500.2936590155
172.30.6.255,56865,103.243.221.51,80,75,56086,47,48118,28,7968,1375.861664,28.689681,13417.5071517874,2221.8441536523
172.30.6.255,56866,103.243.220.231,80,15,6136,9,4508,6,1628,1375.864321,3.55613,10141.361536277,3662.4082921604
172.30.6.255,56867,103.231.98.53,80,23,17385,16,16711,7,674,1375.864919,5.580546,23956.0788496326,966.2137002365
172.30.6.255,56870,184.29.25.41,80,36,16214,16,1246,20,14968,1379.010969,301.700703,33.0393661695,396.8966555573
172.30.6.255,56868,184.29.25.41,80,19,9322,9,2091,10,7231,1379.012728,57.04779,293.2278358198,1014.0270113882
172.30.6.255,56869,184.29.25.41,80,33,12808,17,2243,16,10565,1379.012816,316.809863,56.6396507674,266.784623432
172.30.6.255,56871,115.114.126.194,443,12,1404,6,904,6,500,1379.292261,11.590079,623.9819417969,345.1227554187
172.30.6.255,56876,161.69.226.28,443,96,23953,52,16115,44,7838,1382.713906,339.931169,379.2532481774,184.4608724303
172.30.6.255,56877,103.231.98.53,80,8,468,5,294,3,174,1382.85896,22.333753,105.3114539236,62.327187016
172.30.6.255,56878,103.243.220.231,80,6,348,4,228,2,120,1382.862191,22.779841,80.0707959287,42.142524173
172.30.6.255,56879,103.231.98.53,80,9,522,6,348,3,174,1383.111331,21.904545,127.0969107096,63.5484553548
172.30.6.255,56872,103.15.158.129,80,49,19691,25,6588,24,13103,1383.679845,10.277575,5128.0579319538,10199.2931211885
172.30.6.255,56875,103.15.158.129,80,6,372,4,252,2,120,1383.679911,10.263729,196.4198392222,93.5332567725
172.30.6.255,56873,103.15.158.152,80,7,1553,4,1248,3,305,1383.819509,10.333591,966.1694564842,236.1231444132
172.30.6.255,56874,103.15.158.152,80,5,294,3,174,2,120,1383.819569,20.540172,67.7696369826,46.7376806776
172.30.6.255,56882,172.217.166.226,80,29,6584,15,3990,14,2594,1384.329776,279.545566,114.1853203281,74.2347671506
172.30.6.255,56880,52.76.116.64,80,14,2563,8,1836,6,727,1384.439475,68.478504,214.4906670274,84.9317619439
172.30.6.255,56885,104.122.118.96,80,24,4708,14,3575,10,1133,1384.516883,311.333743,91.8628341548,29.1134520552
172.30.6.255,56886,52.76.116.64,80,6,348,4,228,2,120,1384.547007,19.89522,91.6803131606,48.2527964003
172.30.6.255,56889,104.122.118.96,80,8,480,5,294,3,186,1384.549709,19.842916,118.5309659125,74.9889784344
172.30.6.255,56890,52.221.7.77,80,14,4246,8,3134,6,1112,1384.566364,68.354772,366.792240928,130.1445347517
172.30.6.255,56891,122.15.34.17,80,8,480,5,294,3,186,1384.573916,19.794709,118.8196300335,75.1716026742
172.30.6.255,56893,103.15.158.129,80,16,9626,9,5493,7,4133,1384.648065,10.253648,4285.6942231682,3224.6084515482
172.30.6.255,56895,122.15.34.17,80,27,6156,15,4188,12,1968,1384.802686,311.003551,107.7286734903,50.623216196
172.30.6.255,56896,103.15.158.129,80,9,4265,5,2751,4,1514,1384.856795,10.260273,2144.9721659453,1180.4754123014
172.30.6.255,56897,184.29.25.201,80,17,6264,9,3435,8,2829,1384.860876,3.259,8432.03436637,6944.461491255
172.30.6.255,56898,103.15.158.129,80,4,240,2,120,2,120,1384.904523,10.271605,93.4615378999,93.4615378999
172.30.6.255,56900,217.12.15.54,443,25,9187,14,2856,11,6331,1384.954437,19.358461,1180.25911254,2616.3236839954
172.30.6.255,56881,184.29.26.182,80,9,534,5,294,4,240,1385.017894,23.444361,100.322631954,81.8960260849
172.30.6.255,56883,103.231.98.244,80,9,522,6,348,3,174,1385.017898,22.609858,123.1321311262,61.5660655631
172.30.6.255,56884,63.251.88.51,80,10,2062,5,1547,5,515,1385.01792,0.771878,16033.621893615,5337.6310764135
172.30.6.255,56888,184.29.26.182,80,130,93127,63,5394,67,87733,1385.017944,112.841781,382.4115466593,6219.8947391658
172.30.6.255,56887,63.251.88.51,80,7,398,4,228,3,170,1385.017993,19.570294,93.2024833148,69.4930796645
172.30.6.255,56892,103.231.98.244,80,21,12222,13,10933,8,1289,1385.018043,4.303921,20321.9343477729,2395.9547584633
172.30.6.255,56901,217.12.15.54,443,5,294,3,174,2,120,1385.145572,19.386599,71.8021763384,49.5187423023
172.30.6.255,56894,198.8.71.209,80,9,2852,5,1636,4,1216,1385.173881,10.337045,1266.1258609206,941.0813244984
172.30.6.255,56899,198.8.71.209,80,19,9080,11,6002,8,3078,1385.173999,10.336926,4645.0946828874,2382.1395258126
172.30.6.255,56902,52.202.222.55,80,11,2289,6,1705,5,584,1385.360621,32.691039,417.2397212582,142.9137813576
172.30.6.255,56905,52.202.222.55,80,7,402,5,282,2,120,1385.390309,19.77089,114.1071545085,48.5562359611
172.30.6.255,56906,173.241.248.143,80,14,2595,8,1929,6,666,1385.419825,67.60245,228.2757503611,78.8137116332
172.30.6.255,56903,54.169.115.222,443,111,82383,45,6007,66,76376,1385.47725,62.766306,765.633714369,9734.649670159
172.30.6.255,56907,54.169.115.222,443,6,348,4,228,2,120,1385.544915,18.893043,96.5434737009,50.8123545794
172.30.6.255,56904,210.176.156.55,80,6,348,4,228,2,120,1385.59894,18.878384,96.6184393749,50.8518101973
172.30.6.255,56908,210.176.156.55,80,29,9117,15,5758,14,3359,1385.59905,310.32039,148.4401331153,86.5943742852
172.30.6.255,56909,63.251.88.56,80,11,2496,6,1846,5,650,1385.602789,0.801787,18418.8568784506,6485.5129853699
172.30.6.255,56910,63.251.88.56,80,11,2570,6,1896,5,674,1385.797037,0.788218,19243.407280729,6840.7471029596
172.30.6.255,56913,63.251.88.56,80,9,506,7,390,2,116,1385.846719,27.73624,112.4882103703,33.4580318024
172.30.6.255,56915,35.201.85.114,80,23,3349,12,2120,11,1229,1385.94521,277.903681,61.0283388078,35.3791643372
172.30.6.255,56911,54.148.146.218,80,13,2583,7,1763,6,820,1385.946431,67.216637,209.8290040902,97.5948856233
172.30.6.255,56917,54.148.146.218,80,6,348,4,228,2,120,1386.023476,18.635935,97.8754218664,51.5133799297
172.30.6.255,56912,103.71.26.125,80,10,2535,6,1738,4,797,1386.06497,42.878989,324.2613765917,148.6975357558
172.30.6.255,56918,103.71.26.125,80,8,464,5,294,3,170,1386.065115,18.372585,128.0168250684,74.0233342232
172.30.6.255,56920,35.201.85.114,80,7,414,5,294,2,120,1386.160161,19.243598,122.2224658819,49.8867207681
172.30.6.255,56914,54.245.243.190,80,7,402,4,228,3,174,1386.18548,18.459016,98.8135012181,75.4103035611
172.30.6.255,56919,54.245.243.190,80,11,2436,6,1701,5,735,1386.185531,18.454551,737.3790887679,318.620593912
172.30.6.255,56916,35.189.135.205,80,6,348,4,228,2,120,1386.697472,17.803457,102.4520125501,53.9221118685
172.30.6.255,56921,35.189.135.205,80,12,2433,7,1805,5,628,1386.697515,17.803342,811.0836718185,282.194208256
172.30.6.255,56923,52.192.95.113,80,6,348,4,228,2,120,1386.864684,17.652056,103.3307394901,54.3845997316
172.30.6.255,56922,54.149.58.94,80,12,2966,7,1986,5,980,1386.864684,32.778705,484.7049326689,239.1796747309
172.30.6.255,56924,115.114.126.213,443,9,510,5,282,4,228,1386.864691,17.544083,128.5903629161,103.9666764002
172.30.6.255,56925,115.114.126.213,443,17,6922,10,1207,7,5715,1386.864719,13.974342,690.9806558334,3271.7103960959
172.30.6.255,56928,115.114.126.213,443,105,54861,39,10756,66,44105,1386.864773,170.272765,505.353865605,2072.2045595489
172.30.6.255,56927,52.192.95.113,80,15,2817,8,1839,7,978,1386.864875,66.154076,222.3899249987,118.2693565246
172.30.6.255,56926,54.149.58.94,80,6,348,4,228,2,120,1386.864978,17.798165,102.4824750192,53.9381447469
172.30.6.255,56929,54.169.236.196,80,10,2160,6,1696,4,464,1387.022978,17.414427,779.124113587,213.1565971134
172.30.6.255,56930,54.169.236.196,80,6,535,4,228,2,307,1387.023025,17.414571,104.7398755904,141.0313237116
172.30.6.255,56931,54.169.196.206,80,14,3239,8,2184,6,1055,1387.444561,65.473133,266.8575520893,128.9078376622
172.30.6.255,56933,54.169.196.206,80,6,348,4,228,2,120,1387.519025,16.924453,107.7730547628,56.7226604015
172.30.6.255,56932,103.15.158.189,80,11,2978,6,1762,5,1216,1387.581409,10.267735,1372.8441569635,947.4338790395
172.30.6.255,56935,151.101.2.49,80,11,2569,6,1902,5,667,1387.640747,0.621371,24487.7858799261,8587.4622407522
172.30.6.255,56936,103.15.158.189,80,5,294,3,174,2,120,1387.651574,16.706751,83.3196113356,57.4618009211
172.30.6.255,56934,103.15.158.129,443,20,10441,10,4330,10,6111,1387.703616,10.283586,3368.4747713492,4753.9836784561
172.30.6.255,56938,151.101.130.2,80,11,2791,6,1947,5,844,1387.754814,46.193429,337.1908156028,146.1679755361
172.30.6.255,56939,103.15.158.129,443,4,240,2,120,2,120,1387.788757,10.284261,93.3465224191,93.3465224191
172.30.6.255,56940,151.101.2.49,80,6,348,4,228,2,120,1387.825516,16.698376,109.2321792251,57.4906206448
172.30.6.255,56937,34.233.6.212,80,12,3822,7,2441,5,1381,1387.827997,16.748899,1165.9273842418,659.625447619
172.30.6.255,56942,34.233.6.212,80,7,402,4,228,3,174,1387.889158,16.694051,109.2604784782,83.3829967334
172.30.6.255,56941,103.15.158.188,80,4,240,2,120,2,120,1387.978458,10.287984,93.3127423215,93.3127423215
172.30.6.255,56943,103.15.158.188,80,9,2797,5,1635,4,1162,1387.978483,10.26339,1274.4327166755,905.7436188238
172.30.6.255,56944,199.166.0.200,443,29,14475,15,3003,14,11472,1388.126396,0.741402,32403.4734192839,123787.095260081
172.30.6.255,56945,103.15.158.129,80,12,5805,7,3187,5,2618,1388.349489,10.254345,2486.3606597984,2042.4512730945
172.30.6.255,56946,172.217.166.198,443,16,5029,8,1054,8,3975,1388.714095,12.124712,695.4391988857,2622.7427092701
172.30.6.255,56947,54.169.163.209,443,40,10711,19,4507,21,6204,1388.869405,61.164529,589.4919913468,811.4507020891
172.30.6.255,56948,13.228.173.43,443,24,9113,12,2693,12,6420,1389.149786,65.104209,330.9156248254,788.8890870328
172.30.6.255,56950,184.29.26.182,443,78,38944,47,30161,31,8783,1389.207459,351.06467,687.3035671747,200.1454603791
172.30.6.255,56949,52.77.109.174,443,22,8086,12,3828,10,4258,1389.327567,64.926591,471.6711524251,524.6540666212
172.30.6.255,56951,52.77.109.174,443,6,340,4,228,2,112,1389.369565,15.071287,121.0248335129,59.4507954098
172.30.6.255,56952,52.221.102.82,443,20,7251,11,2630,9,4621,1389.478028,64.776482,324.8092417245,570.7009528551
172.30.6.255,56953,23.198.141.211,443,33,9464,16,2805,17,6659,1389.708187,306.205741,73.2840603403,173.9745304122
172.30.6.255,56954,23.198.141.211,443,6,348,4,228,2,120,1389.830731,14.650337,124.5022554771,65.5275028827
172.30.6.255,56955,184.29.26.182,443,32,7685,17,3241,15,4444,1390.043145,305.776168,84.7940510524,116.2680539577
172.30.6.255,56956,184.29.26.182,443,36,9303,20,4794,16,4509,1390.043581,305.776604,125.4249000685,117.968476097
172.30.6.255,56957,184.29.26.182,443,42,11720,24,6665,18,5055,1390.044023,350.227933,152.2437103839,115.4676603137
172.30.6.255,56958,52.221.102.82,443,23,7437,13,2742,10,4695,1390.449886,63.804388,343.800805675,588.6742460409
172.30.6.255,56959,54.201.177.109,80,7,402,4,228,3,174,1390.793893,13.863597,131.5675866804,100.4068424666
172.30.6.255,56960,54.201.177.109,80,14,3365,8,2195,6,1170,1390.925061,13.741647,1277.867201799,681.1410597289
172.30.6.255,56962,172.30.16.59,7680,3,198,3,198,0,0,1396.390541,9.003926,175.9232583653,0
172.30.6.255,56963,115.114.126.213,443,13,1454,7,958,6,496,1404.323302,15.015757,510.397178111,264.2557414854
172.30.6.255,56964,172.217.160.226,443,42,8139,20,3049,22,5090,1406.880762,240.712721,101.3324094326,169.164304366
172.30.6.255,56965,103.243.221.51,80,45,29062,26,24807,19,4255,1417.833784,18.395558,10788.2565997725,1850.4467219749
172.30.6.255,56966,103.243.220.231,80,23,13635,10,5275,13,8360,1417.845514,18.38383,2295.4955523414,3637.9796810567
172.30.6.255,56967,103.243.220.231,80,30,20658,14,5490,16,15168,1417.846776,1.533698,28636.6677142444,79118.5748432894
172.30.6.255,56968,103.243.220.231,80,16,5527,9,4299,7,1228,1417.849529,18.379498,1871.2154162208,534.5086138914
172.30.6.255,56969,103.231.98.53,80,34,15245,20,13497,14,1748,1417.850954,22.30028,4841.9122988591,627.077328177
172.30.6.255,56970,176.34.147.227,443,18,6378,9,1141,9,5237,1419.461525,16.748067,545.0181205986,2501.5424168055
172.30.6.255,56971,115.114.126.213,443,16,6856,9,1141,7,5715,1421.001275,14.994332,608.7633647167,3049.1521729678
172.30.6.255,56972,115.114.126.213,443,16,6868,9,1153,7,5715,1435.996882,18.258003,505.2031155872,2504.107376913
172.30.6.255,56976,103.243.220.231,80,20,10615,9,4498,11,6117,1436.859559,16.196809,2221.6721824651,3021.3358693061
172.30.6.255,56977,103.243.220.231,80,37,25252,14,8039,23,17213,1436.861658,16.195184,3971.0570747452,8502.7746520201
172.30.6.255,56978,103.243.220.231,80,16,5473,9,4245,7,1228,1436.863356,16.193487,2097.1394240166,606.6636543445
172.30.6.255,56979,103.243.221.51,80,26,13150,15,10940,11,2210,1436.864287,16.192554,5404.9534125377,1091.8598758417
172.30.6.255,56980,184.29.26.182,443,13,1477,7,958,6,519,1436.8976,17.824293,429.9749785307,232.9405155088
172.30.6.255,56981,103.243.221.51,80,36,23396,20,20894,16,2502,1437.086685,15.970155,10466.5233368117,1253.3378667897
172.30.6.255,56982,115.114.126.213,443,84,37193,32,6500,52,30693,1437.09257,333.5607,155.8936649312,736.1298858049
172.30.6.255,56983,176.34.147.227,443,13,1533,7,1009,6,524,1438.294242,16.231423,497.3069828813,258.2644787213
172.30.6.255,56984,176.34.147.227,443,14,2116,8,1580,6,536,1438.681369,15.844102,797.7732029243,270.6369852959
172.30.6.255,56985,103.243.221.51,80,39,24155,24,20106,15,4049,1452.832393,27.741535,5798.0930038658,1167.635460691
172.30.6.255,56986,103.243.220.231,80,15,5843,9,4215,6,1628,1452.834624,3.674503,9176.7512504413,3544.4249195062
172.30.6.255,56987,103.243.220.231,80,16,5443,9,4215,7,1228,1452.837084,27.736843,1215.7115357361,354.1859468289
172.30.6.255,56988,103.243.220.231,80,21,10339,10,4270,11,6069,1452.837753,27.736175,1231.6045741707,1750.4937144361
172.30.6.255,56989,103.231.98.53,80,22,15521,15,15083,7,438,1452.843276,6.903989,17477.432249675,507.5326742265
172.30.6.255,56990,115.114.126.213,443,17,7427,10,1712,7,5715,1456.522017,23.843716,574.4071100327,1917.4863515402
172.30.6.255,56992,157.240.16.39,443,19,1933,10,1125,9,808,1460.08844,61.042341,147.4386442682,105.8937107278
172.30.6.255,56991,157.240.16.39,443,27,5329,15,3275,12,2054,1460.088443,61.04228,429.2107044494,269.1904692944
172.30.6.255,56993,192.168.56.1,7680,3,198,3,198,0,0,1476.617683,9.018226,175.6443007749,0
172.30.6.255,56995,115.114.126.194,443,15,6740,8,1054,7,5686,1480.377423,18.095114,465.9821430249,2513.827765882
172.30.6.255,56996,103.243.221.51,80,45,29423,26,25168,19,4255,1483.838435,14.189971,14189.1762851383,2398.8773479523
172.30.6.255,56997,103.231.98.53,80,91,47348,48,43126,43,4222,1483.849306,180.075761,1915.9047174595,187.5654991679
172.30.6.255,56998,103.243.221.51,80,40,26804,17,8922,23,17882,1483.851424,14.17698,5034.6406639496,10090.7245407696
172.30.6.255,56999,103.243.221.51,80,24,13944,10,5275,14,8669,1483.851699,14.176709,2976.7134248153,4891.9675222226
172.30.6.255,57000,103.243.221.51,80,16,5527,9,4299,7,1228,1483.851996,14.17641,2426.0020696354,692.9822148203
172.30.6.255,57001,54.194.27.245,443,19,6444,10,1207,9,5237,1484.685709,13.960125,691.6843509639,3001.119259319
172.30.6.255,57002,54.194.27.245,443,18,6378,9,1141,9,5237,1485.001959,13.648975,668.768167573,3069.5345254863
172.30.6.255,57003,103.243.221.51,80,6,348,4,228,2,120,1485.198514,12.830199,142.1645915235,74.8234692229
172.30.6.255,57004,103.243.221.51,80,45,29057,26,24802,19,4255,1497.841112,25.223399,7866.3466410693,1349.5405595416
172.30.6.255,57005,103.243.221.51,80,21,11091,10,4552,11,6539,1497.846604,25.218325,1444.0292921913,2074.3645741738
172.30.6.255,57006,103.243.221.51,80,17,5534,10,4299,7,1235,1497.850073,25.51558,1347.8823526645,387.2143999862
172.30.6.255,57007,103.243.221.51,80,24,14014,10,4551,14,9463,1497.851578,25.21335,1443.9969301977,3002.5363547486
172.30.6.255,57008,54.194.27.245,443,12,1416,6,904,6,512,1498.473714,25.196379,287.0253697962,162.5630413005
172.30.6.255,57009,115.114.126.194,443,17,6860,10,1174,7,5686,1506.4801,16.938843,554.4652607029,2685.4254449374
172.30.6.255,57013,157.240.16.39,443,19,1933,10,1125,9,808,1521.092949,61.02036,147.4917552109,105.931856187
172.30.6.255,57012,157.240.16.39,443,28,5559,15,3413,13,2146,1521.092997,61.021603,447.4480947346,281.3429860241
172.30.6.255,57014,103.243.221.51,80,40,24224,23,20079,17,4145,1522.833585,12.09828,13277.259246769,2740.885481242
172.30.6.255,57015,103.243.221.51,80,16,5443,9,4215,7,1228,1522.836677,12.095188,2787.8855624237,812.2238364546
172.30.6.255,57016,103.243.221.51,80,19,9626,9,4216,10,5410,1522.839301,12.092383,2789.1938255677,3579.112570285
172.30.6.255,57017,103.243.221.51,80,16,5799,9,4216,7,1583,1522.840919,12.090946,2789.5253191934,1047.3952989286
172.30.6.255,57018,115.114.126.194,443,17,6860,10,1174,7,5686,1534.739969,14.891484,630.6960407707,3054.6317613476
172.30.6.255,57019,172.217.166.197,443,18,5430,10,1315,8,4115,1542.053172,17.192387,611.8987433217,1914.8010104705
172.30.6.255,57020,103.243.221.51,80,78,53935,47,45806,31,8129,1548.839091,45.252602,8097.8326947918,1437.0886341519
172.30.6.255,57021,103.243.221.51,80,52,38698,20,9814,32,28884,1548.855568,45.236126,1735.6039728071,5108.1297279966
172.30.6.255,57022,103.243.221.51,80,35,19625,16,9598,19,10027,1548.856884,45.234808,1697.4538722481,1773.3246485759
172.30.6.255,57023,103.243.221.51,80,23,10506,14,8316,9,2190,1548.861406,45.230288,1470.8727921432,387.35105998
172.30.6.255,57024,52.213.19.114,443,19,6444,10,1207,9,5237,1549.678574,45.042698,214.3743698479,930.1396643691
172.30.6.255,57025,52.213.19.114,443,18,6378,9,1141,9,5237,1549.678814,45.03131,202.7034079177,930.3748880501
172.30.6.255,57026,52.213.19.114,443,17,6324,8,1087,9,5237,1549.952296,44.763556,194.2651741073,935.9399418581
172.30.6.255,57027,172.217.194.189,443,43,10096,21,3862,22,6234,1550.426228,240.394067,128.5223066674,207.4593629634
172.30.6.255,57028,172.217.194.189,443,7,402,4,228,3,174,1550.518373,43.430401,41.9982306864,32.0512813133
172.30.6.255,57029,192.168.1.35,7680,3,198,3,198,0,0,1556.84455,9.004163,175.9186278614,0
172.30.6.255,57030,172.30.16.59,7680,3,198,3,198,0,0,1556.845309,9.003403,175.9334775973,0
172.30.6.255,57031,172.217.166.206,443,17,1779,10,1150,7,629,1570.434119,114.011376,80.6937020039,44.1359465743
172.30.6.255,57032,172.217.166.206,443,35,5994,19,3730,16,2264,1570.43412,114.03166,261.6817119035,158.8330819704
172.30.6.255,57034,157.240.16.39,443,28,5548,15,3399,13,2149,1582.088228,61.066266,445.2867643815,281.5302314374
172.30.6.255,57033,157.240.16.39,443,18,1879,9,1071,9,808,1582.088248,61.066376,140.3063446896,105.8520322215
172.30.6.255,57035,103.243.221.51,80,16,5443,9,4215,7,1228,1593.840536,16.527011,2040.296336706,594.4208544425
172.30.6.255,57036,103.243.221.51,80,21,10343,10,4270,11,6073,1593.842125,16.525421,2067.1182900575,2939.9553572644
172.30.6.255,57037,103.243.221.51,80,27,16885,11,4324,16,12561,1593.842879,16.524668,2093.3552189974,6081.0904037527
172.30.6.255,57038,103.243.221.75,80,40,24212,24,20117,16,4095,1593.88139,16.486157,9761.8868969888,1987.1216803285
172.30.6.255,57039,103.243.221.75,80,6,340,4,228,2,112,1594.088802,16.278841,112.0472888703,55.0407734801
172.30.6.255,57040,103.243.221.51,80,6,340,4,228,2,112,1594.092547,16.274305,112.0785188676,55.0561145315
172.30.6.255,57041,192.168.240.1,7680,3,198,3,198,0,0,1596.993566,9.00777,175.8481844008,0
172.30.6.255,57043,115.114.126.194,443,16,6794,9,1108,7,5686,1610.138828,10.121633,875.7480141791,4494.136469876
172.30.6.255,57044,103.243.221.75,80,71,48031,42,40002,29,8029,1614.841438,49.190182,6505.6884725493,1305.789029201
172.30.6.255,57045,103.243.221.17,80,47,29597,23,10049,24,19548,1614.860422,49.169979,1634.9813775597,3180.477258288
172.30.6.255,57046,103.243.221.17,80,24,10906,14,8316,10,2590,1614.860665,49.169504,1353.0337828911,421.3994104964
172.30.6.255,57047,103.243.221.17,80,51,36227,23,10049,28,26178,1614.861856,7.011425,11465.8575111337,29868.9638696845
172.30.6.255,57048,54.194.27.245,443,220,82294,128,66251,92,16043,1615.796522,983.698521,538.7910916662,130.4708681167
172.30.6.255,57049,54.194.27.245,443,14,1537,7,959,7,578,1616.053827,48.622251,157.7878407974,95.1004921594
172.30.6.255,57050,192.168.1.44,7680,3,198,3,198,0,0,1637.154144,9.009671,175.8110812259,0
172.30.6.255,57052,157.240.16.39,443,26,6485,15,3443,11,3042,1643.095962,61.026398,451.3456619216,398.7782467515
172.30.6.255,57053,157.240.16.39,443,19,1933,10,1125,9,808,1643.096106,61.026465,147.4770003473,105.9212589161
172.30.6.255,57054,103.243.221.75,80,40,24202,24,20109,16,4093,1663.837028,16.19559,9933.0743739499,2021.7849426912
172.30.6.255,57055,103.243.221.17,80,17,5497,9,4215,8,1282,1663.842362,16.189071,2082.8866585365,633.513806938
172.30.6.255,57056,103.243.221.17,80,20,10291,9,4216,11,6075,1663.843072,16.189097,2083.3774731228,3002.0204338759
172.30.6.255,57057,103.243.221.17,80,16,5798,9,4216,7,1582,1663.843652,16.188143,2083.50025077,781.8067829028
172.30.6.255,57058,103.231.98.53,80,27,11352,14,10166,13,1186,1663.850064,71.071279,1144.3159760781,133.4997784407
172.30.6.255,57059,172.30.10.168,7680,3,198,3,198,0,0,1677.32957,9.005735,175.8879203086,0
172.30.6.255,57061,103.243.221.75,80,48,29981,28,24874,20,5107,1679.844354,16.147687,12323.2510018309,2530.1456487236
172.30.6.255,57062,103.243.221.17,80,16,5472,9,4245,7,1227,1679.858579,16.133089,2104.9905569851,608.438966648
172.30.6.255,57063,103.243.221.17,80,21,10660,10,4552,11,6108,1679.858803,16.132862,2257.2560280997,3028.8488180213
172.30.6.255,57064,103.243.221.17,80,27,17368,11,4606,16,12762,1679.858972,16.132697,2284.0570302659,6328.5140730034
172.30.6.255,57065,103.243.221.75,80,23,13591,15,11542,8,2049,1679.872023,1.760627,52444.9528491805,9310.3195622917
172.30.6.255,57066,103.243.221.17,80,17,5834,9,4552,8,1282,1679.879163,16.111964,2260.1837988218,636.5456129371
172.30.6.255,57067,103.243.221.17,80,24,15230,11,5834,13,9396,1679.879912,16.111758,2896.7664484534,4665.4126756373
172.30.6.255,57068,103.231.98.53,80,19,6855,10,6121,9,734,1679.880428,55.038822,889.6992744503,106.688329921
172.30.6.255,57069,103.243.221.17,80,35,24221,15,6051,20,18170,1679.88125,16.110789,3004.6945559277,9022.5252158662
172.30.6.255,57070,210.176.156.21,80,26,6225,14,4280,12,1945,1679.891796,303.074179,112.9756421777,51.3405663635
172.30.6.255,57071,210.176.156.21,80,323,187262,157,134632,166,52630,1679.891973,1090.095018,988.0386408664,386.2415597243
172.30.6.255,57072,35.190.43.164,80,180,52151,92,38465,88,13686,1679.901801,1030.009386,298.7545591162,106.2980604722
172.30.6.255,57073,35.190.43.164,80,179,51690,90,37760,89,13930,1679.902053,1030.010038,293.2786952121,108.193120347
172.30.6.255,57074,173.241.248.220,80,165,84287,82,39175,83,45112,1679.946344,848.82333,369.216995956,425.1721026565
172.30.6.255,57075,180.149.59.232,80,419,298438,261,227734,158,70704,1680.047166,1368.970527,1330.8336184509,413.1805534481
172.30.6.255,57076,54.194.27.245,443,12,1416,6,904,6,512,1680.738716,15.223364,475.059257599,269.0601104986
172.30.6.255,57077,54.194.27.245,443,12,1416,6,904,6,512,1680.753829,15.219959,475.1655375681,269.1203044634
172.30.6.255,57078,103.243.221.75,80,24,12604,13,10394,11,2210,1681.085775,14.906266,5578.325249261,1186.078391463
172.30.6.255,57079,161.69.226.28,443,19,5264,10,2321,9,2943,1683.687341,159.061724,116.7345577117,148.0180109201
172.30.6.255,57081,172.217.166.206,443,28,4433,16,3202,12,1231,1684.43931,135.747612,188.703135345,72.5463958806
172.30.6.255,57080,172.217.166.206,443,17,1783,10,1154,7,629,1684.439514,135.741575,68.0115874595,37.0704406517
172.30.6.255,57082,172.30.10.168,80,3,198,3,198,0,0,1685.320854,9.001565,175.9694008764,0
172.30.6.255,57083,115.114.126.194,443,17,6860,10,1174,7,5686,1695.800187,39.601197,237.1645483342,1148.6521480651
172.30.6.255,57084,157.240.16.39,443,28,5566,15,3419,13,2147,1704.096967,61.028572,448.1835164028,281.4419449303
172.30.6.255,57085,157.240.16.39,443,19,1933,10,1125,9,808,1704.096996,61.02877,147.4714302779,105.9172583685
172.30.6.255,57086,172.30.10.168,445,3,198,3,198,0,0,1716.331681,9.003311,175.935275367,0
172.30.6.255,57088,172.30.16.59,7680,3,198,3,198,0,0,1717.42546,9.004372,175.9145446234,0
172.30.6.255,57089,103.243.221.17,80,52,35935,25,13851,27,22084,1734.842102,12.437489,8909.1938091363,14204.7964826342
172.30.6.255,57090,103.231.98.53,80,39,17418,20,15672,19,1746,1734.84359,60.900363,2058.7069407123,229.3582388006
172.30.6.255,57091,103.243.221.46,80,101,71855,61,60015,40,11840,1734.844411,35.998598,13337.1860759689,2631.2135822623
172.30.6.255,57092,103.243.221.17,80,52,38458,22,13640,30,24818,1734.845696,35.996727,3031.3867146866,5515.6125722208
172.30.6.255,57093,103.243.221.17,80,37,20806,19,12304,18,8502,1734.846755,35.996252,2734.5069147755,1889.5300544068
172.30.6.255,57094,172.30.10.168,139,3,198,3,198,0,0,1737.339167,9.005798,175.8866898858,0
172.30.6.255,57097,172.30.10.168,445,3,198,3,198,0,0,1758.346953,9.004253,175.916869506,0
172.30.6.255,57099,157.240.16.39,443,19,1933,10,1125,9,808,1765.095721,61.027304,147.4749728417,105.9198027165
172.30.6.255,57098,157.240.16.39,443,28,5423,15,3274,13,2149,1765.095723,61.031086,429.1583472724,281.6925132219
172.30.6.255,57100,115.114.126.194,443,16,6794,9,1108,7,5686,1770.650034,10.467244,846.832270271,4345.7475530331
172.30.6.255,57101,172.30.10.168,139,3,198,3,198,0,0,1779.355736,9.006061,175.8815535449,0
172.30.6.255,57102,115.114.126.194,443,17,6860,10,1174,7,5686,1781.11797,14.533034,646.2518425265,3129.9727228327
172.30.6.255,57103,115.114.126.194,443,17,6860,10,1174,7,5686,1795.654068,15.757611,596.029436188,2886.7320052513
172.30.6.255,57106,103.243.221.46,80,102,71709,61,59812,41,11897,1800.847716,41.184431,11618.3710295767,2310.9703761599
172.30.6.255,57107,103.243.221.87,80,53,35659,23,13442,30,22217,1800.855733,41.175783,2611.6321819551,4316.5177939664
172.30.6.255,57108,103.231.98.53,80,39,17419,20,15673,19,1746,1800.856346,61.063312,2053.3442404827,228.7461905113
172.30.6.255,57109,103.243.221.87,80,46,27632,22,12717,24,14915,1800.857652,41.174185,2470.8685794267,2897.9322845127
172.30.6.255,57110,103.243.221.87,80,57,42424,24,13748,33,28676,1800.858545,41.17329,2671.246334699,5571.7675220999
172.30.6.255,57111,115.114.126.194,443,18,6903,10,1163,8,5740,1814.050996,48.535676,191.6940437793,946.1081782399
172.30.6.255,57112,52.175.23.79,443,24,9836,11,1987,13,7849,1816.366658,124.262846,127.922388,505.3159654818
172.30.6.255,57114,157.240.16.39,443,27,5512,15,3419,12,2093,1826.097938,61.031971,448.1585561115,274.3480134371
172.30.6.255,57115,157.240.16.39,443,19,1933,10,1125,9,808,1826.097939,61.031879,147.463917996,105.9118628807
172.30.6.255,57116,52.229.173.178,443,28,10050,14,2146,14,7904,1836.159907,128.284121,133.8279427428,492.9058990863
172.30.6.255,57118,13.125.182.143,443,21,8527,11,1802,10,6725,1846.725023,109.274203,131.9250070394,492.3394408102
172.30.6.255,57121,161.69.13.35,80,17,5156,9,2452,8,2704,1855.242082,61.259862,320.2096668125,353.1186537769
172.30.6.255,57122,161.69.226.29,443,27,6916,15,3646,12,3270,1855.272102,363.296241,80.2870955111,72.0073511578
172.30.6.255,57119,111.221.29.253,443,24,6067,14,1455,10,4612,1856.127377,108.737142,107.0471394218,339.3136817961
172.30.6.255,57120,72.247.218.17,443,25,8812,14,1377,11,7435,1856.130741,108.642582,101.3967064958,547.4833063154
172.30.6.255,57123,117.18.237.29,80,10,1590,6,574,4,1016,1856.451634,109.832663,41.8090563824,74.0034865585
172.30.6.255,57124,184.29.25.174,443,50,34495,20,2897,30,31598,1859.342851,142.587662,162.5386073025,1772.8322104054
172.30.6.255,57125,172.217.166.206,443,17,1783,10,1154,7,629,1861.42382,68.748791,134.2859978439,73.1940144227
172.30.6.255,57126,172.217.166.206,443,125,20914,57,11749,68,9165,1861.42382,178.753417,525.8193190231,410.1739772616
172.30.6.255,57128,13.67.76.139,443,26,11304,14,1558,12,9746,1861.605526,0.393015,31713.8022721878,198384.285587126
172.30.6.255,57127,13.67.76.139,443,20,8628,12,975,8,7653,1861.605819,109.992458,70.9139530276,556.6199820719
172.30.6.255,57129,103.243.221.75,80,49,34198,29,29888,20,4310,1861.83664,14.197612,16841.1420174041,2428.5774255558
172.30.6.255,57130,103.243.220.231,80,16,5473,9,4245,7,1228,1861.841259,14.190376,2393.1712591689,692.3001899315
172.30.6.255,57131,103.243.220.231,80,37,27845,15,8093,22,19752,1861.842826,14.190394,4562.523070184,11135.4202004539
172.30.6.255,57132,103.243.220.231,80,21,10656,10,4552,11,6104,1861.850642,14.181282,2567.8919578639,3443.4122387525
172.30.6.255,57133,103.231.98.53,80,39,17419,20,15673,19,1746,1861.855013,60.077918,2087.0230556259,232.498070256
172.30.6.255,57134,172.217.166.206,443,32,4755,18,2662,14,2093,1862.408745,67.76372,314.2684610585,247.0938726504
172.30.6.255,57135,172.217.166.206,443,17,1779,10,1150,7,629,1862.408745,67.764718,135.7638646117,74.2569311659
172.30.6.255,57136,103.243.221.75,80,6,340,4,228,2,112,1863.025132,13.008825,140.2125095848,68.8763204978
172.30.6.255,57137,117.18.232.200,443,47,24490,21,1918,26,22572,1865.62296,109.964974,139.5353396801,1642.1228817823
172.30.6.255,57138,172.217.166.197,443,17,1779,10,1150,7,629,1867.426312,62.745767,146.6234367651,80.1966449785
172.30.6.255,57139,172.217.166.197,443,31,8297,18,5577,13,2720,1867.426312,62.751129,710.9991598717,346.7666693296
172.30.6.255,57140,172.217.166.234,443,43,6727,22,4200,21,2527,1870.510916,169.664767,198.0375807783,119.1526111016
172.30.6.255,57141,172.217.166.234,443,17,1793,10,1164,7,629,1870.510936,169.664373,54.8848284136,29.6585541857
172.30.6.255,57142,103.243.221.75,80,31,18279,18,15142,13,3137,1875.843717,46.19945,2622.0225565456,543.2099299883
172.30.6.255,57143,103.243.220.231,80,36,22427,16,8395,20,14032,1875.852251,46.190186,1453.9885160887,2430.2998043784
172.30.6.255,57144,103.243.220.231,80,45,32171,19,9478,26,22693,1875.863073,46.179528,1641.9396924109,3931.2658197806
172.30.6.255,57145,103.243.220.231,80,39,23357,17,9371,22,13986,1875.865661,46.17694,1623.4943242233,2423.0275977577
172.30.6.255,57146,103.243.221.75,80,47,30072,27,24970,20,5102,1876.839434,45.204633,4419.0160774007,902.9163006367
172.30.6.255,57147,103.243.221.75,80,6,340,4,228,2,112,1877.014875,45.029106,40.5071333195,19.8982409289
172.30.6.255,57149,157.240.16.39,443,31,6109,17,3525,14,2584,1887.10257,61.00531,462.254843062,338.8557487865
172.30.6.255,57150,157.240.16.39,443,19,1933,10,1125,9,808,1887.102572,61.005469,147.5277568967,105.9577133978
172.30.6.255,57152,103.243.221.75,80,47,29552,27,25236,20,4316,1921.856748,20.226955,9981.1365576281,1707.0290609733
172.30.6.255,57153,103.243.220.231,80,17,5534,9,4245,8,1289,1921.877125,20.206088,1680.6815846789,510.3412397293
172.30.6.255,57154,103.243.220.231,80,18,6306,9,4498,9,1808,1921.879975,20.203238,1781.1006334727,715.9248433345
172.30.6.255,57155,103.243.220.231,80,21,10669,10,4552,11,6117,1921.882135,20.200919,1802.690263745,2422.464047304
172.30.6.255,57156,103.231.98.53,80,283,147679,142,133917,141,13762,1921.883336,589.118621,1818.540378475,186.8825667284
172.30.6.255,57157,23.8.190.108,80,13,5510,6,549,7,4961,1939.042273,60.120572,73.0531971652,660.1400931448
172.30.6.255,57158,103.243.221.75,80,70,47895,42,39926,28,7969,1941.893777,20.134542,15863.6834152969,3166.2999833818
172.30.6.255,57159,103.243.220.231,80,51,39616,18,9424,33,30192,1941.902325,20.125704,3746.0552932707,12001.3689955889
172.30.6.255,57160,103.243.220.231,80,24,10521,14,8286,10,2235,1941.907064,20.121255,3294.4267144371,888.6125641765
172.30.6.255,57161,103.243.220.231,80,35,19320,16,9316,19,10004,1941.908105,20.120214,3704.135552435,3977.6912909574
172.30.6.255,57162,176.34.147.227,443,19,6444,10,1207,9,5237,1942.797021,40.865787,236.2856733923,1025.2096698884
172.30.6.255,57164,157.240.16.39,443,19,1933,10,1125,9,808,1948.082776,61.042888,147.4373230834,105.8927618235
172.30.6.255,57163,157.240.16.39,443,28,5420,15,3274,13,2146,1948.082787,61.042765,429.0762386009,281.245451447
172.30.6.255,57166,103.243.221.87,80,40,24264,23,20107,17,4157,1982.853271,25.17201,6390.2723699856,1321.1499598165
172.30.6.255,57167,103.243.221.46,80,20,10572,10,4552,10,6020,1982.860408,25.164546,1447.115318512,1913.8036505805
172.30.6.255,57168,103.243.221.46,80,17,6250,9,4497,8,1753,1982.861667,25.163615,1429.6832947094,557.3126118803
172.30.6.255,57169,103.243.221.46,80,16,5473,9,4245,7,1228,1982.869715,25.155802,1349.9867744229,390.5262094208
172.30.6.255,57172,103.243.221.87,80,71,47950,42,39926,29,8024,2007.836185,26.445376,12078.0283101287,2427.3430636796
172.30.6.255,57173,103.243.221.46,80,35,22075,15,8341,20,13734,2007.847702,26.433859,2524.3381982177,4156.4873293756
172.30.6.255,57174,103.243.221.46,80,53,38169,21,9587,32,28582,2007.84976,26.431801,2901.6562284197,8650.7915219247
172.30.6.255,57175,103.243.221.46,80,33,18644,16,9316,17,9328,2007.851714,26.429681,2819.8599899863,2823.4922699218
172.30.6.255,57176,172.217.166.206,80,10,886,6,542,4,344,2008.484119,60.330788,71.8704353737,45.6151840748
172.30.6.255,57177,54.194.27.245,443,19,6444,10,1207,9,5237,2008.662168,25.600687,377.1773780915,1636.5185824896
172.30.6.255,57178,122.15.34.32,80,10,1221,6,705,4,516,2008.749813,60.033091,93.9481860096,68.7620765687
172.30.6.255,57179,157.240.16.39,443,19,1933,10,1125,9,808,2009.100901,61.014456,147.5060270963,105.9421065723
172.30.6.255,57180,157.240.16.39,443,28,5536,15,3430,13,2106,2009.100935,61.014553,449.7287720849,276.1308437349
172.30.6.255,57181,13.250.210.87,443,24,8880,12,1924,12,6956,2034.178165,65.652203,234.4475782481,847.6181675122
172.30.6.255,57183,172.30.16.59,7680,3,198,3,198,0,0,2038.438651,9.010741,175.7902041575,0
172.30.6.255,57184,103.243.221.109,80,40,24281,23,20135,17,4146,2043.845376,29.184386,5519.3897175017,1136.498126087
172.30.6.255,57185,103.243.221.75,80,25,17137,10,4551,15,12586,2043.862274,29.168083,1248.2136724584,3451.9923712505
172.30.6.255,57186,103.243.221.75,80,15,5426,9,4245,6,1181,2043.863075,29.167013,1164.3290315673,323.9275821628
172.30.6.255,57187,103.243.221.75,80,21,10601,10,4552,11,6049,2043.864905,29.165184,1248.61204373,1659.238631925
172.30.6.255,57188,52.229.174.172,443,27,10001,13,2098,14,7903,2050.958216,126.248143,132.9445297267,500.7915245138
172.30.6.255,57190,172.217.166.206,443,33,5831,19,3753,14,2078,2051.406808,98.786441,303.9283498431,168.28220383
172.30.6.255,57189,172.217.166.206,443,17,1779,10,1150,7,629,2051.406808,98.785516,93.1310618451,50.9386416527
172.30.6.255,57191,157.240.16.39,443,18,1879,9,1071,9,808,2070.09081,61.024465,140.4027057017,105.924730352
172.30.6.255,57192,157.240.16.39,443,28,5556,15,3410,13,2146,2070.090844,61.02425,447.0353998615,281.3307824349
172.30.6.255,57193,103.243.221.109,80,51,35315,31,30998,20,4317,2072.840145,15.186192,16329.5709681535,2274.1711681244
172.30.6.255,57194,103.243.221.75,80,25,13235,11,5329,14,7906,2072.849096,15.176527,2809.0748298343,4167.4883851885
172.30.6.255,57195,103.243.221.75,80,17,5588,9,4299,8,1289,2072.851707,15.174628,2266.4147022253,679.5553736144
172.30.6.255,57196,103.243.221.75,80,41,26918,17,8924,24,17994,2072.855066,15.170828,4705.8736675415,9488.7372001055
172.30.6.255,57197,103.243.221.109,80,6,340,4,228,2,112,2074.069625,13.95691,130.6879531358,64.1975910141
172.30.6.255,57198,192.168.56.1,7680,3,198,3,198,0,0,2078.536888,9.003561,175.9303902089,0
172.30.6.255,57200,103.243.221.109,80,48,33899,29,29634,19,4265,2087.838226,12.187847,19451.5077191236,2799.5100365142
172.30.6.255,57201,103.243.221.75,80,34,21298,14,7757,20,13541,2087.850248,12.175825,5096.656694721,8896.97412701
172.30.6.255,57202,103.243.221.75,80,16,5442,9,4215,7,1227,2087.852271,12.173799,2769.8830907263,806.3218392221
172.30.6.255,57203,103.243.221.75,80,22,10143,10,4270,12,5873,2087.8543,12.171772,2806.4935820355,3860.0788775866
172.30.6.255,57204,103.243.221.109,80,6,348,4,228,2,120,2088.739044,11.287348,161.5968604849,85.0509792026
172.30.6.255,57205,172.217.166.195,443,57,10426,26,3194,31,7232,2089.11016,282.033112,90.5992910506,205.1390334621
172.30.6.255,57206,172.217.166.210,443,45,7753,22,2584,23,5169,2099.923241,240.368989,86.0011105676,172.0355032986
172.30.6.255,57207,172.217.166.210,443,47,7934,22,2596,25,5338,2099.960177,240.369293,86.4003872575,177.6599642451
172.30.6.255,57208,103.243.221.109,80,39,24182,23,20079,16,4103,2103.840338,27.183561,5909.1595836175,1207.494485362
172.30.6.255,57209,103.243.221.75,80,16,5473,9,4245,7,1228,2103.848662,27.175238,1249.6670682332,361.5055735666
172.30.6.255,57210,103.243.221.75,80,18,6306,9,4498,9,1808,2103.849978,27.173471,1324.2327415589,532.283858768
172.30.6.255,57211,103.243.221.75,80,21,10671,10,4552,11,6119,2103.851656,27.172818,1340.1628053447,1801.5061963761
172.30.6.255,57212,52.175.23.79,443,27,10070,14,2220,13,7850,2114.944147,94.122598,188.6900741945,667.2149019941
172.30.6.255,57215,52.114.6.46,443,20,7560,12,2917,8,4643,2120.081986,1.035522,22535.4941758913,35869.8318336179
172.30.6.255,57216,157.240.16.39,443,19,1933,10,1125,9,808,2131.088548,61.073963,147.3623056031,105.8388826021
172.30.6.255,57217,157.240.16.39,443,26,5399,14,3344,12,2055,2131.088548,61.073758,438.0277368882,269.1827151033
172.30.6.255,57218,103.243.221.17,80,47,30018,27,25709,20,4309,2138.868824,19.196797,10713.8706524843,1795.7162332862
172.30.6.255,57219,103.243.220.231,80,30,22391,11,5327,19,17064,2138.89324,19.172101,2222.8132430556,7120.3463824856
172.30.6.255,57220,103.243.220.231,80,16,5527,9,4299,7,1228,2138.893559,19.172062,1793.8602535293,512.4122799102
172.30.6.255,57221,103.243.220.231,80,22,13621,10,5275,12,8346,2138.893839,19.171781,2201.1517865763,3482.6185423253
172.30.6.255,57222,103.243.221.17,80,78,53068,46,44884,32,8184,2157.838208,41.496741,8653.0168718551,1577.7624560926
172.30.6.255,57223,103.243.220.231,80,36,22484,16,8594,20,13890,2157.844769,41.489836,1657.0805437746,2678.2463059145
172.30.6.255,57224,103.243.220.231,80,29,15658,15,8539,14,7119,2157.845679,41.48927,1646.4979981571,1372.6922647711
172.30.6.255,57225,103.243.220.231,80,29,14751,14,8233,15,6518,2157.852848,41.482101,1587.7691440942,1257.0240837126
172.30.6.255,57226,192.168.1.35,7680,3,198,3,198,0,0,2158.77206,9.00468,175.9085275657,0
172.30.6.255,57227,161.69.36.37,80,7,398,4,228,3,170,2167.293815,0.825984,2208.2752208274,1646.5209979853
172.30.6.255,57228,161.69.36.37,80,7,398,4,228,3,170,2167.76897,0.663918,2747.3272301711,2048.4457417942
172.30.6.255,57229,172.217.166.206,443,39,6548,20,3795,19,2753,2172.418509,87.777767,345.8734601895,250.9063599214
172.30.6.255,57230,172.217.166.206,443,17,1779,10,1150,7,629,2172.418514,87.744914,104.8493819254,57.3480532444
172.30.6.255,57232,161.69.226.29,443,29,8254,15,4573,14,3681,2183.040473,275.556721,132.7639546125,106.8672899472
172.30.6.255,57231,151.101.194.133,80,10,1099,6,547,4,552,2183.420332,60.633538,72.1712792019,72.8309801087
172.30.6.255,57233,157.240.16.39,443,27,5467,15,3412,12,2055,2192.098696,61.054582,447.0753726559,269.2672599085
172.30.6.255,57234,157.240.16.39,443,20,2025,11,1217,9,808,2192.098706,61.05479,159.4633279387,105.8721191245
172.30.6.255,57235,192.168.240.1,7680,3,198,3,198,0,0,2198.917495,9.004735,175.9074531344,0
172.30.6.255,57236,52.84.108.179,443,24,8202,12,1898,12,6304,2199.178143,138.603966,109.5495348236,363.8568322064
172.30.6.255,57237,103.243.221.87,80,7,406,5,294,2,112,2204.904976,21.127139,111.3260058544,42.4099069921
172.30.6.255,57238,103.243.220.231,80,16,5526,9,4299,7,1227,2204.911783,21.118402,1628.5323103519,464.8078959762
172.30.6.255,57239,103.243.220.231,80,25,13867,11,5329,14,8538,2204.912192,21.118408,2018.7127741826,3234.3347093209
172.30.6.255,57240,103.243.220.231,80,19,7320,10,5275,9,2045,2204.91252,21.118081,1998.2876285019,774.69160195
172.30.6.255,57241,103.243.221.87,80,40,24215,23,20068,17,4147,2205.117716,20.912882,7676.7994004845,1586.3906275568
172.30.6.255,57242,103.243.220.231,80,6,340,4,228,2,112,2205.124023,20.906806,87.2443165159,42.8568572359
172.30.6.255,57243,18.211.245.141,443,24,2873,12,1636,12,1237,2206.073739,61.4333,213.0440656777,161.0852745986
172.30.6.255,57244,18.211.245.141,443,6,348,4,228,2,120,2206.313838,19.761961,92.2985325191,48.5781750101
172.30.6.255,57245,103.243.221.87,80,77,57516,47,49439,30,8077,2225.84152,26.386432,14989.2187014901,2448.8343099969
172.30.6.255,57246,103.243.220.231,80,27,15263,15,8287,12,6976,2225.854551,26.373401,2513.7448143301,2116.0714160453
172.30.6.255,57247,103.243.220.231,80,37,20086,19,12026,18,8060,2225.856508,26.371442,3648.1888248659,2445.0691774837
172.30.6.255,57248,103.243.220.231,80,33,22514,16,8594,17,13920,2225.858541,26.368814,2607.3224226164,4223.1705984198
172.30.6.255,57249,103.243.221.87,80,6,340,4,228,2,112,2230.04818,22.179885,82.2366752578,40.3969632845
172.30.6.255,57250,192.168.1.44,7680,3,198,3,198,0,0,2239.047991,9.002414,175.9528055475,0
172.30.6.255,57255,192.0.73.2,443,39,12026,18,2129,21,9897,2252.07232,181.06906,94.0635578491,437.2696251916
172.30.6.255,57256,23.58.57.98,443,48,12757,26,4466,22,8291,2252.077283,541.413146,65.9902705798,122.5090312085
172.30.6.255,57251,151.101.65.69,443,16,5714,10,1186,6,4528,2252.128327,20.100201,472.0350806442,1802.171033016
172.30.6.255,57252,151.101.65.69,443,541,416577,212,16158,329,400419,2252.12834,631.268206,204.7687476914,5074.4706759396
172.30.6.255,57253,13.250.67.150,443,30,10016,15,2989,15,7027,2252.235496,85.54677,279.519612488,657.1376102219
172.30.6.255,57259,13.250.67.150,443,6,340,4,228,2,112,2252.301771,18.650887,97.7969573243,48.0406106155
172.30.6.255,57254,151.101.1.69,443,16,5714,10,1186,6,4528,2252.357256,19.870979,477.48024896,1822.9600061476
172.30.6.255,57257,52.84.110.11,443,33,7232,17,2070,16,5162,2252.357429,181.802777,91.0877175435,227.1472453911
172.30.6.255,57260,151.101.1.69,443,8,480,5,294,3,186,2252.357597,18.533798,126.9032931081,80.2857568643
172.30.6.255,57261,52.84.110.11,443,8,480,5,294,3,186,2252.377992,18.489783,127.2053868885,80.4768774193
172.30.6.255,57258,13.229.196.49,443,7,406,5,294,2,112,2252.523157,18.431825,127.6053781978,48.6115726468
172.30.6.255,57262,13.229.196.49,443,24,7985,12,1441,12,6544,2252.523274,20.673916,557.6108561145,2532.2730342912
172.30.6.255,57264,157.240.16.39,443,28,5556,15,3410,13,2146,2253.094648,61.025025,447.0297226425,281.3272096161
172.30.6.255,57263,157.240.16.39,443,19,1933,10,1125,9,808,2253.094649,61.025092,147.4803184238,105.9236420324
172.30.6.255,57265,103.243.221.87,80,40,24220,24,20125,16,4095,2270.841721,15.54135,10359.4604072359,2107.9249872115
172.30.6.255,57266,103.243.220.231,80,26,13848,12,5383,14,8465,2270.842126,15.623068,2756.4368279009,4334.6159665951
172.30.6.255,57267,103.243.220.231,80,24,11981,14,9292,10,2689,2270.844351,2.804186,26508.9405624321,7671.3884171739
172.30.6.255,57268,103.243.220.231,80,9,514,6,348,3,166,2270.845612,18.225821,152.750320548,72.8636586522
172.30.6.255,57269,103.243.220.231,80,8,448,5,282,3,166,2271.090783,17.98052,125.4691188019,73.8577082309
172.30.6.255,57270,172.30.10.168,7680,3,198,3,198,0,0,2279.156463,9.01222,175.7613551378,0
172.30.6.255,57271,103.243.221.87,80,39,24162,23,20059,16,4103,2285.844517,13.194226,12162.2897773616,2487.7548709564
172.30.6.255,57272,103.243.220.231,80,35,22046,16,8323,19,13723,2285.858711,36.557652,1821.342355357,3003.0375036121
172.30.6.255,57273,103.243.220.231,80,32,16578,15,8822,17,7756,2285.862856,13.17799,5355.5967184678,4708.4570560458
172.30.6.255,57274,103.243.220.231,80,3,198,3,198,0,0,2285.869845,9.006017,175.8824128358,0
172.30.6.255,57275,103.243.220.231,80,16,5481,9,4245,7,1236,2286.113087,12.928366,2626.7820697527,764.8298323238
172.30.6.255,57276,103.243.221.87,80,40,29001,27,25061,13,3940,2298.849838,23.512601,8526.8320591159,1340.5577715541
172.30.6.255,57277,103.243.220.231,80,23,10455,11,4324,12,6131,2298.86306,23.542782,1469.3250780643,2083.3561641101
172.30.6.255,57278,103.243.220.231,80,6,340,4,228,2,112,2298.870315,23.206895,78.597330664,38.609215063
172.30.6.255,57279,103.243.221.75,80,8,448,5,282,3,166,2306.880388,18.153891,124.2708794495,73.1523616618
172.30.6.255,57281,157.240.16.39,443,28,5565,15,3417,13,2148,2314.094341,61.066078,447.6462365898,281.4000925358
172.30.6.255,57280,157.240.16.39,443,19,1933,10,1125,9,808,2314.094352,60.174031,149.5661807998,107.4217547433
172.30.6.255,57283,103.243.221.46,80,25,13696,15,11538,10,2158,2336.866019,33.185324,2781.4705078667,520.2299667166
172.30.6.255,57284,103.243.220.231,80,39,24097,16,9599,23,14498,2336.874836,33.176117,2314.6771516389,3496.0088909742
172.30.6.255,57285,103.243.220.231,80,37,22477,17,8730,20,13747,2336.875309,33.176454,2105.1074355325,3314.8810900647
172.30.6.255,57286,103.243.220.231,80,28,22570,10,5275,18,17295,2336.875762,0.91066,46340.0171304325,151933.762326224
172.30.6.255,57287,103.243.221.46,80,54,36034,32,30004,22,6030,2338.460133,31.591631,7597.9616247101,1526.9866883416
172.30.6.255,57288,103.243.220.231,80,17,5527,9,4245,8,1282,2346.841367,23.210397,1463.1374034662,441.870942578
172.30.6.255,57290,103.243.221.46,80,40,24209,23,20055,17,4154,2369.83187,33.229683,4828.2133777803,1000.0697268162
172.30.6.255,57291,103.243.220.231,80,16,5442,9,4215,7,1227,2369.835207,33.226344,1014.857367395,295.4282300815
172.30.6.255,57292,103.243.220.231,80,27,17013,11,4324,16,12689,2369.836036,33.225516,1041.1275478762,3055.242242137
172.30.6.255,57293,103.243.220.231,80,22,10400,10,4270,12,6130,2369.840391,33.220865,1028.2694324787,1476.1807075162
172.30.6.255,57294,157.240.16.39,443,19,1933,10,1125,9,808,2375.087973,61.022759,147.4859568378,105.9276916666
172.30.6.255,57295,157.240.16.39,443,27,5452,15,3399,12,2053,2375.087973,61.022114,445.6089476022,269.1483287518
172.30.6.255,57297,103.243.221.17,80,70,47871,43,39948,27,7923,2402.877208,21.155904,15106.137747647,2996.0430903827
172.30.6.255,57298,103.243.221.51,80,37,24119,15,9543,22,14576,2402.879908,21.152366,3609.2416328272,5512.7639149209
172.30.6.255,57299,103.243.221.51,80,34,22897,15,5581,19,17316,2402.88009,1.311245,34050.0821738152,105646.16070987
172.30.6.255,57300,103.243.221.51,80,36,22444,16,8677,20,13767,2402.880333,21.152781,3281.6488763346,5206.6912620143
172.30.6.255,57301,103.243.221.17,80,6,348,4,228,2,120,2403.090772,20.941728,87.0988296668,45.8414892983
172.30.6.255,57302,103.243.221.51,80,17,5532,9,4243,8,1289,2403.097535,20.935289,1621.3771875803,492.5654477471
172.30.6.255,57303,157.240.16.39,443,27,5292,13,2282,14,3010,2423.843067,65.191089,280.038273329,369.3756365997
172.30.6.255,57304,157.240.16.39,443,19,1933,10,1125,9,808,2436.085734,61.029534,147.4695841525,105.9159324402
172.30.6.255,57305,157.240.16.39,443,30,5581,16,3341,14,2240,2436.085738,61.029817,437.9498630972,293.6269659796
172.30.6.255,57306,161.69.226.29,443,32,8176,18,4458,14,3718,2436.616213,262.730456,135.7436840136,113.2110850521
172.30.6.255,57308,103.243.221.17,80,40,24223,23,20067,17,4156,2439.842239,14.045301,11429.8725246258,2367.1973993295
172.30.6.255,57309,103.243.221.51,80,17,5853,9,4216,8,1637,2439.853824,14.035317,2403.0807426722,933.0747570575
172.30.6.255,57310,103.243.221.51,80,20,9667,9,4216,11,5451,2439.855708,14.03292,2403.4912192188,3107.5499610915
172.30.6.255,57311,103.243.221.51,80,17,5496,9,4215,8,1281,2439.862107,14.025093,2404.2621321655,730.6903419464
172.30.6.255,57312,104.36.113.23,443,39,13092,19,6009,20,7083,2453.682596,317.285841,151.5100700633,178.5897530801
172.30.6.255,57313,104.36.113.23,443,4,240,2,120,2,120,2453.917503,10.689702,89.8060582044,89.8060582044
172.30.6.255,57314,103.243.221.17,80,46,29871,26,24759,20,5112,2467.835845,43.193389,4585.7017609801,946.811559519
172.30.6.255,57315,103.243.221.51,80,22,11123,10,4552,12,6571,2467.839018,43.189077,843.1761577123,1217.1596072776
172.30.6.255,57316,103.243.221.51,80,16,5472,9,4245,7,1227,2467.839257,43.187797,786.333232047,227.2864253761
172.30.6.255,57317,103.243.221.51,80,32,23480,12,4659,20,18821,2467.839443,43.188653,863.0044562862,3486.2860853752
172.30.6.255,57318,103.243.221.17,80,22,12174,13,10071,9,2103,2467.873074,1.231822,65405.5537244968,13657.8174444064
172.30.6.255,57319,103.243.221.51,80,31,23004,11,5835,20,17169,2467.877936,43.15016,1081.8036364176,3183.1168181068
172.30.6.255,57320,103.243.221.51,80,25,15257,11,5835,14,9422,2467.878689,43.149406,1081.8225400368,1746.8606636207
172.30.6.255,57321,210.176.156.21,80,26,6226,14,4281,12,1945,2467.881173,302.104098,113.3648971554,51.5054251267
172.30.6.255,57322,210.176.156.21,80,223,134691,110,97058,113,37633,2467.88157,581.250877,1335.8500274573,517.9587883873
172.30.6.255,57323,103.243.221.51,80,16,5787,9,4551,7,1236,2467.882373,43.145139,843.8494079252,229.1799314866
172.30.6.255,57324,103.231.98.53,80,51,23872,26,21566,25,2306,2467.885268,113.051057,1526.1069164528,163.1829059325
172.30.6.255,57325,35.190.43.164,80,118,34507,60,25237,58,9270,2467.901258,581.163902,347.3994157332,127.6059984882
172.30.6.255,57326,35.190.43.164,80,129,39369,67,29193,62,10176,2467.90152,581.1515,401.8642298953,140.0805125686
172.30.6.255,57327,173.241.248.220,80,119,61816,59,27621,60,34195,2467.943909,581.218906,380.1803377676,470.6660385201
172.30.6.255,57328,180.149.59.210,80,10,1002,6,348,4,654,2468.086251,42.747058,65.1272889938,122.3943879366
172.30.6.255,57329,172.217.166.197,443,17,1779,10,1150,7,629,2468.42366,68.02785,135.2387294321,73.9697050546
172.30.6.255,57330,172.217.166.197,443,29,8431,16,5468,13,2963,2468.423937,68.025563,643.0523772365,348.4572409934
172.30.6.255,57331,52.213.19.114,443,19,6444,10,1207,9,5237,2468.837279,42.763404,225.8005466543,979.7162078117
172.30.6.255,57332,52.213.19.114,443,18,6378,9,1141,9,5237,2468.838337,42.754885,213.4960718524,979.9114183093
172.30.6.255,57333,52.213.19.114,443,18,6378,9,1141,9,5237,2468.839279,42.765379,213.4436830315,979.6709623455
172.30.6.255,57334,52.213.19.114,443,19,6444,10,1207,9,5237,2468.840131,42.761419,225.8110283945,979.7616865801
172.30.6.255,57335,103.243.221.17,80,23,12383,13,10226,10,2157,2469.067476,41.961367,1949.6028334825,411.2354108959
172.30.6.255,57336,103.243.221.17,80,6,340,4,228,2,112,2469.40213,41.6261,43.8186618492,21.5249566978
172.30.6.255,57338,172.217.166.206,443,17,1779,10,1150,7,629,2473.414317,63.03502,145.9506160227,79.8286412854
172.30.6.255,57337,172.217.166.206,443,40,6418,21,3848,19,2570,2473.414317,63.034612,488.3666135678,326.1700095814
172.30.6.255,57340,192.0.73.2,443,31,4644,16,2112,15,2532,2475.727667,180.732186,93.4863920696,112.0774359471
172.30.6.255,57339,13.228.141.18,443,29,9836,15,2863,14,6973,2475.813755,105.646035,216.7994283931,528.0273888178
172.30.6.255,57341,52.84.110.215,443,11,1405,7,958,4,447,2475.901263,35.517496,215.7809773527,100.6827733577
172.30.6.255,57342,13.228.208.99,443,20,7631,9,1141,11,6490,2476.03141,35.476734,257.2953868865,1463.4943566113
172.30.6.255,57343,13.228.208.99,443,6,340,4,228,2,112,2476.031449,34.894388,52.2720157751,25.6774814334
172.30.6.255,57344,104.16.2.35,443,126,69809,52,4168,74,65641,2476.438302,400.607356,83.2336189054,1310.8296493687
172.30.6.255,57345,104.16.2.35,443,16,5726,9,1120,7,4606,2476.438302,34.980276,256.1443483179,1053.3936324573
172.30.6.255,57346,104.16.2.35,443,17,5792,10,1186,7,4606,2476.43835,34.980051,271.2403135147,1053.4004081355
172.30.6.255,57347,157.240.16.20,443,39,16956,16,1956,23,15000,2476.555172,65.206725,239.9752479518,1840.3009812255
172.30.6.255,57349,157.240.16.39,443,19,1933,10,1125,9,808,2497.089119,61.022663,147.4861888607,105.9278583106
172.30.6.255,57350,157.240.16.39,443,28,5555,15,3409,13,2146,2497.08912,61.022746,446.9153190845,281.3377162673
172.30.6.255,57351,103.243.221.17,80,39,24304,22,20149,17,4155,2510.84005,17.190973,9376.5489597359,1933.572928071
172.30.6.255,57352,103.243.221.51,80,26,16743,10,4270,16,12473,2510.846306,17.184856,1987.7966972781,5806.5077763816
172.30.6.255,57353,103.243.221.51,80,16,5441,9,4215,7,1226,2510.849246,17.181917,1962.5283954055,570.8326957929
172.30.6.255,57354,103.243.221.51,80,20,9700,10,4270,10,5430,2510.854819,17.176343,1988.7818961231,2529.0598819551
172.30.6.255,57356,103.243.221.51,80,72,48237,43,40214,29,8023,2527.84649,34.200645,9406.6062204383,1876.6897524886
172.30.6.255,57357,103.243.221.17,80,31,18720,16,9346,15,9374,2527.857711,7.301084,10240.6711113039,10271.3514869851
172.30.6.255,57358,103.243.221.17,80,32,16180,15,8623,17,7557,2527.858087,34.189046,2017.7222845001,1768.2856667016
172.30.6.255,57359,103.243.221.17,80,28,14350,15,9557,13,4793,2527.858485,7.001793,10919.488765235,5476.3115676228
172.30.6.255,57360,172.217.166.194,80,20,1780,11,1091,9,689,2535.445965,257.473833,33.8985903861,21.4080007113
172.30.6.255,57362,157.240.16.39,443,19,1933,10,1125,9,808,2558.085077,61.064926,147.3841137546,105.8545457011
172.30.6.255,57361,157.240.16.39,443,28,5424,15,3275,13,2149,2558.085078,61.065058,429.050603702,281.5358007193
172.30.6.255,57364,103.243.221.51,80,100,71949,60,60105,40,11844,2580.845801,68.202416,7050.190128162,1389.2762977781
172.30.6.255,57365,103.243.221.17,80,60,38713,26,17658,34,21055,2580.861817,68.186026,2071.7441430008,2470.300879538
172.30.6.255,57366,103.243.221.17,80,31,15576,19,13225,12,2351,2580.86336,18.210707,5809.7689452693,1032.799001159
172.30.6.255,57367,103.243.221.17,80,59,40441,24,13747,35,26694,2580.864564,68.183654,1612.9379044426,3132.0116695418
172.30.6.255,57368,103.231.98.53,80,40,17472,21,15726,19,1746,2580.879211,68.277941,1842.5863193502,204.5755890618
172.30.6.255,57369,103.243.221.17,80,7,403,5,283,2,120,2599.067564,49.980842,45.297356135,19.2073594919
172.30.6.255,57370,52.213.19.114,443,14,1537,7,959,7,578,2599.538502,50.090667,153.1622647389,92.3126058593
172.30.6.255,57372,52.213.19.114,443,14,1537,7,959,7,578,2600.202538,49.42714,155.2183678845,93.5518421661
172.30.6.255,57374,157.240.16.39,443,27,5469,15,3413,12,2056,2619.091969,61.04567,447.2716901952,269.4376194086
172.30.6.255,57373,157.240.16.39,443,19,1933,10,1125,9,808,2619.091994,61.046751,147.4279933423,105.8860609961
172.30.6.255,57376,172.217.166.206,443,39,6836,22,4057,17,2779,2620.406634,80.025116,405.5726704601,277.8127806775
172.30.6.255,57375,172.217.166.206,443,18,1837,11,1208,7,629,2620.406634,80.031892,120.7518622701,62.8749349072
172.30.6.255,57377,184.85.113.82,443,23,9076,12,1128,11,7948,2634.846867,62.515362,144.3485202885,1017.09400643
172.30.6.255,57378,184.29.26.80,80,13,2580,7,617,6,1963,2634.846867,2.151635,2294.0693937404,7298.6356886749
172.30.6.255,57381,103.243.221.17,80,25,10884,14,8233,11,2651,2648.868966,16.193244,4067.375258472,1309.681988365
172.30.6.255,57382,103.243.221.17,80,32,16038,15,8540,17,7498,2648.871473,16.190737,4219.6967315324,3704.8344371229
172.30.6.255,57383,103.231.98.53,80,39,17419,22,15781,17,1638,2648.872467,61.888877,2039.9142159261,211.7343315181
172.30.6.255,57384,103.243.221.17,80,29,15669,15,8539,14,7130,2648.876147,16.185585,4220.5456274827,3524.1234715952
172.30.6.255,57385,103.243.221.75,80,70,49712,43,41800,27,7912,2648.904365,16.158778,20694.634210582,3917.1278917255
172.30.6.255,57386,103.243.221.75,80,40,28295,25,24254,15,4041,2664.836817,17.27679,11230.7899789256,1871.1809311799
172.30.6.255,57387,103.243.221.17,80,17,5936,9,4299,8,1637,2664.880087,17.23352,1995.6456951337,759.9143993798
172.30.6.255,57388,103.243.221.17,80,40,27130,16,8868,24,18262,2664.880443,17.233161,4116.7142812627,8477.6089540392
172.30.6.255,57389,103.243.221.17,80,24,13815,10,5275,14,8540,2664.880692,17.232914,2448.8023325597,3964.5065251298
172.30.6.255,57390,103.243.221.17,80,6,340,4,228,2,112,2665.09929,17.014592,107.2021004089,52.6606809026
172.30.6.255,57391,54.194.27.245,443,21,6576,11,1273,10,5303,2665.783577,45.185998,225.3795523118,938.8749143042
172.30.6.255,57392,103.243.221.75,80,6,340,4,228,2,112,2666.594944,15.519157,117.5321571913,57.7350947606
172.30.6.255,57393,157.240.16.39,443,19,1933,10,1125,9,808,2680.089244,61.049558,147.4212147449,105.8811924568
172.30.6.255,57394,157.240.16.39,443,27,5453,15,3397,12,2056,2680.089244,61.049369,445.147926099,269.4212941005
172.30.6.255,57395,192.168.56.1,7680,3,198,3,198,0,0,2680.376588,9.00481,175.905988022,0
172.30.6.255,57396,103.243.221.17,80,21,10669,10,4552,11,6117,2709.836207,12.197701,2985.4806245865,4011.9035546125
172.30.6.255,57397,103.243.221.17,80,27,17347,11,4606,16,12741,2709.837429,12.196479,3021.199806928,8357.1660312786
172.30.6.255,57398,103.243.221.17,80,15,5419,9,4245,6,1174,2709.839125,3.503953,9691.9108218635,2680.4012496744
172.30.6.255,57399,103.243.221.75,80,15,7864,10,6771,5,1093,2709.839654,12.194105,4442.1464305908,717.0677962835
172.30.6.255,57400,103.231.98.53,80,177,91060,89,82520,88,8540,2709.840001,339.267559,1945.838859294,201.3749861654
172.30.6.255,57401,103.243.221.75,80,94,70513,58,59706,36,10807,2711.26119,58.798053,8123.5342945795,1470.3888239293
172.30.6.255,57402,103.243.221.75,80,6,340,4,228,2,112,2711.555062,10.478995,174.0624935884,85.5043828153
172.30.6.255,57404,103.243.221.17,80,31,19016,15,9262,16,9754,2721.859573,48.199669,1537.2719675731,1618.9322793897
172.30.6.255,57405,103.243.221.17,80,28,12724,15,9263,13,3461,2721.862119,48.197122,1537.5191904612,574.4741356133
172.30.6.255,57406,103.243.221.17,80,29,15435,15,8341,14,7094,2721.864015,48.19494,1384.5436886113,1177.5510043171
172.30.6.255,57407,176.34.147.227,443,18,6378,9,1141,9,5237,2730.390781,40.434432,225.7481940144,1036.1466188025
172.30.6.255,57408,176.34.147.227,443,18,6378,9,1141,9,5237,2730.587126,40.222075,226.9400571701,1041.6170722172
172.30.6.255,57409,157.240.16.39,443,19,1933,10,1125,9,808,2741.096387,61.030067,147.4682962416,105.915007434
172.30.6.255,57410,157.240.16.39,443,28,5595,15,3417,13,2178,2741.096393,61.02977,447.9125515302,285.5000108963
172.30.6.255,57411,192.168.1.35,7680,3,198,3,198,0,0,2760.636711,9.005099,175.9003426836,0
172.30.6.255,57412,103.243.221.109,80,27,17433,10,4552,17,12881,2769.888377,23.142972,1573.5230548609,4452.6692595921
172.30.6.255,57413,103.243.221.109,80,21,11073,9,4498,12,6575,2769.888691,23.142257,1554.9045194684,2272.8984471999
172.30.6.255,57414,103.243.221.109,80,16,5471,9,4245,7,1226,2769.888982,23.141872,1467.4698745201,423.8205102854
172.30.6.255,57415,103.243.221.109,80,6,340,4,228,2,112,2770.102654,22.928347,79.5521805388,39.0782641243
172.30.6.255,57416,176.34.147.227,443,12,1416,6,904,6,512,2770.643907,23.02066,314.1525916286,177.9271315418
172.30.6.255,57417,103.243.221.17,80,31,18480,17,15289,14,3191,2770.894706,22.136241,5525.4187013956,1153.2219946467
172.30.6.255,57418,103.243.221.17,80,17,6271,9,5040,8,1231,2771.011107,22.01984,1831.0759751206,447.2330407487
172.30.6.255,57419,103.243.221.17,80,6,348,4,228,2,120,2771.108308,21.922766,83.2011799971,43.7900947353
172.30.6.255,57420,103.243.221.17,80,6,340,4,228,2,112,2771.247939,21.783182,83.7343231122,41.1326499499
172.30.6.255,57422,172.217.166.206,443,80,13681,39,8010,41,5671,2774.427154,145.749602,439.6581474027,311.2735772685
172.30.6.255,57421,172.217.166.206,443,17,1779,10,1150,7,629,2774.427154,145.746453,63.1233200577,34.5257115794
172.30.6.255,57423,172.217.166.206,443,17,1783,10,1154,7,629,2783.394245,136.779753,67.4953697277,36.7890706748
172.30.6.255,57424,103.243.221.17,80,53,36260,32,30284,21,5976,2792.840524,3.959635,61185.4375466471,12073.8401393067
172.30.6.255,57425,103.243.221.109,80,34,18941,16,9314,18,9627,2792.84597,37.228064,2001.500803265,2068.7618888804
172.30.6.255,57426,103.243.221.109,80,38,27803,18,9425,20,18378,2792.846787,37.227536,2025.3825018127,3949.3347075133
172.30.6.255,57427,103.243.221.109,80,28,15378,14,8287,14,7091,2792.848684,37.225637,1780.9231847396,1523.8960182199
172.30.6.255,57428,103.243.221.17,80,15,6166,9,5044,6,1122,2795.830265,3.683193,10955.7115252993,2437.0159261273
172.30.6.255,57429,52.213.19.114,443,19,6444,10,1207,9,5237,2796.640515,34.103537,283.1377871451,1228.4942761216
172.30.6.255,57430,103.243.221.17,80,30,18283,17,15168,13,3115,2796.72274,33.351583,3638.328051775,747.190920443
172.30.6.255,57431,52.213.19.114,443,18,6378,9,1141,9,5237,2796.745332,33.998507,268.4823777703,1232.2894061201
172.30.6.255,57432,103.243.221.17,80,6,348,4,228,2,120,2797.017162,33.057399,55.1767548318,29.0403972799
172.30.6.255,57433,192.168.240.1,7680,3,198,3,198,0,0,2800.763202,9.006765,175.8678060325,0
172.30.6.255,57434,157.240.16.39,443,28,5560,15,3415,13,2145,2802.091005,61.020317,447.7197324294,281.2178114381
172.30.6.255,57435,157.240.16.39,443,19,1933,10,1125,9,808,2802.091066,61.020047,147.4925117642,105.9323995604
172.30.6.255,57436,52.175.23.79,443,27,10548,12,2065,15,8483,2807.372747,128.374602,128.6858906873,528.6403925911
172.30.6.255,57437,103.243.221.17,80,40,24411,23,20263,17,4148,2829.847916,31.183488,5198.3921747305,1064.1529260614
172.30.6.255,57438,103.243.221.109,80,20,10614,10,4552,10,6062,2829.859094,31.171914,1168.2311198472,1555.7594570548
172.30.6.255,57439,103.243.221.109,80,16,5472,9,4245,7,1227,2829.862604,31.168094,1089.5757693749,314.9374485331
172.30.6.255,57440,103.243.221.109,80,17,6252,9,4498,8,1754,2829.864535,31.166472,1154.574056377,450.2274110461
172.30.6.255,57441,192.168.1.44,7680,3,198,3,198,0,0,2840.878417,9.009501,175.8143985999,0
172.30.6.255,57442,103.243.221.109,80,72,48247,43,40227,29,8020,2860.874953,30.154673,10672.1767468677,2127.6967586417
172.30.6.255,57443,103.243.221.17,80,29,12796,16,9329,13,3467,2860.893239,30.13566,2476.534444575,920.3714138001
172.30.6.255,57444,103.243.221.17,80,36,19036,17,9370,19,9666,2860.893616,30.135026,2487.4708918452,2566.0505486207
172.30.6.255,57445,103.243.221.17,80,29,15429,14,8287,15,7142,2860.893878,30.13502,2199.9653559214,1896.0000690227
172.30.6.255,57446,54.194.27.245,443,18,6378,9,1141,9,5237,2861.509934,30.336355,300.8931033409,1381.0492394357
172.30.6.255,57447,54.194.27.245,443,18,6378,9,1141,9,5237,2861.780665,30.065689,303.6018898486,1393.4821184374
172.30.6.255,57449,157.240.16.39,443,19,1933,10,1125,9,808,2863.086095,61.033251,147.4606030736,105.9094820297
172.30.6.255,57448,157.240.16.39,443,28,5421,15,3274,13,2147,2863.086107,61.033026,429.1447060154,281.4214061744
172.30.6.255,57450,172.30.10.168,7680,2,132,2,132,0,0,2881.010281,3.001441,351.8310038411,0
172.30.6.255,57451,103.243.221.109,80,40,24351,23,20203,17,4148,2890.840797,31.19154,5181.6614376847,1063.8782182605
172.30.6.255,57452,103.243.221.17,80,35,23435,14,4768,21,18667,2890.853,31.17895,1223.3894983635,4789.6417294361
172.30.6.255,57453,103.243.221.17,80,23,10808,11,4618,12,6190,2890.855399,31.176551,1184.9931700271,1588.3732616863
172.30.6.255,57454,103.243.221.17,80,16,5473,9,4245,7,1228,2890.857407,31.174931,1089.3368136084,315.1249957859
172.30.6.255,57455,54.194.27.245,443,45,13283,26,11001,19,2282,2891.655972,157.52918,558.6774462992,115.8896402559
172.30.6.255,57456,54.194.27.245,443,12,1416,6,904,6,512,2891.958306,35.720234,202.4622795024,114.6689016651
172.30.6.255,57457,52.229.173.178,443,29,10103,16,2254,13,7849,2895.863541,72.439219,248.9259305791,866.8232604772
172.30.6.255,57460,157.240.16.39,443,19,1933,10,1125,9,808,2924.091806,61.024753,147.4811376951,105.9242304512
172.30.6.255,57459,157.240.16.39,443,27,5476,15,3419,12,2057,2924.091817,61.02468,448.2121004158,269.6613894575
172.30.6.255,57461,103.243.221.109,80,72,48153,44,40185,28,7968,2926.841048,24.189593,13290.0127753286,2635.1828242832
172.30.6.255,57462,103.243.221.17,80,42,27824,17,9371,25,18453,2926.844998,24.184291,3099.8634609549,6104.1276752748
172.30.6.255,57463,103.243.221.17,80,33,18687,16,9316,17,9371,2926.845305,24.184423,3081.6530127678,3099.8465417182
172.30.6.255,57464,103.243.221.17,80,24,10877,14,8287,10,2590,2926.847236,24.182196,2741.5210760843,856.8287181197
172.30.6.255,57465,103.243.221.109,80,40,24414,24,20321,16,4093,2950.839781,41.191278,3946.6607469669,794.9255665241
172.30.6.255,57466,103.243.221.17,80,17,5526,9,4245,8,1281,2950.850176,41.180882,824.6545083711,248.8533392752
172.30.6.255,57467,103.243.221.17,80,21,10671,10,4552,11,6119,2950.857008,41.174481,884.4313058858,1188.8917312643
172.30.6.255,57468,103.243.221.17,80,18,6306,9,4498,9,1808,2950.859944,41.171892,873.9943260319,351.3076348301
172.30.6.255,57470,157.240.16.39,443,18,1879,9,1071,9,808,2985.090317,61.036154,140.3758172574,105.9044447656
172.30.6.255,57471,157.240.16.39,443,28,5559,15,3411,13,2148,2985.090318,61.035925,447.0809609259,281.5391099586
172.30.6.255,57472,103.243.221.109,80,39,24310,23,20217,16,4093,2991.844023,14.18355,11403.0690482991,2308.5898805307
172.30.6.255,57473,103.243.220.231,80,24,14163,10,5275,14,8888,2991.852701,14.174872,2977.0991935589,5016.2004990239
172.30.6.255,57474,103.243.220.231,80,19,7314,10,5273,9,2041,2991.85633,14.169983,2976.9972201096,1152.2949604104
172.30.6.255,57475,103.243.220.231,80,16,5527,9,4299,7,1228,2991.857919,14.169654,2427.1587718374,693.3126242885
172.30.6.255,57477,103.243.221.109,80,71,48311,42,40281,29,8030,3005.835945,36.193487,8903.4803416427,1774.9049711624
172.30.6.255,57478,103.243.220.231,80,26,11298,14,8484,12,2814,3005.840894,36.187937,1875.5421178057,622.0857519455
172.30.6.255,57479,103.243.220.231,80,30,16073,15,8540,15,7533,3005.843044,36.186387,1888.0028006112,1665.3776460192
172.30.6.255,57480,103.243.220.231,80,31,15749,15,8287,16,7462,3005.845896,36.182735,1832.2550796671,1649.8476414235
172.30.6.255,57481,172.217.166.206,443,17,1783,10,1154,7,629,3013.409602,62.050484,148.7820787989,81.0952578549
172.30.6.255,57482,172.217.166.206,443,30,4596,17,3265,13,1331,3013.409602,62.049915,420.9514227376,171.6037806015
172.30.6.255,57483,52.229.174.172,443,27,10013,14,2164,13,7849,3019.7049,123.863187,139.7671125643,506.9464263018
172.30.6.255,57486,157.240.16.39,443,18,1879,9,1071,9,808,3046.097254,61.011389,140.4327968996,105.9474322081
172.30.6.255,57487,157.240.16.39,443,27,5330,15,3275,12,2055,3046.097289,61.01128,429.4287875947,269.4583690098
172.30.6.255,57489,74.125.68.188,5228,96,7000,51,3654,45,3346,3052.028371,1822.386307,16.0405068276,14.6884334552
172.30.6.255,57490,161.69.226.18,443,36,8680,21,4945,15,3735,3052.048865,332.692191,118.9087122276,89.812748265
172.30.6.255,57488,172.217.163.133,443,464,158973,208,41800,256,117173,3052.445091,1721.453,194.2545047701,544.5306958715
172.30.6.255,57491,172.217.163.133,443,7,402,4,228,3,174,3052.445126,20.433916,89.2633599942,68.1220378903
172.30.6.255,57492,35.190.43.164,80,234,69917,119,51811,115,18106,3057.839497,1227.065607,337.7879696371,118.0442179894
172.30.6.255,57493,103.243.221.51,80,40,24324,23,20179,17,4145,3057.842745,15.186775,10629.7749192965,2183.4787175026
172.30.6.255,57495,103.243.221.109,80,17,5580,9,4299,8,1281,3057.851141,15.178379,2265.854608058,675.1709125197
172.30.6.255,57496,103.243.221.109,80,24,13737,11,5329,13,8408,3057.8515,15.17802,2808.798512586,4431.6715882573
172.30.6.255,57497,103.243.221.109,80,40,29114,15,5545,25,23569,3057.851871,15.177468,2922.7536503453,12423.152531107
172.30.6.255,57498,103.231.98.53,80,39,17419,20,15673,19,1746,3057.857839,65.06891,1926.9417606657,214.6647300531
172.30.6.255,57499,173.241.248.220,80,240,122632,123,62121,117,60511,3057.858278,1182.07298,420.4207425501,409.5246301967
172.30.6.255,57500,35.190.43.164,80,137,38509,70,28241,67,10268,3057.874604,852.994008,264.8646976193,96.3007937097
172.30.6.255,57494,210.176.156.62,80,31,14703,16,11386,15,3317,3057.937735,19.151793,4756.1082139933,1385.5621768677
172.30.6.255,57501,180.149.59.210,80,488,344632,311,254334,177,90298,3058.100425,1715.759051,1185.8728058664,421.0288149603
172.30.6.255,57502,180.149.59.210,80,7,402,4,228,3,174,3058.10143,14.741155,123.7352161347,94.4295070502
172.30.6.255,57503,54.194.27.245,443,28,9147,15,3538,13,5609,3059.194744,130.223845,217.3488273211,344.5759108096
172.30.6.255,57504,54.194.27.245,443,467,176961,275,147766,192,29195,3059.195037,1714.833523,689.3543799703,136.1998099917
172.30.6.255,57505,54.194.27.245,443,282,111726,169,92713,113,19013,3059.422321,983.291929,754.3070151652,154.68854723
172.30.6.255,57506,54.194.27.245,443,6,348,4,228,2,120,3059.618772,13.3845,136.277036871,71.7247562479
172.30.6.255,57507,161.69.38.37,80,7,398,4,228,3,170,3067.299885,0.606136,3009.2256523295,2243.7208811228
172.30.6.255,57508,161.69.38.37,80,7,398,4,228,3,170,3067.73794,0.547604,3330.8741353249,2483.5465044089
172.30.6.255,57510,172.217.163.133,443,17,1779,10,1150,7,629,3069.436786,70.733016,130.0665590168,71.1407527144
172.30.6.255,57509,172.217.163.133,443,31,8359,17,5543,14,2816,3069.436787,70.732834,626.9224275674,318.4942370611
172.30.6.255,57511,103.243.221.51,80,71,48184,42,40162,29,8022,3072.837259,50.191998,6401.3391138563,1278.6101880224
172.30.6.255,57512,103.243.221.109,80,24,10468,14,8232,10,2236,3072.840534,50.188437,1312.1747545157,356.4167579078
172.30.6.255,57513,103.243.221.109,80,44,31168,17,8646,27,22522,3072.8418,50.187456,1378.1929891007,3590.0604326308
172.30.6.255,57514,103.243.221.109,80,40,26854,16,8594,24,18260,3072.844531,50.184948,1369.9725264237,2910.8329453684
172.30.6.255,57516,172.217.166.206,443,17,1779,10,1150,7,629,3075.421418,64.749199,142.0866997907,77.7152471029
172.30.6.255,57515,172.217.166.206,443,42,6737,23,3958,19,2779,3075.421418,64.754148,488.9879795809,343.329357063
172.30.6.255,57517,157.240.16.16,443,317,63433,139,18178,178,45255,3079.972018,1819.265164,79.9355711733,199.003425759
172.30.6.255,57519,157.240.16.39,443,27,5454,15,3399,12,2055,3107.082257,61.046177,445.4332987961,269.304333341
172.30.6.255,57520,157.240.16.39,443,19,1933,10,1125,9,808,3107.082258,61.046981,147.4274378941,105.8856620608
172.30.6.255,57522,103.243.221.17,80,72,48342,43,40320,29,8022,3122.844488,25.191008,12804.5689954131,2547.5757063791
172.30.6.255,57523,210.176.156.62,80,14,5521,7,3905,7,1616,3122.851095,3.378406,9246.9643968196,3826.6567132549
172.30.6.255,57524,103.243.220.231,80,23,13656,11,5329,12,8327,3122.85527,10.911839,3906.949140287,6104.9287842316
172.30.6.255,57525,103.243.220.231,80,17,5581,9,4299,8,1282,3122.855776,10.743196,3201.2820021156,954.6507389421
172.30.6.255,57526,103.243.220.231,80,29,18146,12,5383,17,12763,3122.85617,10.910597,3946.9884186906,9358.2413501296
172.30.6.255,57527,103.231.98.53,80,159,80988,80,73406,79,7582,3122.882639,308.077851,1906.1675420477,196.8852996186
172.30.6.255,57528,104.25.219.21,443,16,6376,8,1037,8,5339,3133.674722,0.261035,31781.1787691315,163625.567452645
172.30.6.255,57529,104.25.219.21,443,6,348,4,228,2,120,3133.674761,14.252202,127.9802236875,67.3580124671
172.30.6.255,57530,104.25.219.21,443,134,48751,63,5529,71,43222,3133.674763,402.388473,109.9236259683,859.3089096764
172.30.6.255,57531,103.243.220.231,80,17,5527,9,4245,8,1282,3133.846314,14.188761,2393.4436558626,722.8256223359
172.30.6.255,57532,103.243.220.231,80,22,11002,10,4552,12,6450,3133.852901,14.181885,2567.7827735876,3638.4443957908
172.30.6.255,57533,103.243.220.231,80,32,23162,12,4660,20,18502,3133.855428,14.180068,2629.0423995146,10438.3138360125
172.30.6.255,57534,210.176.156.62,80,14,5504,7,3896,7,1608,3133.859729,3.347926,9309.6442394475,3842.3788339404
172.30.6.255,57535,216.58.221.40,443,16,5184,8,1219,8,3965,3135.525947,12.942095,753.5101542679,2450.9169496902
172.30.6.255,57536,103.243.221.17,80,40,24305,23,20151,17,4154,3147.84644,14.184919,11364.7458966806,2342.76981067
172.30.6.255,57537,103.243.220.231,80,17,5504,9,4215,8,1289,3147.855175,14.176183,2378.6374653883,727.4172462362
172.30.6.255,57538,103.243.220.231,80,21,10357,9,4216,12,6141,3147.860195,14.170827,2380.1010343292,3466.8407143775
172.30.6.255,57539,103.243.220.231,80,17,5853,9,4216,8,1637,3147.861532,14.169828,2380.2688360085,924.2172876057
172.30.6.255,57540,210.176.156.62,80,38,19764,19,15036,19,4728,3147.862368,71.231967,1688.6800276062,530.9975505801
172.30.6.255,57543,157.240.16.39,443,19,1933,10,1125,9,808,3168.091662,61.031358,147.4651768358,105.9127670074
172.30.6.255,57542,157.240.16.39,443,27,5452,15,3397,12,2055,3168.091663,61.03125,445.2800819252,269.3701996928
172.30.6.255,57544,103.243.220.231,80,35,19782,15,9545,20,10237,3188.843581,30.183849,2529.8297775078,2713.2391233471
172.30.6.255,57545,103.243.221.17,80,69,48087,42,40174,27,7913,3188.843866,30.1839,10647.7956791535,2097.2770251691
172.30.6.255,57546,103.243.220.231,80,28,12752,15,9292,13,3460,3188.844488,30.183276,2462.8208018242,917.0641384322
172.30.6.255,57547,103.243.220.231,80,29,16160,14,8569,15,7591,3188.846607,30.180532,2271.3979992136,2012.1580361804
172.30.6.255,57550,162.125.32.135,443,17,5289,9,1579,8,3710,3216.376664,1.768153,7144.1781339059,16785.8776927111
172.30.6.255,57551,103.243.221.17,80,39,24244,23,20150,16,4094,3218.837089,35.194013,4580.3245000791,930.6128289491
172.30.6.255,57552,103.243.220.231,80,16,5443,9,4215,7,1228,3218.844454,35.187736,958.2884218524,279.1881807912
172.30.6.255,57553,103.243.220.231,80,20,10309,10,4270,10,6039,3218.852251,35.178849,971.0380234441,1373.3252045853
172.30.6.255,57554,103.243.220.231,80,22,13002,9,4216,13,8786,3218.853835,35.176958,958.8094570315,1998.1261597436
172.30.6.255,57555,157.240.16.39,443,21,2091,11,1191,10,900,3229.098277,61.031429,156.1162855944,117.9720042275
172.30.6.255,57556,157.240.16.39,443,28,5608,14,3365,14,2243,3229.098282,61.031133,441.0863550575,294.0138764915
172.30.6.255,57558,172.30.16.59,7680,3,198,3,198,0,0,3242.15245,9.001721,175.9663513233,0
172.30.6.255,57559,52.175.23.79,443,29,10142,15,2238,14,7904,3245.949285,63.588622,281.5598048343,994.3917325335
172.30.6.255,57560,103.243.221.51,80,70,48828,41,40784,29,8044,3253.844985,28.222954,11560.5191433895,2280.1298545858
172.30.6.255,57561,103.243.221.17,80,62,52593,22,11151,40,41442,3253.845939,28.222002,3160.9380510993,11747.4302496329
172.30.6.255,57562,103.243.221.17,80,44,29588,19,10989,25,18599,3253.846241,28.221697,3115.0500978024,5272.2555982371
172.30.6.255,57563,103.243.221.17,80,23,10805,14,8623,9,2182,3253.846558,28.221382,2444.3877340947,618.5380999414
172.30.6.255,57564,210.176.156.62,80,14,5521,7,3905,7,1616,3253.848602,6.702701,4660.8076356083,1928.7746835193
172.30.6.255,57565,210.176.156.62,80,38,16301,20,11617,18,4684,3254.845788,263.646205,352.5027033862,142.1298668039
172.30.6.255,57566,210.176.156.62,80,95,58460,49,42583,46,15877,3254.84782,248.42341,1371.3039362917,511.2883685157
172.30.6.255,57567,176.34.147.227,443,69,23135,39,15384,30,7751,3255.389212,317.482511,387.6496995452,195.3115458382
172.30.6.255,57568,176.34.147.227,443,12,1416,6,904,6,512,3255.891837,33.802464,213.9489002932,121.1745983961
172.30.6.255,57569,103.243.221.51,80,16,6244,9,5068,7,1176,3256.278467,25.789472,1572.114388383,364.8000238237
172.30.6.255,57570,103.243.221.51,80,15,6198,9,5076,6,1122,3256.286951,25.780335,1575.1540854686,348.1723569535
172.30.6.255,57571,103.243.221.51,80,25,12627,14,10416,11,2211,3256.311077,25.756452,3235.2282061209,686.7405495136
172.30.6.255,57572,103.243.221.51,80,6,340,4,228,2,112,3256.656462,25.411659,71.7780763546,35.2594059286
172.30.6.255,57573,192.168.56.1,7680,3,198,3,198,0,0,3282.271467,9.004297,175.9160098784,0
172.30.6.255,57575,103.243.221.51,80,40,24299,24,20205,16,4094,3288.844119,27.380022,5903.5745113718,1196.2006458578
172.30.6.255,57576,103.243.221.17,80,21,10387,10,4270,11,6117,3288.853173,27.53903,1240.4213220291,1776.968905586
172.30.6.255,57577,103.243.221.17,80,17,5853,10,4270,7,1583,3288.858884,27.539798,1240.3867305054,459.8436052436
172.30.6.255,57578,103.243.221.17,80,17,5858,10,4269,7,1589,3288.863884,27.538616,1240.1494686588,461.6063494258
172.30.6.255,57579,157.240.16.39,443,28,5557,15,3411,13,2146,3290.100274,61.065031,446.867864523,281.1429015732
172.30.6.255,57580,157.240.16.39,443,19,1933,10,1125,9,808,3290.100343,61.064466,147.3852240025,105.8553431058
172.30.6.255,57581,103.243.221.17,80,72,48453,34,10739,38,37714,3315.858718,44.210185,1943.2626214978,6824.4907819318
172.30.6.255,57582,103.243.221.17,80,16,6180,9,4498,7,1682,3315.859955,3.600305,9994.7087816173,3737.4611317653
172.30.6.255,57583,103.243.221.17,80,24,10551,14,8316,10,2235,3315.861027,44.208063,1504.8838489033,404.4511065775
172.30.6.255,57584,103.243.221.51,80,73,49828,43,41736,30,8092,3315.862332,44.206758,7552.8723458979,1464.3914851209
172.30.6.255,57585,103.243.221.17,80,24,13685,11,5329,13,8356,3319.868256,40.199848,1060.5015222943,1662.8918596906
172.30.6.255,57588,172.217.163.133,443,933,695018,462,33358,471,661660,3325.439599,103.038126,2589.9539360799,51372.0523216812
172.30.6.255,57589,172.217.163.133,443,17,1791,10,1162,7,629,3325.439602,103.048627,90.2098385066,48.8313153362
172.30.6.255,57591,172.217.166.206,443,54,10247,29,6199,25,4048,3340.411304,129.794152,382.0819292382,249.5027665037
172.30.6.255,57590,172.217.166.206,443,17,1783,10,1154,7,629,3340.411305,88.067999,104.8280885773,57.1376669975
172.30.6.255,57593,157.240.16.39,443,5,330,1,66,4,264,3351.100428,15.057071,35.0665810103,140.2663240414
172.30.6.255,57592,157.240.16.39,443,5,330,1,66,4,264,3351.100432,15.057906,35.0646364773,140.2585459094
172.30.6.255,57595,157.240.16.39,443,29,5597,16,3451,13,2146,3351.45208,60.674777,455.0160934254,282.9511841469
172.30.6.255,57594,157.240.16.39,443,19,1933,10,1125,9,808,3351.45208,60.675074,148.3310922703,106.534686715
172.30.6.255,57596,103.243.221.51,80,39,24251,23,20150,16,4101,3359.833855,16.205832,9947.0363508643,2024.4563808881
172.30.6.255,57597,103.243.221.17,80,17,5496,9,4215,8,1281,3359.836544,16.199901,2081.4942017238,632.5964584598
172.30.6.255,57598,103.243.221.17,80,20,10313,10,4270,10,6043,3359.838844,16.197746,2108.9354037284,2984.6127973608
172.30.6.255,57599,103.243.221.17,80,26,16648,11,4324,15,12324,3359.840558,16.196161,2135.8147773413,6087.3684819506
172.30.6.255,57600,172.217.166.226,80,37,19037,16,1328,21,17709,3362.336111,255.555339,41.572209141,554.3691654198
172.30.6.255,57601,192.168.1.35,7680,3,198,3,198,0,0,3362.504667,9.003018,175.9410011176,0
172.30.6.255,57602,161.69.226.18,443,19,5301,11,2412,8,2889,3366.080509,138.871145,138.9489515623,166.4276621324
172.30.6.255,57603,103.243.221.51,80,77,57357,47,49274,30,8083,3375.847808,26.216064,15036.276994136,2466.5792698706
172.30.6.255,57604,103.243.221.17,80,40,24161,20,13363,20,10798,3375.857801,26.205382,4079.4673399533,3296.4220861196
172.30.6.255,57605,103.243.221.87,80,14,6072,8,4444,6,1628,3375.88606,3.63264,9786.8217054256,3585.2713178292
172.30.6.255,57606,103.243.221.87,80,66,49219,25,13354,41,35865,3375.88673,26.176736,4081.1810914852,10960.8776281352
172.30.6.255,57607,172.217.166.206,443,24,3159,13,1864,11,1295,3376.41408,93.792835,158.9886903408,110.4561984932
172.30.6.255,57608,172.217.166.206,443,17,1779,10,1150,7,629,3376.414131,93.792501,98.0888653348,53.6503446048
172.30.6.255,57609,103.243.221.87,80,6,340,4,228,2,112,3385.840195,16.22385,112.4270749545,55.2273350654
172.30.6.255,57610,103.243.221.87,80,7,394,4,228,3,166,3386.760862,15.303421,119.1890362292,86.7779825178
172.30.6.255,57611,192.168.240.1,7680,2,132,2,132,0,0,3402.631419,3.003445,351.5962503059,0
172.30.6.255,57614,52.229.174.233,443,30,10338,17,2291,13,8047,3408.568983,102.032823,179.6284711244,630.9342239801
172.30.6.255,57615,52.229.174.29,443,29,10110,16,2260,13,7850,3408.575135,107.875619,167.6004287864,582.1519318466
172.30.6.255,57616,52.229.172.155,443,32,11643,17,2305,15,9338,3408.581888,104.632791,176.2353830359,713.9635604292
172.30.6.255,57617,52.229.173.178,443,33,10999,19,2675,14,8324,3408.588191,101.888037,210.034471466,653.5801646664
172.30.6.255,57618,157.240.16.39,443,19,1933,10,1125,9,808,3412.09773,61.060913,147.3938000239,105.861502595
172.30.6.255,57619,157.240.16.39,443,28,5560,15,3413,13,2147,3412.097767,61.060942,447.1598227227,281.2927452053
172.30.6.255,57620,103.243.221.87,80,71,48209,42,40186,29,8023,3430.836292,20.232961,15889.3204014972,3172.2494794509
172.30.6.255,57621,103.243.221.87,80,43,32866,17,8648,26,24218,3430.841298,20.227956,3420.2170501063,9578.0315124276
172.30.6.255,57622,103.243.221.87,80,35,21829,16,8341,19,13488,3430.844847,20.223917,3299.4597436293,5335.4649349084
172.30.6.255,57623,103.243.221.87,80,28,15615,14,8485,14,7130,3430.845818,20.222569,3356.6457357619,2820.6109718305
172.30.6.255,57624,103.231.98.53,80,14,5617,8,5045,6,572,3431.943056,0.381522,105786.822253988,11994.0658729993
172.30.6.255,57625,103.231.98.53,80,29,12042,15,10802,14,1240,3436.84643,60.120211,1437.3868381799,165.0027475785
172.30.6.255,57626,172.30.13.95,7680,3,198,3,198,0,0,3448.674842,8.98112,176.3699850353,0
172.30.6.255,57628,103.243.221.75,80,46,29377,26,25067,20,4310,3450.886547,46.181949,4342.3026602884,746.6120583174
172.30.6.255,57629,103.243.221.46,80,16,5881,9,4299,7,1582,3450.904228,46.164268,744.9917758904,274.1514281132
172.30.6.255,57630,103.243.221.46,80,42,33531,13,5437,29,28094,3450.904604,46.164269,942.2005577517,4868.5272152798
172.30.6.255,57631,103.243.221.46,80,25,13978,10,5275,15,8703,3450.90493,46.163155,914.1489571066,1508.2158054405
172.30.6.255,57632,103.243.221.75,80,8,449,5,283,3,166,3451.094232,45.97473,49.2444436324,28.8854333674
172.30.6.255,57633,103.243.221.46,80,8,449,5,283,3,166,3451.117067,45.951513,49.2693243855,28.9000277314
172.30.6.255,57634,157.240.16.39,443,24,5318,14,3369,10,1949,3473.096618,61.054008,441.4452201074,255.3804493884
172.30.6.255,57635,157.240.16.39,443,20,2037,11,1229,9,808,3473.09662,61.053937,161.0379360139,105.8735982906
172.30.6.255,57636,172.30.13.95,7680,3,198,3,198,0,0,3488.797569,9.002521,175.9507142499,0
172.30.6.255,57638,103.243.221.75,80,71,48123,42,40102,29,8021,3496.839664,20.231125,15857.546231364,3171.7465044579
172.30.6.255,57639,103.243.221.46,80,26,11295,14,8233,12,3062,3496.84767,20.223117,3256.8668815989,1211.2870632158
172.30.6.255,57640,103.243.221.46,80,25,19666,9,4498,16,15168,3496.850974,1.418391,25369.591318611,85550.4582304785
172.30.6.255,57641,103.243.221.46,80,36,20690,16,8593,20,12097,3496.853159,20.217319,3400.2530206898,4786.7870116705
172.30.6.255,57642,103.231.98.53,80,175,90952,89,82520,86,8432,3496.862305,348.106191,1896.4328043221,193.7799491765
172.30.6.255,57643,103.243.221.46,80,16,5442,9,4214,7,1228,3500.864458,16.206331,2080.1747169054,606.1828553298
172.30.6.255,57644,103.243.221.75,80,7,406,5,294,2,112,3516.838076,40.224252,58.4721873759,22.2751190003
172.30.6.255,57645,103.243.221.46,80,40,29211,16,5623,24,23588,3516.843752,1.640252,27425.0541989941,115045.736874599
172.30.6.255,57646,103.243.221.46,80,3,198,3,198,0,0,3516.847249,9.004684,175.9084494248,0
172.30.6.255,57647,103.243.221.46,80,25,14205,11,5329,14,8876,3516.848187,40.213737,1060.1352468188,1765.7647683925
172.30.6.255,57648,103.243.221.75,80,16,9381,11,8289,5,1092,3517.091858,39.969547,1659.0630862041,218.5664000645
172.30.6.255,57649,103.243.221.46,80,14,6798,10,5733,4,1065,3517.099466,3.533494,12979.7871455287,2411.2111128533
172.30.6.255,57650,103.243.221.75,80,30,18104,17,14992,13,3112,3518.563508,38.498417,3115.3488726563,646.6759399484
172.30.6.255,57651,103.243.221.75,80,6,340,4,228,2,112,3518.858946,38.203267,47.7446078106,23.4534915561
172.30.6.255,57652,172.217.166.206,443,18,1883,11,1242,7,641,3521.412767,106.010516,93.7265506754,48.3725595676
172.30.6.255,57653,172.217.166.206,443,42,6495,22,4050,20,2445,3521.412768,106.048884,305.5194809971,184.4432422316
172.30.6.255,57654,172.30.13.95,7680,3,198,3,198,0,0,3528.955031,9.004542,175.9112234692,0
172.30.6.255,57656,157.240.16.39,443,28,5420,15,3275,13,2145,3534.090467,61.070501,429.0123639235,280.9867238522
172.30.6.255,57657,157.240.16.39,443,19,1933,10,1125,9,808,3534.09047,61.070603,147.3704132248,105.8447056762
172.30.6.255,57658,103.243.221.51,80,7,406,5,294,2,112,3537.855201,19.20689,122.456056134,46.6499261463
172.30.6.255,57659,103.243.221.75,80,40,24302,23,20155,17,4147,3556.834541,15.21782,10595.4729389625,2180.0757270096
172.30.6.255,57660,103.243.221.46,80,27,17449,11,4606,16,12843,3556.838164,15.214351,2421.9238796318,6753.0977824818
172.30.6.255,57661,103.243.221.46,80,16,5480,9,4245,7,1235,3556.839078,15.212298,2232.4043349664,649.4745238359
172.30.6.255,57662,103.243.221.46,80,22,10726,10,4552,12,6174,3556.841342,15.210035,2394.2088233197,3247.3298056186
172.30.6.255,57663,210.176.156.21,80,60,36423,30,27545,30,8878,3556.890893,122.653333,1796.6083318747,579.0629431978
172.30.6.255,57664,172.30.13.95,7680,3,198,3,198,0,0,3569.073867,9.004597,175.910149005,0
172.30.6.255,57666,103.243.221.75,80,63,45359,38,39157,25,6202,3571.833728,46.208234,6779.224672382,1073.7480250814
172.30.6.255,57667,103.243.221.46,80,21,9754,11,4324,10,5430,3571.837029,11.628314,2974.8078698253,3735.7092352339
172.30.6.255,57668,103.243.221.46,80,30,17154,14,4486,16,12668,3571.83776,12.710502,2823.4919439059,7973.2492076238
172.30.6.255,57669,103.243.221.46,80,40,23722,21,13236,19,10486,3571.840249,46.201394,2291.8788987189,1815.7027902665
172.30.6.255,57670,103.243.221.75,80,6,340,4,228,2,112,3573.194211,11.265728,161.9069801792,79.5332534214
172.30.6.255,57671,103.243.220.231,80,16,5526,9,4299,7,1227,3582.905859,35.136102,978.8222950856,279.3707736846
172.30.6.255,57672,103.243.220.231,80,39,33912,13,5437,26,28475,3582.906189,0.896324,48527.0951129129,254149.169273532
172.30.6.255,57673,103.243.221.75,80,22,12384,13,10282,9,2102,3584.660149,33.384076,2463.9292098424,503.7132074585
172.30.6.255,57675,157.240.16.39,443,19,1945,10,1137,9,808,3595.097401,61.017903,149.0710029809,105.9361217314
172.30.6.255,57674,157.240.16.39,443,27,5352,15,3298,12,2054,3595.09741,61.017964,432.3972527172,269.2977432023
172.30.6.255,62078,172.30.13.95,50872,3,198,0,0,3,198,3607.843744,8.98329,0,176.327381171
172.30.6.255,57676,172.30.13.95,7680,3,198,3,198,0,0,3609.18563,9.004055,175.9207379342,0
172.30.6.255,57677,103.243.221.75,80,39,24257,23,20155,16,4102,3617.858815,24.170308,6670.9948421014,1357.6988758273
172.30.6.255,57678,103.243.220.231,80,22,10723,11,4606,11,6117,3617.864903,24.164219,1524.8992735913,2025.1430431085
172.30.6.255,57679,103.243.220.231,80,14,6072,9,4498,5,1574,3617.866299,3.556403,10118.0884168638,3540.656106746
172.30.6.255,57680,103.243.220.231,80,16,5481,9,4245,7,1236,3617.87133,24.157405,1405.7801324273,409.3154873216
172.30.6.255,57681,157.240.16.39,443,30,5781,15,2415,15,3366,3624.876535,65.233694,296.1659660114,412.7928122544
172.30.6.255,57682,103.243.221.75,80,77,53081,45,44898,32,8183,3641.837804,37.18334,9659.810011688,1760.5734180953
172.30.6.255,57683,103.243.220.231,80,52,37631,20,9533,32,28098,3641.844033,37.17711,2051.3697810292,6046.3010707395
172.30.6.255,57684,103.243.220.231,80,32,19003,16,9315,16,9688,3641.852507,37.168171,2004.9412708524,2085.2250168565
172.30.6.255,57685,103.243.220.231,80,34,22038,16,8395,18,13643,3641.854056,37.167088,1806.9750312427,2936.5765754907
172.30.6.255,57686,35.190.43.164,80,97,25061,50,18145,47,6916,3641.91273,642.993017,225.7567285525,86.0475907781
172.30.6.255,57688,157.240.16.39,443,19,1933,10,1125,9,808,3656.088364,61.033851,147.4591534458,105.9084408749
172.30.6.255,57689,157.240.16.39,443,29,5612,15,3411,14,2201,3656.088364,61.033649,447.0976329795,288.4965963611
172.30.6.255,57690,13.67.76.139,443,21,8738,13,1085,8,7653,3662.042487,109.962545,78.9359686064,556.7713988431
172.30.6.255,57691,13.67.76.139,443,24,9649,14,1578,10,8071,3662.042535,0.338552,37288.2156950599,190718.117157686
172.30.6.255,57692,172.217.166.206,443,46,7685,25,4587,21,3098,3663.409736,136.799083,268.2474121555,181.1708050704
172.30.6.255,57693,172.217.166.206,443,17,1779,10,1150,7,629,3663.409737,136.798771,67.2520661754,36.783956195
172.30.6.255,57695,172.217.163.133,443,30,8084,16,5473,14,2611,3670.409925,129.798969,337.3216315763,160.9257774613
172.30.6.255,57694,172.217.163.133,443,19,1899,11,1204,8,695,3670.40996,130.093044,74.0393160452,42.7386417371
172.30.6.255,57696,172.217.166.202,443,17,1793,10,1164,7,629,3671.450221,128.758637,72.3213620225,39.080873464
172.30.6.255,57697,172.217.166.202,443,38,6680,21,4144,17,2536,3671.450286,128.758478,257.4743078277,157.5663235162
172.30.6.255,57698,103.243.221.87,80,40,24311,23,20155,17,4156,3678.860034,34.187535,4716.3388644428,972.5181999814
172.30.6.255,57699,103.243.221.87,80,33,23543,13,4714,20,18829,3678.864924,34.182645,1103.2499094204,4406.6806415946
172.30.6.255,57700,103.243.221.87,80,15,5419,9,4245,6,1174,3678.865235,34.182332,993.495704155,274.7618272504
172.30.6.255,57701,103.243.221.87,80,20,10618,10,4552,10,6066,3678.865498,34.18207,1065.3538536432,1419.6916687609
172.30.6.255,57702,210.176.156.21,80,11,615,10,553,1,62,3679.546372,90.101929,49.0999476826,5.5048765937
172.30.6.255,57703,210.176.156.21,80,11,615,10,553,1,62,3679.795281,81.474764,54.2990219646,6.0877746145
172.30.6.255,57704,172.30.13.95,7680,3,198,3,198,0,0,3689.442527,9.005356,175.8953227391,0
172.30.6.255,57705,103.243.221.87,80,25,14081,15,11902,10,2179,3712.832889,26.220008,3631.4252840807,664.8358002026
172.30.6.255,57706,103.243.221.87,80,45,28837,23,13508,22,15329,3712.839646,26.214186,4122.3481057165,4678.077740045
172.30.6.255,57707,103.243.221.87,80,26,16186,11,4324,15,11862,3712.841012,1.427242,24236.954910236,66489.0747329369
172.30.6.255,57708,103.243.221.87,80,54,39333,22,9640,32,29693,3712.8435,26.210332,2942.3511308441,9062.9908846633
172.30.6.255,57709,210.176.156.21,80,3,198,3,198,0,0,3712.849264,9.007107,175.861128329,0
172.30.6.255,57710,210.176.156.21,80,14,4317,7,3880,7,437,3713.099851,1.001246,31001.3722901183,3491.6494048407
172.30.6.255,57711,210.176.156.21,80,14,4342,7,3905,7,437,3713.847524,0.928219,33655.8506128275,3766.3525525751
172.30.6.255,57712,103.243.221.87,80,7,406,5,294,2,112,3713.849413,25.204255,93.3175767346,35.5495530417
172.30.6.255,57713,103.243.221.87,80,46,30146,27,25086,19,5060,3714.224186,24.829647,8082.5957775396,1630.3091219944
172.30.6.255,57714,176.34.147.227,443,18,6378,9,1141,9,5237,3714.501568,25.47167,358.3589140406,1644.8077413063
172.30.6.255,57715,103.243.221.87,80,16,6241,9,5064,7,1177,3714.594991,24.458626,1656.3481529993,384.9766540443
172.30.6.255,57716,103.243.221.87,80,6,340,4,228,2,112,3714.705763,24.347043,74.9166952225,36.8011836181
172.30.6.255,57717,161.69.226.18,443,25,6472,14,3219,11,3253,3716.860703,269.715169,95.4785008773,96.486972151
172.30.6.255,57718,157.240.16.39,443,19,1933,10,1125,9,808,3717.092029,61.029862,147.4687915893,105.9153632037
172.30.6.255,57719,157.240.16.39,443,26,5276,14,3221,12,2055,3717.09203,61.029658,422.2209470681,269.377226397
172.30.6.255,57720,210.176.156.62,80,12,4179,6,3843,6,336,3733.859898,17.818932,1725.3559304228,150.850791731
172.30.6.255,57721,103.243.221.87,80,25,15121,16,13017,9,2104,3738.835226,23.279957,4473.2041386503,723.0253904679
172.30.6.255,57722,103.243.221.87,80,27,17337,11,4606,16,12731,3738.839861,23.275321,1583.1360607229,4375.7935712251
172.30.6.255,57723,103.243.221.87,80,16,5473,9,4245,7,1228,3738.840542,23.27449,1459.1082339506,422.0930297506
172.30.6.255,57724,103.243.221.87,80,21,10668,10,4552,11,6116,3738.841612,23.273571,1564.6932737568,2102.298783457
172.30.6.255,57725,103.243.221.87,80,23,12391,13,10234,10,2157,3740.873429,21.241754,3854.2956480901,812.3622936223
172.30.6.255,57726,23.8.190.108,80,14,5576,7,615,7,4961,3765.367781,60.188667,81.7429633389,659.3932376007
172.30.6.255,57727,157.240.16.39,443,28,5547,15,3399,13,2148,3778.096664,61.041052,445.4706973268,281.5154627414
172.30.6.255,57728,157.240.16.39,443,19,1971,10,1163,9,808,3778.096709,61.035467,152.4359598985,105.9056367997
172.30.6.255,57729,103.243.221.87,80,63,42186,37,35147,26,7039,3779.836976,20.229209,13899.5054131874,2783.6975731478
172.30.6.255,57730,103.243.221.87,80,28,14791,14,8287,14,6504,3779.855845,20.210343,3280.3005866848,2574.5233517314
172.30.6.255,57731,103.243.221.87,80,36,19106,16,9316,20,9790,3779.856838,20.20881,3687.8965164204,3875.5374512404
172.30.6.255,57732,103.243.221.87,80,62,52819,19,9491,43,43328,3779.86461,20.201577,3758.5184562572,17158.2644265843
172.30.6.255,57733,69.173.144.141,80,402,253059,203,182724,199,70335,3780.029999,993.968726,1470.661965274,566.0942696501
172.30.6.255,57734,69.173.144.141,80,6,348,4,228,2,120,3780.117106,19.90445,91.6377995875,48.2304208355
172.30.6.255,57735,54.194.27.245,443,18,6378,9,1141,9,5237,3780.78961,20.285384,449.9791574071,2065.3294017012
172.30.6.255,57736,103.243.221.87,80,17,6593,9,5331,8,1262,3782.846661,17.218514,2476.8687936717,586.3456045045
172.30.6.255,57737,103.243.221.87,80,39,24248,23,20155,16,4093,3799.833915,45.235159,3564.4839891024,723.8617200395
172.30.6.255,57738,103.243.221.87,80,14,5372,8,4191,6,1181,3799.836965,1.017186,32961.5232612312,9288.3700719432
172.30.6.255,57739,103.243.221.87,80,24,13513,11,4606,13,8907,3799.841942,45.22558,814.7601423796,1575.5685167554
172.30.6.255,57740,103.243.221.87,80,7,406,5,294,2,112,3799.84305,45.2265,52.0049086266,19.8113937625
172.30.6.255,57741,103.243.221.87,80,20,10617,9,4498,11,6119,3800.089654,44.979707,800.0052112389,1088.3130030171
172.30.6.255,57742,157.240.16.39,443,29,5474,16,3329,13,2145,3839.088602,61.059184,436.1669818581,281.03880327
172.30.6.255,57743,157.240.16.39,443,19,1933,10,1125,9,808,3839.088602,61.059259,147.3977926919,105.8643702178
172.30.6.255,57744,103.231.98.53,80,39,17419,20,15673,19,1746,3844.890557,66.039998,1898.6069624048,211.508183268
172.30.6.255,57745,103.243.221.46,80,55,36233,33,30202,22,6031,3844.91181,37.155399,6502.8503663761,1298.5461413024
172.30.6.255,57746,103.243.221.87,80,41,21327,23,16497,18,4830,3844.927454,37.139752,3553.4970723553,1040.3946693021
172.30.6.255,57747,103.243.221.87,80,32,18970,15,9262,17,9708,3844.927745,9.885956,7495.0768544792,7855.9928852606
172.30.6.255,57748,103.243.221.87,80,30,20659,13,5437,17,15222,3844.927995,1.480531,29378.6486064766,82251.5705513679
172.30.6.255,57749,103.243.221.46,80,64,46209,38,39961,26,6248,3845.094867,36.972341,8646.6799600274,1351.9295410588
172.30.6.255,57750,103.243.221.87,80,68,47478,32,19441,36,28037,3845.105855,36.961107,4207.8826264592,6068.4329611664
172.30.6.255,57751,172.217.166.206,443,38,6507,21,3988,17,2519,3852.40199,126.09137,253.0228674651,159.820612624
172.30.6.255,57752,172.217.166.206,443,17,1779,10,1150,7,629,3852.401991,126.09243,72.9623499206,39.9072331305
172.30.6.255,57753,172.217.24.226,80,21,2751,11,1253,10,1498,3855.594328,247.273416,40.5381223835,48.4645708943
172.30.6.255,57754,103.229.205.254,80,6,348,4,228,2,120,3855.718296,26.303867,69.3434163121,36.4965349011
172.30.6.255,57755,103.229.205.254,80,22,2441,12,1367,10,1074,3855.741732,307.294107,35.5880563632,27.960184736
172.30.6.255,57756,103.243.221.87,80,6,348,4,228,2,120,3860.864158,21.203277,86.0244385809,45.2760203057
172.30.6.255,57757,157.240.16.39,443,21,2438,11,1576,10,862,3900.080578,61.037481,206.5616043362,112.9797607473
172.30.6.255,57758,157.240.16.39,443,28,5779,15,3671,13,2108,3900.080579,61.037548,481.1464575871,276.2889492219
172.30.6.255,57759,103.231.98.53,80,39,17418,20,15672,19,1746,3910.850124,65.123542,1925.2024099058,214.4846482705
172.30.6.255,57760,103.243.221.109,80,116,83227,70,71043,46,12184,3910.874407,65.171795,8720.7050227786,1495.6163168438
172.30.6.255,57761,103.243.220.231,80,41,27647,21,12632,20,15015,3910.874729,65.171472,1550.6171166427,1843.1377459144
172.30.6.255,57762,103.243.220.231,80,66,51982,30,18435,36,33547,3910.874982,65.170743,2262.9786497908,4118.0441966114
172.30.6.255,57763,103.243.220.231,80,51,34446,24,13716,27,20730,3910.875217,65.170982,1683.6941324591,2544.6908257421
172.30.6.255,57764,103.243.221.109,80,8,449,5,283,3,166,3922.088311,53.958109,41.9584756019,24.6116853354
172.30.6.255,57765,157.240.16.39,443,19,1933,10,1125,9,808,3961.090409,61.073815,147.3626627058,105.8391390811
172.30.6.255,57766,157.240.16.39,443,29,5480,15,3275,14,2205,3961.09041,61.0743,428.9856781003,288.8285252553
172.30.6.255,57767,161.69.36.37,80,7,398,4,228,3,170,3967.304272,0.679883,2682.8145430895,2000.344176865
172.30.6.255,57768,161.69.36.37,80,7,398,4,228,3,170,3967.691703,0.605708,3011.352004596,2245.3063192163
172.30.6.255,57770,103.243.221.75,80,55,36977,33,31741,22,5236,3975.885543,19.165142,13249.4713579475,2185.6347320567
172.30.6.255,57771,103.243.221.51,80,17,6946,10,5264,7,1682,3975.898923,3.583287,11752.3380069754,3755.2113464538
172.30.6.255,57772,103.243.221.51,80,14,5408,9,4288,5,1120,3975.899233,3.469637,9886.9132419337,2582.4027124454
172.30.6.255,57773,103.243.221.51,80,42,29464,19,5750,23,23714,3975.899529,1.059756,43406.2180350905,179014.792084198
172.30.6.255,57774,103.231.98.53,80,39,17419,20,15673,19,1746,3975.927867,66.024886,1899.0415220104,211.5565939788
172.30.6.255,57775,103.243.221.75,80,30,18080,17,14967,13,3113,3977.605011,17.44361,6864.1754774385,1427.6861268969
172.30.6.255,57776,103.243.221.75,80,6,340,4,228,2,112,3978.015273,17.033887,107.0806680824,52.6010299352
172.30.6.255,57778,172.217.166.206,443,16,1725,10,1150,6,575,3978.419007,82.051377,112.1248702505,56.0624351253
172.30.6.255,57777,172.217.166.206,443,34,6083,19,3731,15,2352,3978.419007,82.051719,363.7705628081,229.3187788058
172.30.6.255,57779,103.243.221.51,80,17,6250,9,4487,8,1763,3981.839346,13.209556,2717.426687165,1067.7118897865
172.30.6.255,57780,103.243.221.51,80,21,10661,10,4541,11,6120,3981.84036,13.210322,2749.9708182738,3706.1927786469
172.30.6.255,57781,103.243.221.51,80,16,5815,9,4234,7,1581,3981.843925,13.206759,2564.7473388438,957.6914366349
172.30.6.255,57782,103.243.221.75,80,40,24255,23,20107,17,4148,3994.834925,47.224626,3406.188965901,702.6842308926
172.30.6.255,57783,103.243.221.51,80,27,16843,12,4367,15,12476,3994.837574,47.221978,739.8250026714,2113.5921074717
172.30.6.255,57784,103.243.221.51,80,17,5485,9,4204,8,1281,3994.840998,47.218554,712.2623873658,217.0333297373
172.30.6.255,57785,103.243.221.51,80,22,10399,10,4259,12,6140,3994.842657,47.216894,721.606126824,1040.3056160365
172.30.6.255,57786,172.30.13.95,7680,3,198,3,198,0,0,4010.382722,9.005214,175.8980963695,0
172.30.6.255,57787,157.240.16.39,443,19,1933,11,1179,8,754,4022.102945,61.499544,153.3669908187,98.0820280554
172.30.6.255,57788,157.240.16.39,443,27,5329,16,3329,11,2000,4022.102969,61.510841,432.9643290034,260.116749176
172.30.6.255,57789,103.231.98.53,80,290,154421,148,140605,142,13816,4041.835932,588.16546,1912.4550428378,187.9199094758
172.30.6.255,57790,103.243.221.87,80,22,12083,13,9980,9,2103,4041.847125,1.730985,46124.0276489936,9719.3216578992
172.30.6.255,57791,103.243.221.46,80,25,14008,11,5318,14,8690,4041.849369,23.217245,1832.4310227161,2994.3259848445
172.30.6.255,57792,103.243.221.46,80,17,5569,9,4288,8,1281,4041.849649,23.216754,1477.5536666323,441.4053747565
172.30.6.255,57793,103.243.221.46,80,46,35096,16,5588,30,29508,4041.849887,23.217014,1925.4844744462,10167.7157966997
172.30.6.255,57794,103.243.221.87,80,15,7857,10,6764,5,1093,4041.906612,23.160849,2336.3564953945,377.5336560417
172.30.6.255,57795,103.243.221.46,80,21,15122,11,5824,10,9298,4041.914233,23.152383,2012.4062391331,3212.8010321875
172.30.6.255,57796,103.243.221.46,80,41,33675,17,6148,24,27527,4041.915178,23.151436,2124.4470537379,9511.9801639952
172.30.6.255,57797,103.231.98.53,80,24,7125,16,6445,8,680,4041.9162,80.308441,642.0246658754,67.7388320862
172.30.6.255,57798,103.243.221.46,80,16,5769,9,4541,7,1228,4041.920125,3.437385,10568.4990188771,2857.9865217311
172.30.6.255,57801,35.190.43.164,80,162,50147,83,37245,79,12902,4041.966937,731.930234,407.0879793715,141.0189048155
172.30.6.255,57802,35.190.43.164,80,163,49307,83,36351,80,12956,4041.972227,731.924438,397.3197025565,141.6102463845
172.30.6.255,57803,173.241.248.220,80,6,535,4,228,2,307,4042.004643,23.015841,79.2497654116,106.7091139533
172.30.6.255,57804,161.69.226.23,443,19,5126,10,2321,9,2805,4042.018784,257.06929,72.2295533628,87.29164032
172.30.6.255,57805,103.243.221.87,80,20,10117,11,9627,9,490,4042.079856,1.514978,50836.3817824365,2587.4963200783
172.30.6.255,57806,180.149.59.232,80,8,480,5,294,3,186,4042.086742,22.755744,103.3585190623,65.3900834884
172.30.6.255,57799,69.173.144.142,80,6,348,4,228,2,120,4042.520938,22.506889,81.0418534521,42.65360708
172.30.6.255,57800,69.173.144.142,80,6,348,4,228,2,120,4042.521026,22.49223,81.0946713598,42.6814059789
172.30.6.255,57807,52.213.19.114,443,18,6390,9,1153,9,5237,4042.780961,23.072293,399.7868785734,1815.8576609616
172.30.6.255,57808,52.213.19.114,443,35,12438,19,6403,16,6035,4042.78192,131.006841,391.0024820765,368.5303731581
172.30.6.255,57809,52.213.19.114,443,22,7159,12,1856,10,5303,4042.782668,23.070805,643.583958167,1838.8608459913
172.30.6.255,57810,52.213.19.114,443,20,6624,10,1321,10,5303,4042.865395,22.987594,459.7262332021,1845.5171950575
172.30.6.255,57811,52.213.19.114,443,146,55263,84,43252,62,12011,4042.865948,731.152843,473.2471511432,131.4198541658
172.30.6.255,57812,103.243.221.87,80,31,18126,18,15013,13,3113,4043.421715,21.645569,5548.6644864821,1150.5357054832
172.30.6.255,57813,103.243.221.87,80,31,18125,18,15013,13,3112,4043.461895,21.604718,5559.1561065504,1152.3408914664
172.30.6.255,57815,172.217.166.206,443,42,6980,22,4057,20,2923,4060.43806,70.233041,462.1186771622,332.9487043
172.30.6.255,57814,172.217.166.206,443,17,1783,10,1154,7,629,4060.43806,69.733309,132.3901035587,72.160637035
172.30.6.255,57816,103.243.221.87,80,40,24302,23,20155,17,4147,4064.843656,38.213053,4219.500598395,868.1850152093
172.30.6.255,57817,103.243.221.46,80,25,16770,10,4258,15,12512,4064.848177,38.208531,891.5286484058,2619.7290861562
172.30.6.255,57818,103.243.221.46,80,19,9621,9,4204,10,5417,4064.852433,38.204274,880.3203536861,1134.3233482202
172.30.6.255,57819,103.243.221.46,80,17,5494,9,4204,8,1290,4064.859627,38.197081,880.4861292935,270.1777133179
172.30.6.255,57820,157.240.16.39,443,5,330,1,66,4,264,4083.087598,15.143854,34.8656293173,139.4625172694
172.30.6.255,57821,157.240.16.39,443,5,330,1,66,4,264,4083.087648,15.144064,34.865145842,139.4605833679
172.30.6.255,57823,157.240.16.39,443,28,5423,16,3329,12,2094,4083.38968,61.162164,435.4325984934,273.8948216417
172.30.6.255,57822,157.240.16.39,443,19,1933,11,1179,8,754,4083.38968,61.21556,154.0784728589,98.5370386222
172.30.6.255,57824,103.243.221.87,80,71,48014,43,40048,28,7966,4102.833129,19.317068,16585.5397930988,3299.0513881299
172.30.6.255,57825,103.243.221.46,80,50,33282,22,13690,28,19592,4102.836749,19.314168,5670.4487607233,8115.0790445647
172.30.6.255,57826,103.243.221.46,80,16,5462,9,4234,7,1228,4102.837099,3.542089,9562.7184974754,2773.5045618564
172.30.6.255,57827,103.243.221.46,80,35,23864,18,9685,17,14179,4102.838343,19.31223,4011.9654747278,5873.5837342452
172.30.6.255,57828,103.243.221.46,80,3,198,3,198,0,0,4106.857845,9.002632,175.9485448256,0
172.30.6.255,57829,103.243.221.17,80,16,5440,9,4204,7,1236,4127.865601,35.188258,955.7733719015,281.0028277046
172.30.6.255,57830,103.243.221.87,80,40,24270,23,20123,17,4147,4135.834262,27.22108,5913.9461035346,1218.7613423127
172.30.6.255,57831,103.243.221.46,80,21,8821,12,4367,9,4454,4135.84583,3.643448,9588.7192571437,9779.7470967067
172.30.6.255,57832,103.243.221.46,80,21,10349,10,4259,11,6090,4135.847841,27.206265,1252.3586019617,1790.7640023355
172.30.6.255,57834,157.240.16.39,443,4,264,1,66,3,198,4144.089653,15.140171,34.8741107349,104.6223322048
172.30.6.255,57833,157.240.16.39,443,4,264,1,66,3,198,4144.089653,15.140172,34.8741084315,104.6223252946
172.30.6.255,57835,157.240.16.39,443,19,1933,10,1125,9,808,4144.392063,60.739761,148.1731217217,106.4212287566
172.30.6.255,57836,157.240.16.39,443,28,5421,15,3274,13,2147,4144.392197,60.739693,431.2171943312,282.7804875471
172.30.6.255,57837,103.243.221.51,80,71,48103,42,40073,29,8030,4162.887182,43.15435,7428.7760098345,1488.6100705954
172.30.6.255,57838,103.243.221.109,80,30,16122,17,9402,13,6720,4162.895845,11.105178,6773.0566768044,4840.9849891646
172.30.6.255,57839,103.243.221.109,80,35,22334,15,8601,20,13733,4162.896427,43.143847,1594.8508254259,2546.458131098
172.30.6.255,57840,103.243.221.109,80,59,44793,22,9901,37,34892,4162.896778,43.143159,1835.9341744076,6469.994466562
172.30.6.255,57841,161.69.226.23,443,24,6418,13,3165,11,3253,4179.052053,176.646394,143.3372027962,147.3225657808
172.30.6.255,57842,157.240.16.39,443,19,1933,10,1125,9,808,4205.096751,61.019817,147.4930677029,105.932798848
172.30.6.255,57843,157.240.16.39,443,29,5537,16,3353,13,2184,4205.096867,61.019633,439.5962197937,286.334072183
172.30.6.255,57844,103.243.221.51,80,40,25802,24,21708,16,4094,4205.843253,18.22446,9529.1712347031,1797.1451554669
172.30.6.255,57845,103.243.221.109,80,15,5833,9,4205,6,1628,4205.856711,3.527106,9537.5642240421,3692.5456734223
172.30.6.255,57846,103.243.221.109,80,23,10731,11,4325,12,6406,4205.860985,18.20525,1900.5506653301,2815.0121530877
172.30.6.255,57847,103.243.221.109,80,16,5439,9,4203,7,1236,4205.867592,18.198384,1847.636581358,543.3449475514
172.30.6.255,57848,103.243.221.109,80,7,406,5,294,2,112,4223.861677,14.195914,165.6814770785,63.1167531728
172.30.6.255,57849,103.243.221.109,80,7,406,5,294,2,112,4223.862217,14.195063,165.6914097528,63.1205370487
172.30.6.255,57850,103.243.221.109,80,7,406,5,294,2,112,4223.862632,14.19507,165.6913280456,63.1205059221
172.30.6.255,57851,103.243.221.51,80,7,406,5,294,2,112,4223.863124,14.194351,165.6997209665,63.1237032253
172.30.6.255,57852,103.243.221.51,80,17,6609,9,5354,8,1255,4224.098137,13.958926,3068.4309093693,719.25304282
172.30.6.255,57853,103.243.221.109,80,33,21367,15,8800,18,12567,4224.10959,0.868963,81016.1077054012,115696.525628838
172.30.6.255,57854,103.243.221.51,80,34,21844,19,19418,15,2426,4225.132073,12.924993,12018.8846523935,1501.5868867395
172.30.6.255,57855,103.243.221.51,80,15,7424,10,6355,5,1069,4225.152392,12.904672,3939.6584430818,662.7057239425
172.30.6.255,57856,103.243.221.109,80,24,11936,14,7396,10,4540,4225.223012,12.834055,4610.2342556583,2829.9707302175
172.30.6.255,57857,119.42.60.92,80,11,1676,6,807,5,869,4225.829015,51.142421,126.2357134012,135.9341201309
172.30.6.255,57858,67.231.251.189,80,11,1226,6,787,5,439,4225.947353,12.142885,518.4929281633,289.2228659005
172.30.6.255,57860,67.231.251.189,80,6,348,4,228,2,120,4226.045066,12.048213,151.3917458133,79.6798662175
172.30.6.255,57859,54.171.10.96,80,6,348,4,228,2,120,4226.05065,11.985442,152.1846253146,80.0971712182
172.30.6.255,57861,54.171.10.96,80,13,1751,7,1021,6,730,4226.05069,77.976745,104.7491787455,74.8941238827
172.30.6.255,57862,103.243.221.87,80,18,7220,10,3900,8,3320,4226.114077,11.942987,2612.4117860969,2223.8992640619
172.30.6.255,57863,103.243.221.51,80,40,24332,23,20185,17,4147,4237.832604,39.194275,4119.9894627468,846.4501512019
172.30.6.255,57864,103.243.221.109,80,17,5591,9,4309,8,1282,4237.840672,39.186062,879.7005425041,261.7257125761
172.30.6.255,57865,103.243.221.109,80,42,27030,20,5824,22,21206,4237.842146,1.082513,43040.5916603196,156716.824647791
172.30.6.255,57866,103.243.221.109,80,25,14011,11,5338,14,8673,4237.842793,39.183744,1089.8397049552,1770.7343126782
172.30.6.255,57868,172.217.166.206,443,49,8903,26,5671,23,3232,4241.406378,108.806266,416.9612805204,237.6333730633
172.30.6.255,57867,172.217.166.206,443,17,1779,10,1150,7,629,4241.40638,86.007263,106.9677103898,58.5066868132
172.30.6.255,57870,157.240.16.39,443,27,5466,15,3411,12,2055,4266.090081,61.0415,447.0401284372,269.3249674402
172.30.6.255,57869,157.240.16.39,443,19,1933,10,1125,9,808,4266.090081,61.041738,147.4401007389,105.8947567974
172.30.6.255,57872,172.217.163.133,443,31,8380,17,5538,14,2842,4271.403352,78.808731,562.1712142529,288.4959535765
172.30.6.255,57871,172.217.163.133,443,18,1833,11,1204,7,629,4271.403352,79.059857,121.8317407278,63.6479775065
172.30.6.255,57873,103.243.221.51,80,53,35452,32,30268,21,5184,4276.837454,27.210907,8898.7845939866,1524.0947315722
172.30.6.255,57874,103.243.221.109,80,32,16247,18,12478,14,3769,4276.845309,27.202695,3669.6364091867,1108.4195885739
172.30.6.255,57875,103.243.221.109,80,31,16154,15,8559,16,7595,4276.848778,27.199225,2517.4246692691,2233.8871787707
172.30.6.255,57876,103.243.221.109,80,18,10223,9,4238,9,5985,4276.85015,1.171801,28933.2403710309,40860.1801841953
172.30.6.255,57877,173.241.248.220,80,108,53422,56,26435,52,26987,4276.885719,497.123269,425.407566267,434.290674895
172.30.6.255,57878,103.243.221.75,80,6,340,4,228,2,112,4284.904172,19.143612,95.2798249359,46.8041245299
172.30.6.255,57879,172.217.166.206,443,29,4548,16,3217,13,1331,4289.41429,60.798,423.3033981381,175.1373400441
172.30.6.255,57880,172.217.166.206,443,18,1837,11,1208,7,629,4289.414291,61.018969,158.3769794603,82.466159007
172.30.6.255,57881,103.243.221.75,80,28,18159,12,5393,16,12766,4303.838668,41.19251,1047.3748747042,2479.2856759639
172.30.6.255,57882,103.243.221.75,80,15,5482,9,4309,6,1173,4303.839423,41.192143,836.8586213152,227.8104346259
172.30.6.255,57883,103.243.221.75,80,33,18507,17,5735,16,12772,4303.840173,41.191391,1113.824973767,2480.5183199567
172.30.6.255,57884,103.243.221.87,80,39,24285,23,20192,16,4093,4303.846626,41.184171,3922.2836365942,795.0627438877
172.30.6.255,57885,52.229.174.233,443,30,10373,16,2271,14,8102,4312.837953,77.75981,233.6425461945,833.5411313376
172.30.6.255,57887,157.240.16.39,443,28,5544,14,3343,14,2201,4327.092964,61.069052,437.930492191,288.329348882
172.30.6.255,57886,157.240.16.39,443,18,1879,9,1071,9,808,4327.092965,61.069124,140.3000311581,105.8472690717
172.30.6.255,57888,103.243.221.87,80,63,42124,37,35077,26,7047,4344.838005,17.231618,16284.9478209178,3271.6602700917
172.30.6.255,57889,103.243.221.75,80,24,10841,14,8253,10,2588,4344.841808,17.227815,3832.4070696138,1201.7774743924
172.30.6.255,57890,103.243.221.75,80,31,15783,15,8559,16,7224,4344.842401,17.227553,3974.5633056535,3354.6261619396
172.30.6.255,57891,103.243.221.75,80,31,16240,15,8559,16,7681,4344.846297,17.223324,3975.5392164719,3567.7201450778
172.30.6.255,57892,52.229.173.178,443,27,10012,14,2162,13,7850,4367.694967,125.562632,137.7479885895,500.1488022328
172.30.6.255,57893,103.243.221.87,80,39,24320,23,20226,16,4094,4368.834964,37.225885,4346.652873397,879.8179009042
172.30.6.255,57894,103.243.221.75,80,27,14153,12,5393,15,8760,4368.839896,37.220158,1159.1568203445,1882.8506853733
172.30.6.255,57895,103.243.221.75,80,17,5590,9,4309,8,1281,4368.840157,37.220043,926.1676564963,275.3355228526
172.30.6.255,57896,103.243.221.75,80,33,20831,15,5555,18,15276,4368.84134,1.460211,30433.9578321295,83692.0143732872
172.30.6.255,57898,157.240.16.39,443,19,1933,10,1125,9,808,4388.092528,61.047547,147.4260710262,105.884680346
172.30.6.255,57897,157.240.16.39,443,27,5329,15,3275,12,2054,4388.092528,61.047614,429.1732024121,269.1669489327
172.30.6.255,57899,103.243.221.87,80,70,48306,44,40445,26,7861,4405.834438,28.248916,11453.8908324834,2226.2093172
172.30.6.255,57900,103.243.221.75,80,21,11079,10,4562,11,6517,4405.841624,12.220475,2986.4632921388,4266.2826117643
172.30.6.255,57901,103.243.221.75,80,16,5838,9,4255,7,1583,4405.842865,3.596484,9464.7995097418,3521.216832884
172.30.6.255,57902,103.243.221.75,80,27,17130,11,4616,16,12514,4405.846284,12.216094,3022.897498988,8195.0908367277
172.30.6.255,57903,103.243.221.75,80,19,9662,9,4226,10,5436,4417.838817,16.244696,2081.1716021033,2677.0584072488
172.30.6.255,57904,103.243.221.75,80,17,5863,9,4226,8,1637,4417.839704,16.24381,2081.2851172231,806.2147981293
172.30.6.255,57905,103.243.221.75,80,17,5506,9,4225,8,1281,4417.840767,16.242746,2080.9289266729,630.9278000161
172.30.6.255,57906,52.229.174.29,443,30,10163,17,2314,13,7849,4423.800169,82.617955,224.0675165586,760.0284950166
172.30.6.255,57907,103.243.221.46,80,40,24340,23,20192,17,4148,4433.892964,13.169604,12265.8205971867,2519.7416718072
172.30.6.255,57908,103.243.220.231,80,23,13912,10,5285,13,8627,4433.89374,13.168826,3210.6127000237,5240.8620176168
172.30.6.255,57909,103.243.220.231,80,15,5482,9,4309,6,1173,4433.893778,13.168495,2617.7630777094,712.6099072066
172.30.6.255,57910,103.243.220.231,80,36,28992,13,5459,23,23533,4433.894172,13.168395,3316.4254261815,14296.6549833905
172.30.6.255,57911,172.217.166.195,443,55,9740,25,3096,30,6644,4435.559876,282.707745,87.6099096613,188.0104133688
172.30.6.255,57912,52.229.172.155,443,29,10198,16,2336,13,7862,4440.588283,62.17437,300.5740146623,1011.6065510596
172.30.6.255,57914,161.69.226.28,443,17,4714,9,1926,8,2788,4446.950598,156.605344,98.3874471104,142.4217043321
172.30.6.255,57913,216.239.32.62,443,41,7446,20,2387,21,5059,4448.034517,240.370787,79.4439300979,168.3732058505
172.30.6.255,57915,216.239.32.62,443,7,402,4,228,3,174,4448.034517,17.819428,102.3601879926,78.1169855733
172.30.6.255,57916,216.239.32.62,443,41,7446,20,2387,21,5059,4448.034636,240.370567,79.4440028092,168.3733599547
172.30.6.255,57917,216.239.32.62,443,7,402,4,228,3,174,4448.034712,17.852477,102.1706959768,77.9723732455
172.30.6.255,57918,157.240.16.39,443,29,5600,16,3453,13,2147,4449.089182,61.056137,452.4360917233,281.3148824008
172.30.6.255,57919,157.240.16.39,443,19,1933,10,1125,9,808,4449.08932,61.056693,147.4039873073,105.8688193283
172.30.6.255,57920,103.243.221.46,80,38,24271,23,20231,15,4040,4465.832303,16.246573,9961.9778275705,1989.3426139778
172.30.6.255,57921,103.243.220.231,80,16,5483,9,4255,7,1228,4465.835544,12.214186,2786.9233365203,804.3106597525
172.30.6.255,57922,103.243.220.231,80,26,17302,11,4616,15,12686,4465.838034,12.212001,3023.9106596864,8310.5135677602
172.30.6.255,57923,103.243.220.231,80,20,10633,10,4562,10,6071,4465.840945,12.209091,2989.2479300876,3978.0193300223
172.30.6.255,57924,103.243.221.46,80,78,57434,47,49304,31,8130,4488.837212,38.227569,10317.9985104468,1701.3899052802
172.30.6.255,57925,103.243.220.231,80,33,16899,17,4754,16,12145,4488.852825,11.208423,3393.1624457785,8668.4808380269
172.30.6.255,57926,103.243.220.231,80,27,16953,11,4334,16,12619,4488.858181,11.202659,3094.9795044193,9011.4320180589
172.30.6.255,57927,103.243.220.231,80,16,5452,9,4225,7,1227,4488.860437,11.199831,3017.902680853,876.4417963093
172.30.6.255,57928,103.243.221.17,80,26,14149,11,5339,15,8810,4499.885258,27.179289,1571.4907038223,2593.1509834566
172.30.6.255,57929,103.243.221.17,80,42,28350,17,8943,25,19407,4499.885702,27.178563,2632.3687532707,5712.4432958431
172.30.6.255,57930,103.243.221.17,80,16,5535,9,4309,7,1226,4499.886091,27.176487,1268.4494504386,360.9002149542
172.30.6.255,57931,103.243.221.17,80,7,406,5,294,2,112,4500.1072,26.957976,87.2469060734,33.2369165994
172.30.6.255,57932,103.243.221.75,80,6,340,4,228,2,112,4501.203757,25.861195,70.5303834568,34.6465041542
172.30.6.255,57934,157.240.16.39,443,28,5560,15,3411,13,2149,4510.083373,61.058621,446.9147771942,281.5654811464
172.30.6.255,57933,157.240.16.39,443,18,1879,10,1125,8,754,4510.083375,61.058806,147.3988862475,98.7900090939
172.30.6.255,57935,103.243.221.75,80,7,406,5,294,2,112,4526.841819,27.973046,84.0809399162,32.0308342538
172.30.6.255,57936,103.243.221.17,80,26,17048,11,4615,15,12433,4526.856235,27.958874,1320.5109762289,3557.5109355262
172.30.6.255,57937,103.243.221.17,80,16,5483,9,4255,7,1228,4526.859089,27.954598,1217.6887680517,351.426981708
172.30.6.255,57938,103.243.221.17,80,21,10914,10,4562,11,6352,4526.867179,27.946237,1305.936108679,1818.3485669287
172.30.6.255,57939,103.243.221.75,80,40,24467,23,20319,17,4148,4527.093703,27.721407,5863.7716332364,1197.0532375936
172.30.6.255,57940,184.29.25.201,443,34,10865,18,3884,16,6981,4554.760253,219.120145,141.8034841114,254.8738729613
172.30.6.255,57941,103.243.221.75,80,7,406,5,294,2,112,4558.844012,28.208037,83.380491879,31.7639969063
172.30.6.255,57942,103.243.221.17,80,14,7280,10,5660,4,1620,4558.855966,1.990155,22751.99670378,6512.0555936614
172.30.6.255,57943,103.243.221.17,80,12,6637,9,5605,3,1032,4558.857747,1.2473,35949.651246693,6619.0972500602
172.30.6.255,57944,103.243.221.17,80,43,28150,20,12834,23,15316,4558.863436,28.188396,3642.3498520454,4346.7531816992
172.30.6.255,57945,103.243.221.75,80,80,62056,50,53971,30,8085,4559.097591,27.954245,15445.5253575978,2313.7809660036
172.30.6.255,57946,103.243.221.75,80,6,340,4,228,2,112,4560.223095,26.829157,67.9857365627,33.3965021711
172.30.6.255,57947,103.243.221.17,80,26,14260,12,5393,14,8867,4565.868971,21.18253,2036.7727556623,3348.7973344072
172.30.6.255,57948,103.243.221.17,80,16,5537,9,4309,7,1228,4565.871129,21.180706,1627.5189316164,463.8183448654
172.30.6.255,57949,157.240.16.39,443,18,1879,9,1071,9,808,4571.083538,61.069131,140.3000150764,105.847256939
172.30.6.255,57950,157.240.16.39,443,25,5381,12,3235,13,2146,4571.083538,61.064871,423.8115888266,281.1436382139
172.30.6.255,57952,172.217.166.206,443,17,1779,10,1150,7,629,4580.422438,99.778713,92.2040355441,50.4315985715
172.30.6.255,57951,172.217.166.206,443,41,6372,22,3902,19,2470,4580.422438,99.780672,312.8461592241,198.0343447677
172.30.6.255,57953,103.243.221.75,80,40,24625,23,20467,17,4158,4586.842189,15.251483,10735.7428782499,2181.0338050405
172.30.6.255,57954,103.243.221.17,80,27,17315,11,4616,16,12699,4586.851826,15.241844,2422.8039599408,6665.3352442132
172.30.6.255,57955,103.243.221.17,80,16,5482,9,4255,7,1227,4586.854296,15.239376,2233.687258586,644.1208616416
172.30.6.255,57956,103.243.221.17,80,22,11039,10,4562,12,6477,4586.859678,15.233993,2395.6949435385,3401.3406727967
172.30.6.255,57958,103.243.221.75,80,49,36217,31,31202,18,5015,4629.841009,17.190465,14520.6077904229,2333.8519347789
172.30.6.255,57959,103.243.221.17,80,37,19828,18,9445,19,10383,4629.86493,17.166177,4401.6789527453,4838.8176354001
172.30.6.255,57960,103.243.221.17,80,37,23575,16,9336,21,14239,4629.865225,17.165881,4350.9564117331,6635.9541930877
172.30.6.255,57961,103.243.221.17,80,30,15509,15,8361,15,7148,4629.865476,17.165407,3896.6742821769,3331.3512461428
172.30.6.255,57962,103.231.98.53,80,39,17419,20,15673,19,1746,4629.907169,67.052582,1869.9354485708,208.3141257707
172.30.6.255,57963,103.243.221.75,80,32,18570,18,15379,14,3191,4630.789606,16.241501,7575.1619262286,1571.7759091355
172.30.6.255,57964,103.243.221.75,80,6,348,4,228,2,120,4630.878935,16.152285,112.9251991282,59.4343153306
172.30.6.255,57965,157.240.16.39,443,29,5622,16,3477,13,2145,4632.090578,61.053511,455.6003339431,281.064916971
172.30.6.255,57966,157.240.16.39,443,18,1879,10,1125,8,754,4632.090579,61.049271,147.4219077899,98.8054386432
172.30.6.255,57967,103.243.221.75,80,38,24303,23,20263,15,4040,4646.836994,50.220962,3227.8155085919,643.5559717076
172.30.6.255,57968,103.243.221.17,80,21,10665,10,4570,11,6095,4646.840029,50.216025,728.0544407886,971.0047738745
172.30.6.255,57969,103.243.221.17,80,17,5552,9,4263,8,1289,4646.842471,50.215937,679.1469409403,205.3531332095
172.30.6.255,57970,103.243.221.17,80,18,6331,9,4515,9,1816,4646.843242,50.215167,719.3045877952,289.3149792771
172.30.6.255,57971,131.253.61.102,443,56,26881,16,6929,40,19952,4686.853632,65.039395,852.2834506686,2454.1433695686
172.30.6.255,57972,131.253.61.102,443,69,28655,26,7469,43,21186,4686.868944,65.89229,906.8132250374,2572.1977487806
172.30.6.255,57973,131.253.61.102,443,77,30766,32,7809,45,22957,4686.891609,65.348111,955.9878479119,2810.4255377788
172.30.6.255,57974,131.253.61.102,443,56,26881,16,6929,40,19952,4686.901854,99.640324,556.3209529507,1601.9217279944
172.30.6.255,57975,52.229.207.60,443,22,7505,11,1036,11,6469,4689.287702,3.46279,2393.4457475038,14945.1742669907
172.30.6.255,57976,52.229.207.60,443,63,41873,26,7405,37,34468,4689.288327,3.46262,17108.4323431378,79634.4964217791
172.30.6.255,57977,52.175.39.99,443,24,9380,12,2455,12,6925,4691.238705,1.510621,13001.2756343222,36673.6593758375
172.30.6.255,57979,161.69.226.21,443,5,330,1,66,4,264,4691.817385,15.631863,33.7771639887,135.1086559548
172.30.6.255,57978,13.78.168.230,443,23,6383,14,1487,9,4896,4692.925844,1.63572,7272.6383488647,23945.4185312991
172.30.6.255,57980,122.15.34.34,443,1596,1221476,773,54257,823,1167219,4692.926676,9.462189,45872.6833716814,986849.026160875
172.30.6.255,57981,122.15.34.34,443,24,6031,14,1275,10,4756,4692.92682,9.462707,1077.9156535228,4020.8367436504
172.30.6.255,57982,23.61.87.106,443,2410,1887050,1140,71141,1270,1815909,4693.013308,9.376046,60700.2141414388,1549402.80796399
172.30.6.255,57983,23.61.87.106,443,2139,1712485,980,61421,1159,1651064,4693.013308,9.376385,52404.84472427,1408699.83474434
172.30.6.255,57985,157.240.16.39,443,18,1879,10,1125,8,754,4693.086131,61.054365,147.4096078143,98.7971949262
172.30.6.255,57984,157.240.16.39,443,28,5544,15,3399,13,2145,4693.086131,61.054441,445.373007346,281.0606357038
172.30.6.255,57986,13.78.168.230,443,24,6439,14,1487,10,4952,4694.32558,1.523376,7808.9716524346,26005.3985358818
172.30.6.255,57987,103.243.221.17,80,51,28526,26,17199,25,11327,4696.856694,25.24886,5449.4341526707,3588.9145094076
172.30.6.255,57988,103.243.221.17,80,49,32245,25,13869,24,18376,4696.861945,12.952291,8566.206549868,11349.961176752
172.30.6.255,57989,103.243.221.17,80,37,19923,19,12358,18,7565,4696.86268,25.242335,3916.594879198,2397.559496774
172.30.6.255,57990,103.231.98.53,80,39,17419,20,15673,19,1746,4696.865477,63.111522,1986.7053752879,221.3225027278
172.30.6.255,57991,103.243.221.75,80,69,50401,44,43389,25,7012,4696.86788,25.237678,13753.7217171879,2222.7084440969
172.30.6.255,57992,103.243.221.75,80,27,20224,18,18122,9,2102,4697.090328,25.01523,5795.5093756883,672.2304771933
172.30.6.255,57993,184.29.26.80,80,13,2660,7,617,6,2043,4722.266708,60.987394,80.9347584191,267.989807861
172.30.6.255,57995,161.69.226.24,443,57,12707,34,7938,23,4769,4722.315421,453.132103,140.1445617725,84.1961974166
172.30.6.255,57994,104.121.241.30,443,21,8944,10,1008,11,7936,4722.948426,60.313245,133.7019754119,1052.6377746712
172.30.6.255,57996,52.229.207.60,443,29,9951,16,3112,13,6839,4725.453851,2.262278,11004.8367176794,24184.4724653629
172.30.6.255,57997,13.75.122.216,443,22,8827,14,2564,8,6263,4726.704585,1.011407,20280.6585281699,49538.9096575383
172.30.6.255,58000,52.229.171.86,443,30,10173,17,2324,13,7849,4737.756869,93.659286,198.5067449692,670.4300521787
172.30.6.255,58001,52.229.173.178,443,29,10122,16,2272,13,7850,4737.763407,97.2925,186.8181000591,645.4762700105
172.30.6.255,58003,52.229.175.79,443,30,10146,17,2297,13,7849,4737.772653,98.674072,186.2292659818,636.3576441844
172.30.6.255,58004,52.229.175.79,443,31,10230,17,2326,14,7904,4737.777964,101.934523,182.5485561943,620.3197713497
172.30.6.255,58005,52.114.6.46,443,92,64941,56,56610,36,8331,4738.15915,5.698441,79474.3685158864,11695.8304911826
172.30.6.255,58006,52.175.39.99,443,36,9105,20,3751,16,5354,4738.822501,1.77428,16912.7758865516,24140.4964267122
172.30.6.255,58007,157.240.16.39,443,35,12025,21,9287,14,2738,4743.384091,30.500719,2435.8770034241,718.1470049936
172.30.6.255,58008,103.243.221.75,80,17,6561,9,5306,8,1255,4744.483492,15.607715,2719.6806194885,643.2716127889
172.30.6.255,58009,157.240.16.39,443,19,1945,10,1137,9,808,4754.090649,61.065063,148.9558767834,105.8543082155
172.30.6.255,58010,157.240.16.39,443,28,6463,16,3361,12,3102,4754.090649,61.06391,440.3255539974,406.3938912526
172.30.6.255,58011,157.240.16.16,443,234,18765,122,11147,112,7618,4759.136948,1116.137106,79.8969943035,54.6026108015
172.30.6.255,58012,195.201.82.80,80,10,2505,6,1038,4,1467,4759.887795,14.135109,587.4733615425,830.2730456482
172.30.6.255,58013,103.231.98.53,80,39,17419,20,15673,19,1746,4761.845377,12.103867,10359.0034490624,1154.0113585187
172.30.6.255,58014,103.243.221.46,80,85,65107,55,56214,30,8893,4761.871806,12.176676,36932.2465342757,5842.6453984651
172.30.6.255,58015,103.243.221.51,80,37,21077,20,8918,17,12159,4761.882547,12.165168,5864.612802717,7995.9438291361
172.30.6.255,58016,103.243.221.51,80,29,15435,16,8388,13,7047,4761.88279,12.164663,5516.3057127022,4634.4070526243
172.30.6.255,58017,103.243.221.51,80,14,6817,10,5751,4,1066,4761.88299,3.461993,13289.4549469053,2463.3209830292
172.30.6.255,58018,103.243.221.46,80,7,406,5,294,2,112,4762.083856,11.964418,196.5829010655,74.8887242154
172.30.6.255,58019,103.243.221.51,80,80,58091,36,22480,44,35611,4762.091079,11.956442,15041.2639479195,23827.1552690997
172.30.6.255,58020,104.122.91.146,80,75,68946,25,2520,50,66426,4763.867888,10.018845,2012.2079940351,53040.8445284834
172.30.6.255,58021,104.122.91.146,80,3,198,3,198,0,0,4763.867941,9.000619,175.9878959436,0
172.30.6.255,58022,104.122.91.146,80,7,402,4,228,3,174,4763.898906,9.990001,182.5825643061,139.3393253915
172.30.6.255,58023,103.243.221.46,80,38,24182,23,20142,15,4040,4763.961046,10.087488,15973.8479986308,3203.9691150069
172.30.6.255,58024,172.217.31.2,80,14,2919,8,1699,6,1220,4766.558235,7.339246,1851.9613595185,1329.8368797014
172.30.6.255,58025,172.217.31.2,80,10,1598,6,928,4,670,4766.558251,7.302779,1016.599297336,733.9671651025
172.30.6.255,58027,172.30.13.95,7680,3,198,3,198,0,0,4777.78798,9.00029,175.9943290716,0
172.30.6.255,58028,172.217.166.206,443,17,1783,10,1154,7,629,4780.430666,91.050993,101.3937321914,55.265734444
172.30.6.255,58029,172.217.166.206,443,37,7213,21,4862,16,2351,4780.431318,91.049323,427.197025946,206.5693558205
172.30.6.255,58030,157.240.16.39,443,24,3843,13,2387,11,1456,4802.184336,1.71335,11145.4168733768,6798.3774476902
172.30.6.255,58031,103.243.221.46,80,21,11287,11,9916,10,1371,4803.395543,0.667204,118896.169687177,16438.7503671964
172.30.6.255,58032,35.230.55.83,80,457,384583,191,12954,266,371629,4808.103556,64.636824,1603.2965976175,45995.9480682404
172.30.6.255,58033,35.230.55.83,80,6,348,4,228,2,120,4808.184668,10.642961,171.3808779342,90.2004620707
172.30.6.255,58034,35.190.43.164,80,35,10694,19,8224,16,2470,4811.481823,61.073845,1077.2532824812,323.5427538581
172.30.6.255,58035,35.230.55.83,80,28,12932,14,3978,14,8954,4814.594286,58.147626,547.2966342598,1231.898960071
172.30.6.255,58036,35.230.55.83,80,6,348,4,228,2,120,4814.666389,11.441012,159.426456331,83.9086612268
172.30.6.255,58037,205.185.216.42,443,113,98011,39,3976,74,94035,4814.740746,4.150017,7664.546916314,181271.546598487
172.30.6.255,58038,205.185.216.42,443,8969,7320878,4078,329128,4891,6991750,4814.901635,32.95709,79892.4905081125,1697176.54076862
172.30.6.255,58039,157.240.16.39,443,19,1933,10,1125,9,808,4815.094978,61.046657,147.4282203528,105.8862240401
172.30.6.255,58040,157.240.16.39,443,29,6382,16,4237,13,2145,4815.094978,61.045916,555.2541794934,281.0998855353
172.30.6.255,58041,104.25.171.105,443,38,11890,21,2151,17,9739,4815.199732,57.340906,300.0998972705,1358.7507668609
172.30.6.255,58042,143.204.192.51,80,63,44376,28,4715,35,39661,4816.434471,56.23086,670.8060307098,5642.5955427322
172.30.6.255,58043,143.204.192.51,80,238,195893,100,10759,138,185134,4816.434523,56.231097,1530.6832801075,26339.0202044254
172.30.6.255,58044,143.204.192.51,80,6,348,4,228,2,120,4816.434581,12.029982,151.6211744955,79.8006181555
172.30.6.255,58045,143.204.192.51,80,17,6406,10,2057,7,4349,4816.550366,56.112418,293.2684169839,620.0410041143
172.30.6.255,58047,35.190.43.247,443,31,9458,15,2116,16,7342,4818.453962,54.097878,312.9143069161,1085.735747343
172.30.6.255,58048,172.217.31.2,80,18,4089,10,2319,8,1770,4819.466049,53.085458,349.4742383121,266.7397161761
172.30.6.255,58049,172.217.31.2,80,26,6569,14,3699,12,2870,4819.469905,53.08174,557.4798414671,432.5404555314
172.30.6.255,58052,143.204.192.51,80,20,12776,8,1915,12,10861,4819.920253,52.746297,290.4469293835,1647.2815143782
172.30.6.255,58050,35.190.41.40,443,86,32228,37,5547,49,26681,4819.982368,52.575049,844.0505685501,4059.8725832857
172.30.6.255,58051,35.190.41.40,443,7,402,4,228,3,174,4819.982689,19.090007,95.5473719837,72.9177312507
172.30.6.255,58053,151.139.104.15,80,14,5536,7,1818,7,3718,4819.99902,5.993623,2426.5790490996,4962.6077582796
172.30.6.255,58054,151.139.104.15,80,20,13641,7,1816,13,11825,4819.999135,5.995247,2423.2529535481,15779.166396314
172.30.6.255,58055,151.139.104.15,80,23,16166,8,1870,15,14296,4819.999388,5.994347,2495.6846842534,19079.3092225063
172.30.6.255,58056,151.139.104.15,80,22,14868,8,1870,14,12998,4819.999528,5.997888,2494.2112957095,17336.7692094287
172.30.6.255,58057,151.139.104.15,80,17,8745,7,1816,10,6929,4819.999673,5.994319,2423.6281052112,9247.4224344759
172.30.6.255,58058,172.217.166.194,443,16,4829,8,1219,8,3610,4820.664738,25.189072,387.152015763,1146.5289392162
172.30.6.255,58059,35.230.55.83,443,28,8996,15,2632,13,6364,4820.905426,51.836249,406.2022311838,982.1698325432
172.30.6.255,58060,35.230.55.83,443,6,348,4,228,2,120,4820.979197,18.259072,99.8955478132,52.5766041122
172.30.6.255,58061,157.240.16.39,443,35,6695,18,3156,17,3539,4825.868337,46.668234,541.0104012078,606.665338997
172.30.6.255,58062,103.243.221.46,80,23,11542,12,10126,11,1416,4826.834567,12.36844,6549.572945335,915.8794480144
172.30.6.255,58063,103.231.98.53,80,39,17444,20,15698,19,1746,4826.853305,45.749943,2745.0088844919,305.3118557984
172.30.6.255,58064,103.243.221.51,80,16,5551,9,4317,7,1234,4826.853594,12.349414,2796.569942509,799.3901572981
172.30.6.255,58065,103.243.221.51,80,25,14240,11,5347,14,8893,4826.85381,12.348996,3463.9253263988,5761.1161263634
172.30.6.255,58066,103.243.221.51,80,30,20677,13,5455,17,15222,4826.858088,1.539956,28338.4720082981,79077.584034888
172.30.6.255,58067,210.176.156.41,80,15,8531,10,8217,5,314,4826.89408,2.651372,24793.2014066655,947.4340077514
172.30.6.255,58068,173.241.248.220,80,17,6680,10,3393,7,3287,4826.904012,45.758521,593.2009909149,574.6689234121
172.30.6.255,58069,35.190.43.164,80,26,6692,14,4902,12,1790,4826.906556,45.645327,859.1459975739,313.7232426881
172.30.6.255,58070,180.149.59.210,80,24,13023,15,9528,9,3495,4827.00845,45.507181,1674.98839359,614.4085259863
172.30.6.255,58071,210.176.156.41,80,9,520,7,392,2,128,4827.109336,133.244613,23.5356606875,7.6851136939
172.30.6.255,58072,176.34.147.227,443,38,15440,21,9099,17,6341,4828.376369,44.321792,1642.3523669801,1144.5385601737
172.30.6.255,58073,176.34.147.227,443,24,10309,13,4820,11,5489,4828.376745,44.317987,870.075619635,990.8392274225
172.30.6.255,58074,176.34.147.227,443,6,348,4,228,2,120,4828.525327,10.642333,171.3909910543,90.2057847654
172.30.6.255,58075,172.217.166.197,443,50,11832,25,5262,25,6570,4845.889744,26.662171,1578.8661771016,1971.3323419912
172.30.6.255,58076,205.185.216.42,443,82,85808,18,2070,64,83738,4847.865911,0.691124,23960.9679305035,969296.392543238
172.30.6.255,58077,205.185.216.42,443,98,114240,14,1822,84,112418,4848.371098,0.693864,21006.9984895946,1296138.72459015
172.30.6.255,58078,205.185.216.42,443,125,105106,48,4106,77,101000,4848.416701,0.999812,32854.1765851974,808151.932563306
172.30.6.255,58079,205.185.216.42,443,9971,9307614,3609,227144,6362,9080470,4849.415369,128.947316,14092.2049125862,563360.000451658
172.30.6.255,58080,103.243.221.46,80,85,60213,52,50337,33,9876,4857.229988,15.479212,26015.2777802898,5104.1357919253
172.30.6.255,58081,103.243.221.51,80,41,27360,18,8738,23,18622,4857.237323,15.471839,4518.1442231916,9628.8489041285
172.30.6.255,58082,103.243.221.51,80,31,16152,15,8575,16,7577,4857.238655,15.470452,4434.2595807803,3918.1789905041
172.30.6.255,58083,103.243.221.51,80,22,10393,14,8266,8,2127,4857.242388,15.466518,4275.5583383409,1100.1829888279
172.30.6.255,58084,210.176.156.41,80,13,747,12,685,1,62,4857.440444,66.837565,81.9898211432,7.4209765122
172.30.6.255,58085,122.15.34.40,80,20,11601,9,913,11,10688,4857.691534,14.82574,492.6566903237,5767.2669290031
172.30.6.255,58086,122.15.34.40,80,19,10816,9,918,10,9898,4857.691714,14.825199,495.3727771209,5341.1761960157
172.30.6.255,58087,122.15.34.40,80,79,73986,24,2553,55,71433,4857.691968,14.825368,1377.638652882,38546.3618845757
172.30.6.255,58088,122.15.34.40,80,113,93777,44,4567,69,89210,4857.692261,14.824977,2464.4894895958,48140.3782279048
172.30.6.255,58089,122.15.34.40,80,34,26236,13,1146,21,25090,4857.692686,14.824619,618.4307333632,13539.639703388
172.30.6.255,58090,210.176.156.41,80,16,4465,9,4028,7,437,4857.693063,7.971316,4042.4943635404,438.5725017049
172.30.6.255,58093,172.217.166.206,443,17,1779,10,1150,7,629,4871.403517,134.042574,68.6349099802,37.5403116326
172.30.6.255,58092,172.217.166.206,443,54,9840,30,6097,24,3743,4871.403517,134.042972,363.8833075113,223.3910480588
172.30.6.255,58095,172.217.166.197,443,17,1779,10,1150,7,629,4872.41926,132.986252,69.1800833668,37.8384977719
172.30.6.255,58094,172.217.166.197,443,56,18488,30,9754,26,8734,4872.419261,133.028041,586.5830949131,525.242644143
172.30.6.255,58096,172.217.166.195,443,28,3286,16,1952,12,1334,4873.073551,132.379655,117.9637460152,80.61661741
172.30.6.255,58097,172.217.166.195,443,17,1779,11,1204,6,575,4873.073551,132.374074,72.763492948,34.7500070142
172.30.6.255,58098,161.69.38.37,80,7,398,4,228,3,170,4873.358189,0.562961,3240.0112974047,2415.7978971877
172.30.6.255,58099,161.69.38.37,80,7,398,4,228,3,170,4873.908177,0.586123,3111.9747902742,2320.3320804676
172.30.6.255,58100,74.125.68.188,5228,63,8720,31,2566,32,6154,4875.533059,990.690113,20.7209093243,49.6946515908
172.30.6.255,58101,157.240.16.39,443,19,1945,10,1137,9,808,4876.081288,61.067197,148.9506715037,105.8506091249
172.30.6.255,58102,157.240.16.39,443,27,5488,15,3433,12,2055,4876.081329,61.066927,449.7360739963,269.2128261178
172.30.6.255,58103,157.240.16.16,443,373,101431,204,35615,169,65816,4889.939378,985.445735,289.1280462034,534.3044079439
172.30.6.255,58106,35.190.41.40,443,74,17868,32,5132,42,12736,4890.842296,8.355178,4913.8390588448,12194.593580173
172.30.6.255,58105,216.58.196.194,80,38,10281,20,5761,18,4520,4890.918208,8.00226,5759.3729771338,4518.7234606223
172.30.6.255,58104,216.58.196.194,80,14,2828,8,1623,6,1205,4890.918208,8.001986,1622.5971902475,1204.7009329934
172.30.6.255,58107,35.190.43.164,80,10,1573,6,1119,4,454,4891.836149,7.116414,1257.9369328429,510.3694079631
172.30.6.255,58108,210.176.156.41,80,10,572,8,456,2,116,4891.845798,14.349832,254.2190040971,64.6697466563
172.30.6.255,58109,103.243.221.87,80,25,17702,10,5293,15,12409,4891.848268,7.249081,5841.292158275,13694.4255416653
172.30.6.255,58110,103.243.221.87,80,25,14338,11,5347,14,8991,4891.848771,7.24879,5901.1228080828,9922.7595226243
172.30.6.255,58111,103.243.221.87,80,15,5499,9,4317,6,1182,4891.849152,7.247958,4764.928273591,1304.6433216087
172.30.6.255,58112,103.231.98.53,80,19,6478,10,5744,9,734,4891.849568,7.139964,6435.8867915861,822.4131102062
172.30.6.255,58113,173.241.248.220,80,10,2494,6,1300,4,1194,4891.851802,7.221039,1440.2359549644,1322.8013309442
172.30.6.255,58114,35.190.43.164,80,10,1629,6,1175,4,454,4891.866221,7.087029,1326.3668033531,512.4855563594
172.30.6.255,58115,210.176.156.41,80,9,518,7,402,2,116,4892.098051,10.229577,314.38250086,90.7173385566
172.30.6.255,58116,54.194.27.245,443,25,8971,13,3428,12,5543,4893.328381,7.249999,3782.6212113962,6116.4146367471
172.30.6.255,58117,54.194.27.245,443,22,8301,11,2824,11,5477,4893.328778,5.754904,3925.6953721554,7613.6804367193
172.30.6.255,58118,54.194.27.245,443,6,348,4,228,2,120,4893.480055,6.579043,277.2439699817,145.9178789377
172.30.6.255,58119,157.240.16.39,443,113,47204,56,11496,57,35708,4894.929778,4.131979,22257.6155396687,69134.9108986161
172.30.6.255,58120,157.240.16.37,443,23,6107,12,2731,11,3376,4895.105315,3.924749,5566.7254135236,6881.45917102
172.30.6.255,58121,157.240.16.63,443,1244,1083023,480,32859,764,1050164,4895.140764,3.937491,66761.2954543796,2133671.41664546
172.30.6.255,58122,180.149.59.210,80,8,468,5,282,3,186,4895.52275,10.432018,216.2572955683,142.637790694
172.30.6.255,58123,157.240.16.63,443,36,12150,21,10440,15,1710,4895.916745,3.320791,25150.6342916553,4119.5004443229
172.30.6.255,58125,157.240.16.39,443,302,152683,150,49917,152,102766,4899.588654,29.344272,13608.6524825014,28016.6432481267
172.30.6.255,58126,216.58.196.194,80,42,11502,22,6432,20,5070,4899.836254,9.116973,5643.9785441944,4448.8450278398
172.30.6.255,58127,35.190.41.40,443,82,18438,35,5708,47,12730,4899.843669,9.106691,5014.3350641853,11182.9862240852
172.30.6.255,58128,216.58.196.194,80,10,1609,6,939,4,670,4899.844212,9.287792,808.8036424588,577.1016405191
172.30.6.255,58129,172.217.166.197,443,33,8992,17,3973,16,5019,4903.838038,5.120253,6207.5057619223,7841.8000048044
172.30.6.255,58130,157.240.16.20,443,305,227851,120,9383,185,218468,4906.254852,2.683205,27975.4994493497,651364.319908402
172.30.6.255,58131,157.240.16.20,443,47,26380,20,2420,27,23960,4906.254852,2.766058,6999.1301700828,69297.173088919
172.30.6.255,58132,172.217.166.197,443,30,6666,16,4038,14,2628,4909.833223,9.131529,3537.6331827889,2302.3526509087
172.30.6.255,58133,216.58.196.194,80,10,1592,6,922,4,670,4910.814993,8.141315,905.9961443575,658.3703001297
172.30.6.255,58134,35.190.41.40,443,53,15006,24,3966,29,11040,4910.821336,8.142438,3896.6216261027,10846.8741180469
172.30.6.255,58135,216.58.196.194,80,22,5310,12,3005,10,2305,4910.822042,8.092571,2970.6257751708,2278.6330821194
172.30.6.255,58136,157.240.16.20,443,126,88931,55,4950,71,83981,4912.901949,6.032254,6564.710305634,111375.946702514
172.30.6.255,58137,157.240.16.17,443,1650,1502670,607,37889,1043,1464781,4915.998931,12.935201,23433.1109350365,905919.281810912
172.30.6.255,58138,157.240.16.20,443,499,365192,223,22587,276,342605,4918.729985,10.203712,17708.849485363,268612.050202895
172.30.6.255,58139,157.240.16.20,443,6,348,4,228,2,120,4918.980893,9.951714,183.2850099993,96.4657947365
172.30.6.255,58140,157.240.16.20,443,113,52768,62,6105,51,46663,4919.277385,9.656638,5057.6608546373,38657.7605994985
172.30.6.255,58141,157.240.16.17,443,1749,1515804,702,44420,1047,1471384,4935.641728,23.297398,15253.2055296472,505252.646668941
172.30.6.255,58142,157.240.16.17,443,6,348,4,228,2,120,4935.892719,15.98581,114.101193496,60.0532597347
172.30.6.255,58143,157.240.16.39,443,29,5474,16,3329,13,2145,4937.092331,61.030326,436.3732220601,281.1716915948
172.30.6.255,58144,157.240.16.39,443,19,1933,10,1125,9,808,4937.092338,61.030693,147.4667836395,105.9139210495
172.30.6.255,58145,216.58.196.194,80,72,20359,37,11391,35,8968,4950.813185,163.181425,558.4459138042,439.6578838553
172.30.6.255,58146,35.190.41.40,443,361,93807,149,23084,212,70723,4950.837232,163.412867,1130.0946087679,3462.2977393818
172.30.6.255,58147,216.58.196.194,80,136,41227,71,23095,65,18132,4950.83858,163.155536,1132.4163710878,889.0657562487
172.30.6.255,58148,35.190.43.164,80,10,1573,6,1119,4,454,4957.832071,1.1219,7979.3207950791,3237.3651840625
172.30.6.255,58149,103.243.221.87,80,15,5491,9,4317,6,1174,4957.836172,1.245004,27739.6699127199,7543.7508634545
172.30.6.255,58150,103.243.221.87,80,19,7345,10,5293,9,2052,4957.83744,1.244753,34017.9939313276,13188.1586146012
172.30.6.255,58151,103.231.98.53,80,19,6478,10,5744,9,734,4957.837747,1.165989,39410.3203374961,5036.0680932664
172.30.6.255,58152,103.243.221.87,80,25,14268,11,5346,14,8922,4957.840311,1.241926,34436.8344007699,57472.0232928674
172.30.6.255,58153,210.176.156.41,80,14,4353,7,3916,7,437,4957.840615,0.881141,35553.901135012,3967.5829407559
172.30.6.255,58154,173.241.248.220,80,10,2494,6,1300,4,1194,4957.841213,1.203193,8643.6673085678,7938.8759741768
172.30.6.255,58155,157.240.16.39,443,36,19528,15,2777,21,16751,4957.871044,1.068033,20800.8554042892,125471.778493787
172.30.6.255,58156,35.190.43.164,80,10,1629,6,1175,4,454,4957.880473,1.073611,8755.4989656419,3382.9757705544
172.30.6.255,58157,180.149.59.232,80,12,4895,8,3668,4,1227,4958.01919,0.892997,32860.1327888028,10992.1981820777
172.30.6.255,58158,176.34.147.227,443,42,14341,23,7880,19,6461,4958.529637,155.58522,405.179875055,332.2166462856
172.30.6.255,58159,176.34.147.227,443,28,9147,15,3538,13,5609,4958.529827,132.302036,213.9347273537,339.1633368363
172.30.6.255,58160,176.34.147.227,443,35,13546,19,7499,16,6047,4958.721205,155.38954,386.0748928145,311.3208263568
172.30.6.255,58161,176.34.147.227,443,7,402,5,282,2,120,4958.863053,13.57316,166.2103740028,70.7278187246
172.30.6.255,58162,103.243.221.17,80,32,18365,19,15252,13,3113,4958.879925,13.336043,9149.3406252513,1867.4204934702
172.30.6.255,58163,35.190.43.164,80,8,469,5,283,3,186,4962.252778,48.457541,46.7213142326,30.7072948667
172.30.6.255,58164,35.190.43.164,80,22,5364,13,4164,9,1200,4962.504408,151.490409,219.8951090032,63.3703484159
172.30.6.255,58165,157.240.16.17,443,6,348,4,228,2,120,4965.081759,45.645369,39.960242188,21.0317064147
172.30.6.255,58166,157.240.16.17,443,4684,4380278,1661,100624,3023,4279654,4965.334813,133.540023,6028.0954122646,256381.803977974
172.30.6.255,58167,172.217.166.197,443,52,9608,26,5267,26,4341,4966.840334,147.396303,285.8687710777,235.6097086099
172.30.6.255,58168,13.250.67.150,443,27,9545,14,2542,13,7003,4971.777419,69.552734,292.3824676683,805.4895440918
172.30.6.255,58170,157.240.16.39,443,28,5560,16,3467,12,2093,4998.096413,61.318096,452.3297657514,273.0678395494
172.30.6.255,58171,157.240.16.39,443,19,1933,11,1179,8,754,4998.096413,61.280965,153.9140253421,98.4318703206
172.30.6.255,58172,205.185.216.10,443,38906,36549251,13968,819644,24938,35729607,5010.736518,871.518435,7523.8247828917,327975.68533361
172.30.6.255,58173,103.243.221.109,80,41,24478,24,20331,17,4147,5023.84445,17.686243,9196.300197843,1875.808219982
172.30.6.255,58174,103.231.98.53,80,19,6478,10,5744,9,734,5023.847089,43.357222,1059.8465003131,135.433031203
172.30.6.255,58175,210.176.156.41,80,14,4353,7,3916,7,437,5023.847407,1.179922,26550.9076023815,2962.9077176304
172.30.6.255,58176,173.241.248.220,80,13,2669,7,1355,6,1314,5023.848723,66.176049,163.8054879946,158.8490119741
172.30.6.255,58177,103.243.221.51,80,27,17918,12,5401,15,12517,5023.860959,17.669734,2445.3112876515,5667.0915362959
172.30.6.255,58178,103.243.221.51,80,25,14098,11,5347,14,8751,5023.861216,17.669055,2420.95573306,3962.1813390701
172.30.6.255,58179,103.243.221.51,80,16,5545,9,4317,7,1228,5023.86147,17.669224,1954.5849891314,555.9949888009
172.30.6.255,58180,35.190.43.164,80,21,5179,12,3979,9,1200,5023.883433,90.111524,353.2511557567,106.5346536587
172.30.6.255,58181,210.176.156.41,80,11,615,10,553,1,62,5024.097752,61.688978,71.7145938129,8.0403342069
172.30.6.255,58182,180.149.59.210,80,20,9565,13,7165,7,2400,5024.672315,89.281483,642.0144253204,215.0501913146
172.30.6.255,58183,157.240.16.39,443,160,120732,60,12246,100,108486,5041.332997,72.753658,1346.5714672381,11929.1321406823
172.30.6.255,58184,157.240.16.20,443,50,13762,25,2824,25,10938,5041.336432,65.242732,346.2761185415,1341.2068642374
172.30.6.255,58185,157.240.16.20,443,453,305989,204,19546,249,286443,5041.907503,72.359456,2160.9891594542,31668.894802084
172.30.6.255,58186,157.240.16.39,443,5,330,1,66,4,264,5059.089482,15.066961,35.0435631976,140.1742527906
172.30.6.255,58187,157.240.16.39,443,5,330,1,66,4,264,5059.089495,15.066141,35.0454705024,140.1818820095
172.30.6.255,58188,157.240.16.39,443,27,5329,15,3275,12,2054,5059.390665,60.762879,431.1843090911,270.4282659154
172.30.6.255,58189,157.240.16.39,443,19,1933,10,1125,9,808,5059.390665,60.76312,148.1161599339,106.3803175347
172.30.6.255,58190,172.217.161.2,80,6,348,4,228,2,120,5068.233876,13.64532,133.6722040964,70.3537916297
172.30.6.255,58191,173.241.248.220,80,9,2437,6,1300,3,1137,5089.846439,24.264092,428.616904354,374.8749386542
172.30.6.255,58192,210.176.156.41,80,14,5527,8,3969,6,1558,5089.846708,24.22377,1310.7786277694,514.5359289656
172.30.6.255,58193,103.231.98.53,80,19,6478,10,5744,9,734,5089.850746,24.184502,1900.0597986264,242.8001205069
172.30.6.255,58194,103.243.221.87,80,7,406,5,294,2,112,5089.889219,24.252474,96.9797967828,36.9446844887
172.30.6.255,58195,103.243.221.87,80,32,22731,13,5455,19,17276,5089.889511,11.497108,3795.737154074,12021.1100043598
172.30.6.255,58196,103.243.221.87,80,15,5491,9,4317,6,1174,5089.889756,11.49652,3004.0394832522,816.942866189
172.30.6.255,58197,103.243.221.46,80,39,24317,23,20223,16,4094,5089.890018,24.25193,6670.9742276181,1350.4904558111
172.30.6.255,58198,103.243.221.46,80,6,340,4,228,2,112,5090.091772,11.294884,161.4890422956,79.3279506014
172.30.6.255,58199,103.243.221.87,80,26,14184,11,5347,15,8837,5090.094918,11.291701,3788.2689242303,6260.8813322279
172.30.6.255,58200,157.240.16.17,443,1990,1692911,814,57956,1176,1634955,5101.17252,22.806148,20329.9566415164,573513.77356668
172.30.6.255,58201,157.240.16.39,443,28,5505,16,3373,12,2132,5120.092457,61.055971,441.9551365418,279.3502375058
172.30.6.255,58202,157.240.16.39,443,19,1933,10,1125,9,808,5120.09246,61.056029,147.4055903636,105.8699706789
172.30.6.255,58203,157.240.16.17,443,2230,1970995,868,54572,1362,1916423,5125.7982,38.178719,11435.0615063854,401568.842579558
172.30.6.255,58204,103.243.221.46,80,54,37945,34,31998,20,5947,5150.829354,13.286384,19266.6416987496,3580.8087437485
172.30.6.255,58205,161.69.226.24,443,61,14594,39,9370,22,5224,5155.096744,701.847706,106.8037971189,59.5456815527
172.30.6.255,58206,103.243.221.87,80,25,14382,11,5347,14,9035,5155.860398,8.254855,5181.9202154368,8756.0593129739
172.30.6.255,58207,173.241.248.220,80,10,2494,6,1300,4,1194,5155.861532,8.221141,1265.0312164698,1161.8825172808
172.30.6.255,58208,103.243.221.87,80,31,20731,13,5455,18,15276,5155.863205,1.53268,28473.0015397818,79734.8435420177
172.30.6.255,58209,103.243.221.87,80,16,5908,9,4317,7,1591,5155.864289,8.25069,4185.8317304372,1542.6588564108
172.30.6.255,58210,210.176.156.41,80,15,4359,10,4081,5,278,5155.864598,121.167431,269.4453429486,18.3547672972
172.30.6.255,58211,103.231.98.53,80,19,6478,10,5744,9,734,5155.886353,8.155493,5634.4846350796,720.0055226581
172.30.6.255,58212,35.190.43.164,80,10,1573,6,1119,4,454,5155.945795,8.048856,1112.2077472873,451.2442513569
172.30.6.255,58213,35.190.43.164,80,10,1629,6,1175,4,454,5155.946041,8.048203,1167.9625874248,451.2808635667
172.30.6.255,58214,180.149.59.210,80,12,4893,8,3668,4,1225,5156.022654,7.934423,3698.3155548931,1235.1244696685
172.30.6.255,58215,54.194.27.245,443,24,10309,13,4820,11,5489,5157.21345,6.885437,5600.2255194551,6377.5182315953
172.30.6.255,58216,54.194.27.245,443,25,8953,12,3224,13,5729,5157.213893,6.871582,3753.4297051248,6669.7887036787
172.30.6.255,58217,54.194.27.245,443,22,7159,12,1856,10,5303,5157.390337,6.712771,2211.9032512802,6319.89382626
172.30.6.255,58218,13.107.5.88,443,33,8935,17,1966,16,6969,5163.754646,1.65734,9489.9055112423,33639.4463417334
172.30.6.255,58219,52.175.39.99,443,23,5840,13,1338,10,4502,5164.261003,1.188594,9005.5982109941,30301.347642672
172.30.6.255,58220,157.240.16.17,443,414,337472,177,12144,237,325328,5165.049788,8.898223,10918.13500291,292488.06194225
172.30.6.255,58222,13.107.5.88,443,29,8739,14,1824,15,6915,5166.22058,125.654755,116.1277183661,440.2539322925
172.30.6.255,58221,204.79.197.219,443,47,17083,20,6214,27,10869,5166.250423,123.986227,400.9477601089,701.3037020636
172.30.6.255,58223,157.240.16.17,443,5410,4902962,2038,124827,3372,4778135,5174.822812,84.182239,11862.549771336,454075.354303657
172.30.6.255,58224,172.217.167.2,80,44,11665,23,6529,21,5136,5174.949883,84.069328,621.2967468944,488.7394841553
172.30.6.255,58225,172.217.167.2,80,63,17775,33,9958,30,7817,5174.951657,84.067075,947.6242631256,743.8821916904
172.30.6.255,58226,35.190.41.40,443,173,45344,71,11241,102,34103,5175.004178,84.014279,1070.3894751034,3247.3527505961
172.30.6.255,58227,157.240.16.39,443,5,330,1,66,4,264,5181.087859,15.061066,35.0572794781,140.2291179124
172.30.6.255,58228,157.240.16.39,443,5,330,1,66,4,264,5181.087877,15.062358,35.0542723789,140.2170895155
172.30.6.255,58229,157.240.16.39,443,27,5328,16,3329,11,1999,5181.394735,61.119388,435.73734737,261.6518346028
172.30.6.255,58230,157.240.16.39,443,19,1933,11,1179,8,754,5181.394772,60.966028,154.7091111135,98.9403475654
172.30.6.255,58231,172.217.166.206,443,39,6271,20,3783,19,2488,5182.407605,61.076254,495.5117253917,325.8877009713
172.30.6.255,58232,172.217.166.206,443,17,1779,10,1150,7,629,5182.407605,61.071884,150.6421514686,82.3947071946
172.30.6.255,58233,35.190.43.164,80,14,2928,8,2140,6,788,5201.840204,57.17862,299.4126126164,110.250999412
172.30.6.255,58234,172.217.166.197,443,34,6954,18,4018,16,2936,5211.879056,47.141001,681.8692712953,498.2499204885
172.30.6.255,58235,210.176.156.41,80,14,5528,8,3970,6,1558,5221.848498,37.250497,852.6060739539,334.599562524
172.30.6.255,58236,173.241.248.220,80,11,2548,7,1354,4,1194,5221.84959,37.7272,287.1138064844,253.1860302381
172.30.6.255,58237,103.243.221.75,80,41,24405,25,20311,16,4094,5221.875464,38.284483,4244.2260484489,855.490199515
172.30.6.255,58238,103.231.98.53,80,19,6478,10,5744,9,734,5221.882096,37.191612,1235.5474132178,157.8850629007
172.30.6.255,58239,103.243.221.109,80,17,5606,10,4371,7,1235,5221.882947,37.67515,928.1449443466,262.2418225276
172.30.6.255,58240,103.243.221.109,80,25,14095,11,5347,14,8748,5221.883165,37.675511,1135.3794245817,1857.5461391884
172.30.6.255,58241,103.243.221.109,80,31,18282,13,5455,18,12827,5221.883369,37.674729,1158.3361356096,2723.7355841365
172.30.6.255,58242,35.190.43.164,80,10,1629,6,1175,4,454,5221.892002,37.126358,253.1893917523,97.8280713664
172.30.6.255,58243,180.149.59.232,80,12,4896,8,3669,4,1227,5222.021523,37.200084,789.0304763828,263.8703719056
172.30.6.255,58244,103.243.221.75,80,8,448,5,282,3,166,5222.093247,40.080085,56.2873057779,33.1336622664
172.30.6.255,58245,103.243.221.109,80,8,448,5,282,3,166,5222.100363,40.077175,56.291392794,33.1360680986
172.30.6.255,58246,176.34.147.227,443,22,8291,11,2814,11,5477,5222.603076,36.545685,615.9961155469,1198.9377131664
172.30.6.255,58247,176.34.147.227,443,22,8809,12,3386,10,5423,5222.603293,36.542345,741.2770034326,1187.2253956335
172.30.6.255,58248,176.34.147.227,443,20,7186,10,1763,10,5423,5222.760388,36.398796,387.4853442955,1191.9075565027
172.30.6.255,58249,176.34.147.227,443,6,348,4,228,2,120,5222.843482,36.312612,50.2304819053,26.4370957396
172.30.6.255,58250,157.240.16.39,443,5,330,1,66,4,264,5242.082605,15.053555,35.0747713746,140.2990854984
172.30.6.255,58251,157.240.16.39,443,5,330,1,66,4,264,5242.082606,15.053182,35.0756404858,140.3025619434
172.30.6.255,58252,157.240.16.39,443,19,1933,10,1125,9,808,5242.384895,60.776283,148.0840807589,106.3572775584
172.30.6.255,58253,157.240.16.39,443,28,5548,14,3345,14,2203,5242.384905,60.776357,440.3027973526,289.9811846241
172.30.6.255,58254,172.217.194.189,443,22,5002,12,1094,10,3908,5243.530455,96.693636,90.5126786214,323.3304826804
172.30.6.255,58255,172.217.194.189,443,96,14863,49,6042,47,8821,5243.530572,620.694812,77.874019672,113.691944311
172.30.6.255,58256,157.240.16.17,443,23,4076,12,1771,11,2305,5260.779621,8.219282,1723.751539368,2243.5049679522
172.30.6.255,58257,172.217.167.2,80,9,1555,6,939,3,616,5264.57085,4.402625,1706.2547911758,1119.3322165754
172.30.6.255,58258,172.217.167.2,80,30,7788,16,4368,14,3420,5264.594389,4.420281,7905.3797711056,6189.6517438601
172.30.6.255,58259,35.190.41.40,443,179,47707,77,12244,102,35463,5264.594656,59.401064,1648.9940314874,4776.0760649002
172.30.6.255,58260,157.240.16.39,443,40,8841,20,3826,20,5015,5268.516064,55.694872,549.5658559014,720.3535722283
172.30.6.255,58261,172.217.166.197,443,7,402,4,228,3,174,5268.835556,11.059821,164.9212948383,125.8609881661
172.30.6.255,58262,172.217.167.2,80,70,20201,36,11311,34,8890,5268.979168,55.014562,1644.8008801742,1292.7486362611
172.30.6.255,58263,172.217.166.197,443,32,6802,17,3962,15,2840,5269.086808,54.909136,577.2445590839,413.7744946488
172.30.6.255,58264,172.217.167.2,80,22,5321,12,3001,10,2320,5269.837998,54.122641,443.5851532079,342.9248768551
172.30.6.255,58265,157.240.16.20,443,95,64127,43,3701,52,60426,5272.375815,51.838763,571.1556041567,9325.2225173661
172.30.6.255,58266,35.190.43.164,80,10,1573,6,1119,4,454,5287.834124,36.158338,247.5777509464,100.4470946646
172.30.6.255,58267,103.243.221.75,80,40,24330,23,20183,17,4147,5287.835809,28.041203,5758.0981814511,1183.1161451954
172.30.6.255,58268,103.243.221.109,80,24,14008,10,5292,14,8716,5287.839868,28.035664,1510.0765938699,2487.1178367668
172.30.6.255,58269,103.243.221.109,80,34,22448,13,5455,21,16993,5287.840098,28.035609,1556.5918329079,4848.9761716964
172.30.6.255,58270,103.243.221.109,80,16,5544,9,4317,7,1227,5287.840764,28.034943,1231.8912151881,350.1344732536
172.30.6.255,58271,103.231.98.53,80,19,6478,10,5744,9,734,5287.842168,36.225113,1268.5122610936,162.097492974
172.30.6.255,58272,173.241.248.220,80,10,2493,6,1300,4,1193,5287.842983,36.265495,286.7739706848,263.1702669438
172.30.6.255,58273,35.190.43.164,80,6,348,4,228,2,120,5287.876605,27.847083,65.5005768468,34.4739878141
172.30.6.255,58274,210.176.156.41,80,14,5528,8,3970,6,1558,5287.876908,36.195672,877.4529728306,344.3505621335
172.30.6.255,58275,180.149.59.232,80,12,4896,8,3669,4,1227,5288.004411,35.955534,816.3416513297,273.0038719492
172.30.6.255,58276,35.190.43.164,80,14,2984,8,2196,6,788,5288.08533,35.907557,489.2563423348,175.5619297631
172.30.6.255,58277,52.213.19.114,443,22,8557,11,3080,11,5477,5288.737872,35.380887,696.4212061727,1238.4087487688
172.30.6.255,58278,52.213.19.114,443,25,9669,13,4006,12,5663,5288.738447,35.380231,905.8165844084,1280.4890957326
172.30.6.255,58279,52.213.19.114,443,19,6444,10,1207,9,5237,5289.021465,26.838571,359.780705165,1561.0369121366
172.30.6.255,58281,157.240.16.39,443,4,264,1,66,3,198,5303.100163,15.066986,35.0435050514,105.1305151541
172.30.6.255,58282,157.240.16.39,443,4,264,1,66,3,198,5303.100166,15.066847,35.0438283471,105.1314850413
172.30.6.255,58283,157.240.16.39,443,27,5329,15,3274,12,2055,5303.401002,60.721534,431.3461514329,270.7441481963
172.30.6.255,58284,157.240.16.39,443,19,1933,10,1125,9,808,5303.401002,60.721602,148.2174333938,106.4530543842
172.30.6.255,58285,52.84.108.179,443,16,3785,10,2880,6,905,5315.682082,8.278343,2783.1656649163,874.5711551213
172.30.6.255,58286,151.101.1.69,443,76,49717,28,3452,48,46265,5320.813231,3.169239,8713.7637773615,116785.133592014
172.30.6.255,58287,23.58.57.98,443,16,2742,8,1838,8,904,5320.816051,3.176019,4629.6952253743,2277.064463405
172.30.6.255,58288,13.229.196.49,443,25,10814,12,3895,13,6919,5320.855733,3.183681,9787.4127464418,17386.1640032429
172.30.6.255,58289,192.0.73.2,443,44,13101,27,3213,17,9888,5320.913863,3.073666,8362.6522855763,25736.0428881974
172.30.6.255,58290,151.101.65.69,443,16,5714,10,1186,6,4528,5320.919236,3.029508,3131.8616752286,11957.0570534865
172.30.6.255,58291,13.228.208.99,443,20,7631,9,1141,11,6490,5320.936471,3.104454,2940.2915939483,16724.3579708366
172.30.6.255,58292,52.84.110.11,443,11,1405,7,958,4,447,5320.978593,2.971188,2579.4396046292,1203.5589804481
172.30.6.255,58293,104.16.0.35,443,28,7211,14,1952,14,5259,5321.620368,2.358146,6622.1514698398,17841.1345183849
172.30.6.255,58294,35.171.73.174,443,25,6022,14,1855,11,4167,5323.293739,10.932659,1357.4007933477,3049.2124559999
172.30.6.255,58295,35.171.73.174,443,6,348,4,228,2,120,5323.381826,0.805858,2263.4260626545,1191.2768750813
172.30.6.255,58296,157.240.16.39,443,6,348,4,228,2,120,5324.898488,9.103099,200.3713240952,105.4585916291
172.30.6.255,58297,157.240.16.39,443,82,55471,33,5307,49,50164,5325.149711,8.852112,4796.1435643835,45335.1697312482
172.30.6.255,58298,157.240.16.20,443,219,144178,107,11338,112,132840,5326.347453,7.655796,11847.755608953,138812.476194507
172.30.6.255,58299,157.240.16.17,443,13,1754,8,1037,5,717,5326.390235,7.562849,1096.9411130647,758.444337577
172.30.6.255,58300,157.240.16.17,443,1736,1458878,727,55412,1009,1403466,5326.607029,7.396029,59937.0283702204,1518075.17250126
172.30.6.255,58301,157.240.16.17,443,15,4922,8,1025,7,3897,5326.657027,7.293757,1124.2491352537,4274.3403708133
172.30.6.255,58302,157.240.16.17,443,15,4921,8,1025,7,3896,5326.657369,7.294038,1124.2058239894,4273.0789173295
172.30.6.255,58303,157.240.16.17,443,15,4921,8,1025,7,3896,5326.657613,7.294343,1124.1588173192,4272.9002461225
172.30.6.255,58304,157.240.16.17,443,15,4922,8,1025,7,3897,5326.657849,7.294678,1124.1071915717,4273.8007078584
172.30.6.255,58305,157.240.16.17,443,1934,1708690,749,47375,1185,1661315,5337.288812,41.732068,9081.7450024283,318472.595223412
172.30.6.255,58306,35.190.43.164,80,6,348,4,228,2,120,5353.834324,5.154141,353.8902020725,186.2580010908
172.30.6.255,58307,103.231.98.53,80,19,6478,10,5744,9,734,5353.843865,5.227364,8790.6638986681,1123.3195162992
172.30.6.255,58308,173.241.248.220,80,10,2494,6,1300,4,1194,5353.845043,5.288399,1966.5687101143,1806.2177229819
172.30.6.255,58309,103.243.221.109,80,38,24224,23,20183,15,4041,5353.876704,5.288968,30528.4509189704,6112.3455464282
172.30.6.255,58310,103.243.221.51,80,14,5437,9,4317,5,1120,5353.882145,5.28158,6538.9523589523,1696.4620435549
172.30.6.255,58311,103.243.221.51,80,33,19257,17,5743,16,13514,5353.882416,5.281157,8699.608816781,20471.271730799
172.30.6.255,58312,103.243.221.51,80,17,7234,10,5292,7,1942,5353.882627,5.282158,8014.9060289375,2941.2221292888
172.30.6.255,58313,210.176.156.21,80,14,5528,8,3970,6,1558,5353.882872,5.2236,6080.0980166932,2386.0938816141
172.30.6.255,58314,180.149.59.232,80,12,4896,8,3669,4,1227,5353.88443,5.101824,5753.2364895375,1924.0177630588
172.30.6.255,58315,35.190.43.164,80,10,1573,6,1119,4,454,5353.890755,5.130317,1744.9214151877,707.9484562066
172.30.6.255,58316,35.190.43.164,80,10,1629,6,1175,4,454,5354.084978,4.935766,1904.4662976322,735.8533609575
172.30.6.255,58317,52.213.19.114,443,15,2985,8,2287,7,698,5354.574283,4.564184,4008.6026330228,1223.4388447092
172.30.6.255,58318,52.213.19.114,443,18,4641,10,3757,8,884,5354.574651,4.561314,6589.3293029151,1550.4304242153
172.30.6.255,58319,52.213.19.114,443,12,1416,6,904,6,512,5354.777033,4.362059,1657.9326414429,939.0060978084
172.30.6.255,58320,52.213.19.114,443,6,348,4,228,2,120,5354.935402,4.215264,432.7131112073,227.7437427407
172.30.6.255,58322,157.240.16.39,443,27,5457,16,3453,11,2004,5364.089628,61.922906,446.1030947094,258.9025779895
172.30.6.255,58321,157.240.16.39,443,19,1933,11,1179,8,754,5364.089632,61.90208,152.3696780464,97.4442215835
172.30.6.255,58323,172.217.167.2,80,9,1555,6,939,3,616,5372.999214,6.037753,1244.1714657755,816.1976814885
172.30.6.255,58324,172.217.167.2,80,66,19957,36,11268,30,8689,5373.016835,16.02499,5625.2141186984,4337.7250157411
172.30.6.255,58325,35.190.41.40,443,151,34878,68,10475,83,24403,5373.017338,26.026928,3219.7422607847,7500.8468152676
172.30.6.255,58326,172.217.167.2,80,14,2843,8,1623,6,1220,5379.112466,10.146062,1279.7083242739,961.9495721591
172.30.6.255,58327,204.79.197.200,443,31,13729,18,3503,13,10226,5383.93796,61.502058,455.6595488236,1330.1668701883
172.30.6.255,58328,157.240.16.17,443,6,348,4,228,2,120,5385.668545,3.358458,543.1063898968,285.8454683668
172.30.6.255,58329,157.240.16.17,443,5588,4918348,2185,136322,3403,4782026,5385.920004,133.119679,8192.4476395409,287382.063173394
172.30.6.255,58330,172.217.167.2,80,10,1582,6,912,4,670,5389.236719,9.77185,746.6344653265,548.5143550096
172.30.6.255,58331,172.217.167.2,80,14,2828,8,1608,6,1220,5419.159067,9.892129,1300.427845209,986.6430168874
172.30.6.255,58332,35.190.41.40,443,39,13827,19,3617,20,10210,5419.16603,10.14253,2852.9370876892,8053.2174910993
172.30.6.255,58333,172.217.167.2,80,9,1555,6,939,3,616,5419.166361,9.849805,762.6546921487,500.3144732307
172.30.6.255,58334,35.190.43.164,80,10,1573,6,1119,4,454,5419.829315,9.222968,970.6203035726,393.7994797336
172.30.6.255,58335,103.243.221.109,80,39,24579,23,20487,16,4092,5419.834289,9.369621,17492.2763684895,3493.844628294
172.30.6.255,58336,103.243.221.51,80,19,7345,11,5347,8,1998,5419.839133,9.970597,4290.2145177467,1603.1136350211
172.30.6.255,58337,210.176.156.21,80,15,5549,8,3971,7,1578,5419.839548,9.29707,3416.9905142156,1357.8471496933
172.30.6.255,58338,103.231.98.53,80,19,6478,10,5744,9,734,5419.839835,9.253918,4965.6804825803,634.5420393826
172.30.6.255,58339,103.243.221.51,80,17,5606,10,4371,7,1235,5419.840822,9.903855,3530.7463608869,997.5913419573
172.30.6.255,58340,103.243.221.51,80,25,13892,12,5401,13,8491,5419.841455,9.977221,4330.6648213966,6808.3086462653
172.30.6.255,58341,173.241.248.220,80,10,2495,6,1300,4,1195,5419.842282,9.321976,1115.6432927954,1025.5336422235
172.30.6.255,58342,35.190.43.164,80,10,1629,6,1175,4,454,5419.881702,9.170289,1025.0494831733,396.0616726474
172.30.6.255,58343,180.149.59.232,80,12,4895,8,3668,4,1227,5420.146205,8.866799,3309.4242916749,1107.0511466426
172.30.6.255,58344,52.213.19.114,443,18,4641,10,3757,8,884,5420.598245,8.57543,3504.897130523,824.6816777701
172.30.6.255,58345,52.213.19.114,443,15,2949,8,2251,7,698,5420.598517,8.590022,2096.3857834126,650.0565423465
172.30.6.255,58346,52.213.19.114,443,12,1416,6,904,6,512,5420.803409,8.37347,863.6801708253,489.1639905559
172.30.6.255,58347,52.213.19.114,443,7,402,5,282,2,120,5420.864334,8.842499,255.1314961981,108.5665941268
172.30.6.255,58348,157.240.16.39,443,5,330,1,66,4,264,5425.092136,15.062413,35.0541443791,140.2165775165
172.30.6.255,58349,157.240.16.39,443,5,330,1,66,4,264,5425.092136,15.062415,35.0541397246,140.2165588984
172.30.6.255,58350,157.240.16.39,443,18,1879,10,1125,8,754,5425.393742,60.755479,148.1347879753,99.2832267852
172.30.6.255,58351,157.240.16.39,443,27,5491,15,3397,12,2094,5425.393743,60.755729,447.2993814295,275.7270841076
172.30.6.255,58352,35.190.43.164,80,6,348,4,228,2,120,5441.833612,7.183999,253.8975854535,133.6303081334
172.30.6.255,58353,35.190.43.164,80,10,1703,6,1249,4,454,5442.086218,6.962775,1435.0600155829,521.6311025417
172.30.6.255,58354,172.217.166.197,443,46,22306,22,4405,24,17901,5450.875188,8.183768,4306.0849232286,17499.0297867684
172.30.6.255,58355,184.29.25.174,443,51,34537,21,2939,30,31598,5459.377062,62.570635,375.7673228025,4039.9781782621
172.30.6.255,58358,172.217.166.206,443,102,18011,56,11399,46,6612,5462.403134,117.068214,778.9646470561,451.839130304
172.30.6.255,58359,172.217.166.206,443,18,1887,11,1246,7,641,5462.403134,97.767904,101.9557502225,52.4507511177
172.30.6.255,58357,65.52.162.217,443,21,9872,13,1097,8,8775,5462.502391,109.825783,79.9083763418,639.1941680944
172.30.6.255,58356,65.52.162.217,443,24,10205,14,2122,10,8083,5462.502522,1.534836,11060.4650920372,42130.8856451164
172.30.6.255,58360,172.217.166.206,443,32,4853,18,2661,14,2192,5464.400156,95.795053,222.2244190418,183.0574695752
172.30.6.255,58361,172.217.166.206,443,17,1779,10,1150,7,629,5464.400156,95.799467,96.0339372243,52.5263882731
172.30.6.255,58362,117.18.232.200,443,50,24832,24,2260,26,22572,5466.451573,109.822532,164.6292402,1644.2527476966
172.30.6.255,58363,172.217.167.42,443,17,1793,10,1164,7,629,5472.744911,87.425707,106.5132936243,57.5574413141
172.30.6.255,58364,172.217.167.42,443,40,6793,21,4156,19,2637,5472.745075,87.453563,380.1789070618,241.2251631189
172.30.6.255,58366,172.217.166.197,443,17,1779,10,1150,7,629,5474.426005,85.744367,107.2956780939,58.6860708879
172.30.6.255,58365,172.217.166.197,443,48,19310,26,6074,22,13236,5474.426005,85.768732,566.5467923672,1234.5757892282
172.30.6.255,58367,210.176.156.21,80,3,198,3,198,0,0,5484.862013,9.000552,175.9892059954,0
172.30.6.255,58368,103.243.221.109,80,17,7537,10,6336,7,1201,5484.885626,4.334739,11693.4375979733,2216.5117669138
172.30.6.255,58369,103.243.221.51,80,23,13609,11,5347,12,8262,5484.891539,4.328374,9882.6949796859,15270.399461785
172.30.6.255,58370,103.243.221.51,80,16,5545,9,4317,7,1228,5484.891802,3.458925,9984.6050434748,2840.1887869787
172.30.6.255,58371,103.243.221.51,80,19,7346,10,5293,9,2053,5484.892013,4.32827,9783.1235112413,3794.5876759075
172.30.6.255,58372,103.231.98.53,80,19,6478,10,5744,9,734,5484.89385,4.221218,10885.9575601174,1391.0676965749
172.30.6.255,58373,35.190.43.164,80,6,348,4,228,2,120,5484.915589,4.148003,439.7296723266,231.4366696456
172.30.6.255,58374,35.190.43.164,80,10,1573,6,1119,4,454,5484.91586,4.154794,2154.6194588709,874.1708975222
172.30.6.255,58375,173.241.248.220,80,11,3524,7,2318,4,1206,5484.930608,4.250774,4362.4996294792,2269.7042938533
172.30.6.255,58376,180.149.59.232,80,12,4896,8,3669,4,1227,5485.031938,3.995249,7346.726073895,2456.9182045978
172.30.6.255,58377,35.190.43.164,80,10,1629,6,1175,4,454,5485.105241,3.960344,2373.5311881998,917.0920505895
172.30.6.255,58378,103.243.221.109,80,30,18190,18,15131,12,3059,5485.106297,4.114033,29423.1961678491,5948.4209290497
172.30.6.255,58379,103.243.221.51,80,6,348,4,228,2,120,5485.110311,4.10909,443.8939035164,233.6283702718
172.30.6.255,58380,210.176.156.21,80,13,4249,7,3917,6,332,5485.112921,1.173241,26708.9199917058,2263.8145104024
172.30.6.255,58381,173.241.248.220,80,6,535,4,228,2,307,5485.113941,5.039888,361.9128044115,487.3124164664
172.30.6.255,58382,157.240.16.39,443,29,5490,16,3341,13,2149,5486.087126,61.0702,437.660266382,281.5120959159
172.30.6.255,58383,157.240.16.39,443,19,1933,10,1125,9,808,5486.087127,61.070617,147.3703794412,105.844681412
172.30.6.255,58384,52.213.19.114,443,27,9777,14,4048,13,5729,5486.31614,4.314163,7506.4386765173,10623.613433243
172.30.6.255,58385,52.213.19.114,443,20,7853,10,2430,10,5423,5486.317114,2.880882,6747.9334453836,15059.2769853149
172.30.6.255,58386,52.213.19.114,443,20,6624,10,1321,10,5303,5486.497492,12.688969,832.8493827986,3343.3764398038
172.30.6.255,58387,172.217.166.197,443,51,23621,26,5250,25,18371,5504.84146,4.238295,9909.6452700907,34676.2082393973
172.30.6.255,58388,172.217.166.197,443,54,23050,28,4869,26,18181,5512.837971,6.218506,6263.8839618389,23389.5408318326
172.30.6.255,58389,157.240.16.17,443,23,5182,12,1779,11,3403,5523.72001,15.340676,927.7296515486,1774.6284453176
172.30.6.255,58390,157.240.16.17,443,6,348,4,228,2,120,5523.925981,11.954207,152.5822666447,80.3064561288
172.30.6.255,58393,35.190.41.40,443,136,33272,59,9537,77,23735,5526.225334,22.84092,3340.3207926825,8313.1502583957
172.30.6.255,58391,216.58.196.162,80,59,16553,31,9286,28,7267,5526.256715,14.961871,4965.1544248712,3885.6102956644
172.30.6.255,58392,216.58.196.162,80,20,4207,11,2371,9,1836,5526.256722,13.122298,1445.4785282273,1119.3161441693
172.30.6.255,58394,157.240.16.39,443,39,8787,20,3815,19,4972,5529.69279,9.367303,3258.1416443986,4246.2595690563
172.30.6.255,58395,157.240.16.20,443,34,16983,15,1851,19,15132,5533.526836,5.532837,2676.3846467916,21879.5529309838
172.30.6.255,58396,216.58.196.162,80,17,4023,10,2307,7,1716,5539.974154,9.092491,2029.80679332,1509.8172766958
172.30.6.255,58397,216.58.196.162,80,10,1582,6,912,4,670,5541.838581,7.227129,1009.5295102661,741.6499691648
172.30.6.255,58398,157.240.16.39,443,29,5966,16,3473,13,2493,5547.098547,61.051143,455.093854672,326.6769305204
172.30.6.255,58399,157.240.16.39,443,19,1933,10,1125,9,808,5547.098627,61.050953,147.4178462046,105.8787730963
172.30.6.255,58400,35.190.43.164,80,10,1573,6,1119,4,454,5550.837111,8.208181,1090.6192248928,442.4853691701
172.30.6.255,58401,103.231.98.53,80,16,7695,11,7177,5,518,5550.843829,8.253072,6956.9246457566,502.1160605409
172.30.6.255,58402,210.176.156.21,80,15,4407,8,3970,7,437,5550.848482,1.475017,21531.9552249264,2370.142174633
172.30.6.255,58403,173.241.248.220,80,9,3415,6,2264,3,1151,5550.849451,1.050087,17248.094681685,8768.7972520404
172.30.6.255,58404,103.243.221.109,80,16,7940,10,6794,6,1146,5550.868441,8.359379,6501.9183841284,1096.7321854888
172.30.6.255,58405,103.243.221.51,80,7,414,5,294,2,120,5550.877289,8.348505,281.7270876642,114.9906480262
172.30.6.255,58406,103.243.221.51,80,3,198,3,198,0,0,5550.877543,9.001328,175.9740340536,0
172.30.6.255,58407,103.243.221.51,80,3,198,3,198,0,0,5550.877754,9.001274,175.9750897484,0
172.30.6.255,58408,35.190.43.164,80,10,1629,6,1175,4,454,5550.911908,8.130072,1156.2013226943,446.7365110666
172.30.6.255,58409,180.149.59.232,80,12,4896,8,3669,4,1227,5551.043345,7.966807,3684.2865654962,1232.1121874799
172.30.6.255,58410,103.243.221.109,80,31,18208,18,15086,13,3122,5551.089268,8.139396,14827.6358589744,3068.5323579291
172.30.6.255,58411,210.176.156.21,80,3,198,3,198,0,0,5551.09802,9.000428,175.9916306202,0
172.30.6.255,58412,103.243.221.51,80,25,11486,14,9327,11,2159,5551.098593,0.878957,84891.5248413841,19650.5631105981
172.30.6.255,58413,52.213.19.114,443,6,348,4,228,2,120,5551.952526,7.244609,251.7734221405,132.5123274424
172.30.6.255,58414,52.213.19.114,443,17,3809,9,2925,8,884,5552.039598,7.164182,3266.2486798914,987.1329343672
172.30.6.255,58415,52.213.19.114,443,12,1416,6,904,6,512,5552.312706,6.879944,1051.1713467435,595.3536831114
172.30.6.255,58416,216.58.196.162,80,10,1188,6,816,4,372,5552.843755,6.195242,1053.7118646859,480.368644195
172.30.6.255,58417,35.190.43.164,80,6,348,4,228,2,120,5561.831308,8.205859,222.2802024748,116.9895802499
172.30.6.255,58418,35.190.43.164,80,11,1757,7,1303,4,454,5562.082014,7.248869,1438.017434168,501.0436800555
172.30.6.255,58419,103.243.220.231,80,7,406,5,294,2,112,5571.880273,7.346913,320.1344564717,121.9559834178
172.30.6.255,58420,103.243.220.231,80,7,406,5,294,2,112,5571.881101,7.345602,320.1915921935,121.9777494071
172.30.6.255,58421,216.58.196.162,80,24,6431,13,3645,11,2786,5572.165262,6.890491,4231.9190316051,3234.602584925
172.30.6.255,58422,35.190.41.40,443,6,348,4,228,2,120,5572.173449,6.880096,265.1125798245,139.5329367497
172.30.6.255,58423,216.58.196.162,80,6,348,4,228,2,120,5572.174007,6.879336,265.1418683431,139.5483517595
172.30.6.255,58424,35.190.41.40,443,56,15962,27,4910,29,11052,5572.424771,6.627234,5927.057955099,13341.3125294815
172.30.6.255,58426,172.217.166.206,443,44,7324,25,4340,19,2984,5579.414244,63.037415,550.7840066094,378.6957317333
172.30.6.255,58425,172.217.166.206,443,17,1795,10,1166,7,629,5579.414324,63.037438,147.9755570015,79.8255792058
172.30.6.255,58427,157.240.16.20,443,68,54578,23,2284,45,52294,5587.105344,1.94541,9392.3645915244,215045.67160647
172.30.6.255,58428,157.240.16.39,443,79,54760,31,5271,48,49489,5591.955809,7.073976,5961.0041085808,55967.3937259638
172.30.6.255,58429,157.240.16.20,443,186,113322,84,8954,102,104368,5592.929631,6.102167,11738.7806659503,136827.45818002
172.30.6.255,58430,157.240.16.20,443,6,348,4,228,2,120,5592.975964,6.054657,301.2557110998,158.5556374209
172.30.6.255,58431,157.240.16.17,443,894,761614,359,26848,535,734766,5592.984796,6.048461,35510.5207754483,971838.62142778
172.30.6.255,58432,157.240.16.17,443,1236,1079046,493,31382,743,1047664,5604.264818,14.767566,17000.4996083981,567548.640039919
172.30.6.255,58433,157.240.16.39,443,29,5493,16,3341,13,2152,5608.085966,61.055675,437.7643847194,281.9721508279
172.30.6.255,58434,157.240.16.39,443,19,1933,10,1125,9,808,5608.085966,61.055815,147.4061070186,105.8703417521
172.30.6.255,58435,35.190.43.164,80,10,1573,6,1119,4,454,5616.836937,2.208605,4053.2372244022,1644.4769435912
172.30.6.255,58436,103.243.221.109,80,38,24224,23,20177,15,4047,5616.83908,2.387721,67602.5381524878,13559.3731428417
172.30.6.255,58437,103.243.221.51,80,14,7073,10,5292,4,1781,5616.846627,2.38054,17784.2002234779,5985.1966360571
172.30.6.255,58438,103.243.221.51,80,22,13478,10,5291,12,8187,5616.847948,2.379559,17788.1699928434,27524.4278456642
172.30.6.255,58439,103.243.221.51,80,16,5545,9,4317,7,1228,5616.848758,2.377664,14525.1810180098,4131.7864929618
172.30.6.255,58440,210.176.156.21,80,14,5525,8,3971,6,1554,5616.849783,2.315845,13717.6710876587,5368.2349207307
172.30.6.255,58441,103.231.98.53,80,19,6478,10,5744,9,734,5616.850037,2.258316,20347.9052532997,2600.1675584823
172.30.6.255,58442,173.241.248.220,80,10,2493,6,1300,4,1193,5616.851379,2.341957,4440.7305514139,4075.2242675667
172.30.6.255,58443,35.190.43.164,80,10,1629,6,1175,4,454,5616.895263,2.150966,4370.1295139037,1688.5436589892
172.30.6.255,58444,180.149.59.232,80,12,4894,8,3668,4,1226,5617.007575,2.002538,14653.404829267,4897.7847111999
172.30.6.255,58445,52.213.19.114,443,16,3835,9,3137,7,698,5617.69679,1.501247,16716.7694589881,3719.5744604315
172.30.6.255,58446,52.213.19.114,443,15,2905,8,2207,7,698,5617.697157,1.502998,11747.18795367,3715.2411380434
172.30.6.255,58447,52.213.19.114,443,15,2276,8,1578,7,698,5617.849488,1.349764,9352.7461096868,4137.019508594
172.30.6.255,58448,52.213.19.114,443,6,348,4,228,2,120,5617.972365,1.241822,1468.8095395315,773.057652385
172.30.6.255,58449,157.240.16.17,443,9,546,6,360,3,186,5624.484199,4.584337,628.2260662775,324.5834675767
172.30.6.255,58450,157.240.16.17,443,255,209466,101,7361,154,202105,5624.736277,4.332693,13591.5468739641,373172.066426098
172.30.6.255,58451,157.240.16.17,443,476,421853,176,12387,300,409466,5634.312939,4.741638,20899.1070174506,690843.122144782
172.30.6.255,58452,52.114.128.8,443,21,8639,13,3996,8,4643,5639.555583,1.44502,22122.8771920095,25704.8345351601
172.30.6.255,58453,52.138.216.83,443,27,7412,14,2530,13,4882,5640.644086,1.373702,14733.908809918,28431.2026917074
172.30.6.255,58455,172.217.166.206,443,17,1783,10,1154,7,629,5642.40979,83.059196,111.1496432015,60.5832977242
172.30.6.255,58454,172.217.166.206,443,47,9691,25,6891,22,2800,5642.409796,83.058298,663.7265791312,269.690091651
172.30.6.255,58456,157.240.16.17,443,6,348,4,228,2,120,5644.012903,5.058537,360.578562537,189.7781908089
172.30.6.255,58457,157.240.16.17,443,424,373074,158,10624,266,362450,5644.265208,4.806506,17682.6992414036,603265.657007411
172.30.6.255,58458,172.217.166.206,443,18,1883,11,1242,7,641,5654.411608,71.053744,139.8378106578,72.1707219256
172.30.6.255,58459,157.240.16.17,443,2512,2263344,958,58871,1554,2204473,5654.620515,34.444819,13673.115832021,512001.064659386
172.30.6.255,58460,161.69.13.161,443,31,11941,15,3756,16,8185,5655.028571,85.045243,353.3178216682,769.9431230974
172.30.6.255,58461,161.69.17.34,443,3,198,3,198,0,0,5657.332834,9.001072,175.9790389411,0
172.30.6.255,58462,52.229.171.86,443,29,10553,16,2294,13,8259,5661.140564,129.116016,142.1357362823,511.7258264846
172.30.6.255,58463,172.217.166.206,80,10,886,6,542,4,344,5668.460208,60.758665,71.3643066384,45.2939510768
172.30.6.255,58464,122.15.34.32,80,10,1221,6,705,4,516,5669.069575,60.105849,93.834461934,68.678840224
172.30.6.255,58466,157.240.16.39,443,19,1933,10,1125,9,808,5669.088269,61.067036,147.3790213103,105.8508881944
172.30.6.255,58465,157.240.16.39,443,28,5544,15,3399,13,2145,5669.088269,61.066977,445.2815799282,281.0029387896
172.30.6.255,58467,216.58.196.162,80,38,11286,22,6432,16,4854,5672.9081,6.176147,8331.4079149993,6287.4151149575
172.30.6.255,58468,216.58.196.162,80,6,348,4,228,2,120,5672.930591,6.157946,296.2026623813,155.8961380954
172.30.6.255,58469,35.190.41.40,443,6,348,4,228,2,120,5672.930861,6.119707,298.0534852404,156.8702553897
172.30.6.255,58470,216.58.196.162,80,10,1609,6,939,4,670,5673.159546,5.923615,1268.1445367399,904.8528643405
172.30.6.255,58471,35.190.41.40,443,87,19593,41,6791,46,12802,5673.181658,5.903582,9202.5485544202,17348.1117057409
172.30.6.255,58472,161.69.45.59,443,26,12171,12,4767,14,7404,5678.434218,9.993725,3815.994536572,5926.9191417618
172.30.6.255,58473,216.58.196.162,80,7,402,4,228,3,174,5680.8347,8.252023,221.0367082108,168.6859088977
172.30.6.255,58474,35.190.41.40,443,6,348,4,228,2,120,5680.848417,8.237611,221.4234199697,116.5386420893
172.30.6.255,58475,216.58.196.162,80,46,13346,24,7729,22,5617,5680.850164,8.236958,7506.6547625961,5455.4120586754
172.30.6.255,58476,35.190.41.40,443,85,19387,39,6675,46,12712,5681.09952,17.958307,2973.5542442837,5662.8946147318
172.30.6.255,58477,35.190.43.164,80,10,1629,6,1175,4,454,5681.828335,7.257001,1295.3009101143,500.4822239931
172.30.6.255,58478,35.190.43.164,80,14,2928,8,2140,6,788,5682.079621,7.006183,2443.5559276712,899.7766686939
172.30.6.255,58479,103.231.98.53,80,19,6478,10,5744,9,734,5682.837045,6.307381,7285.4327334916,930.9727761809
172.30.6.255,58480,103.243.221.51,80,47,33567,29,29366,18,4201,5682.838963,6.410762,36645.8776663394,5242.434518705
172.30.6.255,58481,210.176.156.21,80,15,5583,9,4024,6,1559,5682.841229,6.89656,4667.8343985986,1808.4378298746
172.30.6.255,58482,173.241.248.220,80,10,2494,6,1300,4,1194,5682.842057,6.375106,1631.3454239034,1498.3280278005
172.30.6.255,58483,103.243.221.87,80,15,5491,9,4317,6,1174,5682.843489,6.406679,5390.6243780907,1465.9701227423
172.30.6.255,58484,103.243.221.87,80,46,33168,19,9068,27,24100,5682.843744,6.404409,11327.1966234516,30104.2609864559
172.30.6.255,58485,103.243.221.87,80,24,13603,12,5401,12,8202,5682.84393,6.404875,6746.111360487,10244.6964226465
172.30.6.255,58486,180.149.59.210,80,13,4950,8,3669,5,1281,5682.992474,6.043222,4857.0117066689,1695.7841363431
172.30.6.255,58487,176.34.147.227,443,23,8815,12,3338,11,5477,5683.740323,5.492547,4861.8609909029,7977.3554964575
172.30.6.255,58488,176.34.147.227,443,25,9657,13,3994,12,5663,5683.741253,5.489554,5820.5092799891,8252.7651608859
172.30.6.255,58489,176.34.147.227,443,13,1482,7,958,6,524,5683.923554,6.593457,1162.3644470572,635.7818061148
172.30.6.255,58490,157.240.16.17,443,473,401373,195,13121,278,388252,5690.998462,8.043506,13050.0306707036,386152.008837894
172.30.6.255,58491,157.240.16.17,443,247,192712,109,8254,138,184458,5700.988235,8.077131,8175.180023699,182696.554011567
172.30.6.255,58492,157.240.16.17,443,533,448704,219,14893,314,433811,5710.945816,8.132549,14650.2652489399,426740.496737251
172.30.6.255,58493,216.58.196.162,80,16,3981,9,2265,7,1716,5711.158255,7.933214,2284.0679704343,1730.4461974681
172.30.6.255,58494,35.190.41.40,443,37,13792,20,3744,17,10048,5711.167845,7.924429,3779.7045061545,10143.8223498505
172.30.6.255,58495,216.58.196.162,80,6,348,4,228,2,120,5711.168179,7.924517,230.1717568402,121.1430299159
172.30.6.255,58496,23.8.190.108,80,13,5510,6,549,7,4961,5714.128902,60.232293,72.917695496,658.9156418136
172.30.6.255,58497,157.240.16.17,443,423,363342,167,12437,256,350905,5721.672326,7.391439,13460.97830206,379796.1398315
172.30.6.255,58498,52.229.175.79,443,30,10147,17,2298,13,7849,5727.959515,98.504365,186.6313233936,637.4539849072
172.30.6.255,58499,157.240.16.39,443,27,5501,15,3409,12,2092,5730.090377,61.048527,446.7265852295,274.1425685832
172.30.6.255,58500,157.240.16.39,443,19,1933,10,1125,9,808,5730.090379,61.048455,147.4238782947,105.8831054774
172.30.6.255,58501,157.240.16.17,443,385,339538,145,9681,240,329857,5731.018158,8.03437,9639.5859289524,328445.91424093
172.30.6.255,58502,157.240.16.17,443,677,739824,151,9526,526,730298,5741.206552,7.845642,9713.4179714035,744666.147142558
172.30.6.255,58503,35.190.43.164,80,10,1573,6,1119,4,454,5747.844196,1.222781,7321.0166006808,2970.2784063531
172.30.6.255,58504,103.243.221.51,80,45,29247,26,24983,19,4264,5747.847053,11.371175,17576.3718349258,2999.8658889694
172.30.6.255,58505,173.241.248.220,80,10,2494,6,1300,4,1194,5747.862658,1.319136,7883.9482812989,7241.103267593
172.30.6.255,58506,103.243.221.87,80,25,14414,11,5347,14,9067,5747.864758,1.35288,31618.4731831266,53615.9895925583
172.30.6.255,58507,210.176.156.21,80,14,5524,8,3970,6,1554,5747.865928,1.28091,24794.8723954162,9705.5999250571
172.30.6.255,58508,103.243.221.87,80,29,18046,12,5401,17,12645,5747.869035,1.347777,32058.7159448496,75056.92707325
172.30.6.255,58509,103.243.221.87,80,16,5907,9,4317,7,1590,5747.869754,1.348532,25610.070802918,9432.479169942
172.30.6.255,58510,103.231.98.53,80,19,6478,10,5744,9,734,5747.880014,1.237139,37143.7647669388,4746.4351216806
172.30.6.255,58511,35.190.43.164,80,10,1629,6,1175,4,454,5747.968567,1.106292,8496.852548872,3283.0391976067
172.30.6.255,58512,180.149.59.210,80,12,4896,8,3669,4,1227,5748.027823,1.002219,29287.0121201064,9794.2665225867
172.30.6.255,58513,54.194.27.245,443,22,8297,11,2820,11,5477,5748.512149,10.691293,2110.1283072123,4098.2882051779
172.30.6.255,58514,54.194.27.245,443,25,9669,13,4006,12,5663,5748.512565,10.678579,3001.1483737676,4242.5120420984
172.30.6.255,58515,54.194.27.245,443,18,6378,9,1141,9,5237,5748.868451,10.323432,884.2020754338,4058.3402883847
172.30.6.255,58516,157.240.16.17,443,1213,1206299,376,21639,837,1184660,5751.517815,7.547133,22937.4518774214,1255745.72489977
172.30.6.255,58517,172.217.166.197,443,31,6656,16,3920,15,2736,5753.099603,5.986135,5238.7725970095,3656.4494452597
172.30.6.255,58518,157.240.16.17,443,1902,1570997,831,62999,1071,1507998,5761.103304,7.990948,63070.3641170011,1509706.23260225
172.30.6.255,58519,157.240.16.17,443,12,1688,7,971,5,717,5770.957385,8.069972,962.5807871452,710.783135307
172.30.6.255,58520,157.240.16.17,443,15,870,11,630,4,240,5771.208083,18.77575,268.4313542735,102.2595635328
172.30.6.255,58521,157.240.16.17,443,378,323347,148,9972,230,313375,5771.323289,7.878451,10125.8483425225,318209.759761131
172.30.6.255,58522,161.69.36.37,80,7,398,4,228,3,170,5775.422527,0.615827,2961.8707851368,2208.4124275143
172.30.6.255,58523,161.69.36.37,80,7,398,4,228,3,170,5775.952436,0.611336,2983.6292971418,2224.6358794478
172.30.6.255,58524,157.240.16.17,443,351,287067,150,10836,201,276231,5781.034607,8.064663,10749.1162370949,274016.161617661
172.30.6.255,58525,35.190.41.40,443,84,18609,36,5775,48,12834,5781.817617,7.549225,6119.8334928415,13600.336458377
172.30.6.255,58526,172.217.166.226,80,32,7930,17,4444,15,3486,5781.829202,7.561131,4701.9420771837,3688.3371019493
172.30.6.255,58527,172.217.166.226,80,28,6662,15,3726,13,2936,5781.82938,7.562682,3941.4588634034,3105.776495693
172.30.6.255,58529,172.217.166.206,443,14,1617,8,1042,6,575,5784.415654,0.321625,25918.3832102938,14302.3707734347
172.30.6.255,58528,172.217.166.206,443,26,5628,14,3270,12,2358,5784.415654,0.473508,55247.2186319933,39838.8200410521
172.30.6.255,58530,172.217.166.226,80,10,1609,6,939,4,670,5790.835933,8.240366,911.6099940221,650.4565452554
172.30.6.255,58531,35.190.41.40,443,85,18813,38,6009,47,12804,5790.841886,8.267699,5814.435189283,12389.4205630853
172.30.6.255,58532,172.217.166.226,80,42,11457,22,6432,20,5025,5790.842413,8.234337,6248.9548338866,4881.9959639739
172.30.6.255,58534,157.240.16.39,443,19,1933,10,1125,9,808,5791.086898,61.056181,147.4052233958,105.8697071145
172.30.6.255,58533,157.240.16.39,443,27,5497,14,3347,13,2150,5791.086907,61.056855,438.5420768888,281.7046505261
172.30.6.255,58535,157.240.16.17,443,521,428362,218,17480,303,410882,5791.634274,7.459963,18745.4012841613,440626.314098326
172.30.6.255,58536,157.240.16.17,443,582,504421,231,15090,351,489331,5801.148833,7.936466,15210.800373869,493248.254323769
172.30.6.255,58537,172.217.166.226,80,10,1594,6,939,4,655,5801.805033,7.261023,1034.5649641931,721.6613967481
172.30.6.255,58538,35.190.41.40,443,38,13258,18,3048,20,10210,5801.815498,7.3087,3336.2978368244,11175.7220846381
172.30.6.255,58539,172.217.166.226,80,14,2828,8,1608,6,1220,5801.816437,7.285144,1765.7852748005,1339.7127084929
172.30.6.255,58540,35.190.43.164,80,10,1703,6,1249,4,454,5801.827855,7.27238,1373.9656068578,499.4238474888
172.30.6.255,58541,184.29.25.201,443,20,5512,11,3415,9,2097,5811.086756,18.323892,1490.9496301331,915.5260247113
172.30.6.255,58542,157.240.16.17,443,433,365558,178,11892,255,353666,5811.12452,7.953883,11960.9503936629,355716.572647593
172.30.6.255,58543,210.176.156.21,80,14,5524,8,3970,6,1554,5813.854197,3.459158,9181.4250751179,3593.9381780185
172.30.6.255,58544,103.243.221.51,80,16,5907,9,4317,7,1590,5813.893253,5.335359,6473.0414579416,2384.0944911112
172.30.6.255,58545,103.243.221.51,80,15,8347,11,6727,4,1620,5813.893605,1.547264,34781.3947716786,8376.075446725
172.30.6.255,58546,103.243.221.51,80,14,8192,10,6672,4,1520,5813.893963,9.619284,5548.85374005,1264.1273508507
172.30.6.255,58547,103.231.98.53,80,19,6478,10,5744,9,734,5813.894373,5.249916,8752.9019511935,1118.4940863816
172.30.6.255,58548,103.243.221.46,80,16,6556,9,5356,7,1200,5813.917057,5.312028,8066.2225425012,1807.2193896567
172.30.6.255,58549,173.241.248.220,80,10,2494,6,1300,4,1194,5813.930503,5.258114,1977.8954963699,1816.6209405121
172.30.6.255,58550,35.190.43.164,80,10,1573,6,1119,4,454,5813.989017,5.110339,1751.7428882899,710.7160601283
172.30.6.255,58551,35.190.43.164,80,10,1629,6,1175,4,454,5813.989399,5.106414,1840.8221503388,711.2623457479
172.30.6.255,58552,180.149.59.210,80,12,4894,8,3669,4,1225,5814.054681,5.000975,5869.2554951775,1959.6178745142
172.30.6.255,58553,103.243.221.46,80,30,18130,18,15075,12,3055,5814.098238,5.130744,23505.3629649031,4763.4417152756
172.30.6.255,58554,103.243.221.51,80,7,406,5,294,2,112,5814.102282,5.125998,458.8374790626,174.7952301191
172.30.6.255,58555,173.241.248.220,80,7,601,5,294,2,307,5814.105365,5.083597,462.6645267121,483.1224819749
172.30.6.255,58556,54.194.27.245,443,15,2278,8,1580,7,698,5816.260965,2.938778,4301.1074671177,1900.1095012963
172.30.6.255,58557,54.194.27.245,443,15,3005,8,2307,7,698,5816.261268,2.938354,6281.067563677,1900.3836841988
172.30.6.255,58558,157.240.16.17,443,188,155910,71,5424,117,150486,5821.06809,8.321857,5214.2208163395,144665.787936516
172.30.6.255,58559,157.240.16.17,443,161,137039,57,4415,104,132624,5831.202656,7.88818,4477.5854506363,134504.030080451
172.30.6.255,58560,157.240.16.17,443,371,308279,154,10588,217,297691,5841.4523,7.640493,11086.1956159114,311698.211097116
172.30.6.255,58561,157.240.16.17,443,950,795143,403,26104,547,769039,5851.200681,17.898031,11667.8756450921,343742.392668786
172.30.6.255,58562,157.240.16.39,443,23,5213,13,3303,10,1910,5852.087534,0.316044,83608.611459125,48347.6984217162
172.30.6.255,58563,157.240.16.39,443,14,1586,8,1017,6,569,5852.087551,0.274295,29661.4958347585,16595.2715142356
172.30.6.255,58564,52.229.175.79,443,27,10001,15,2206,12,7795,5856.908287,0.674988,26145.6499967501,92386.8276177094
172.30.6.255,58565,157.240.16.17,443,269,213883,120,8594,149,205289,5870.964954,8.267503,8315.9328759844,198646.677237371
172.30.6.255,58566,35.190.43.164,80,7,1467,4,1067,3,400,5879.848172,0.830178,10282.1322656085,3854.5950386536
172.30.6.255,58567,103.243.221.46,80,3,186,2,120,1,66,5879.852231,1.22899,781.1292199282,429.6210709605
172.30.6.255,58568,173.241.248.220,80,3,186,2,120,1,66,5879.858919,1.187697,808.2869620791,444.5578291435
172.30.6.255,58569,103.231.98.53,80,15,6261,8,5635,7,626,5879.859385,0.439768,102508.595441189,11387.8226701304
172.30.6.255,58570,103.243.221.51,80,22,15192,15,7035,7,8157,5879.861714,1.809258,31106.6746699437,36067.8244893718
172.30.6.255,58571,103.243.221.51,80,9,5173,7,4209,2,964,5879.862558,0.501106,67195.3638550695,15389.9574141808
172.30.6.255,58572,103.243.221.51,80,16,5621,9,5239,7,382,5879.867856,1.613703,25972.5612457809,1893.7809497783
172.30.6.255,58573,35.190.43.164,80,7,1411,4,1011,3,400,5879.919516,0.565059,14313.5495585297,5663.125443533
172.30.6.255,58574,180.149.59.210,80,9,4732,6,3560,3,1172,5879.95561,0.682857,41707.1216960637,13730.546805558
172.30.6.255,58575,210.176.156.21,80,11,5363,6,3863,5,1500,5879.96668,0.526938,58648.2660199143,22773.0776675826
172.30.6.255,58576,35.190.43.164,80,3,186,2,120,1,66,5880.098737,0.345115,2781.6814684954,1529.9248076725
172.30.6.255,58577,103.243.221.46,80,21,16881,16,14994,5,1887,5880.101744,2.177603,55084.4208058104,6932.3930946088
172.30.6.255,58578,173.241.248.220,80,7,2331,4,1192,3,1139,5880.108729,0.507886,18775.8670252653,17941.034011558
172.30.6.255,58579,210.176.156.21,80,1,66,1,66,0,0,5880.115745,0,0,0
172.30.6.255,58580,54.194.27.245,443,13,3550,7,2813,6,737,5881.326672,0.86489,26019.4938084662,6817.0518794311
172.30.6.255,58581,157.240.16.17,443,1,66,1,66,0,0,5881.352933,0,0,0
172.30.6.255,58582,54.194.27.245,443,3,186,2,120,1,66,5881.510541,0.215402,4456.7831310609,2451.2307220835
172.30.6.255,58583,157.240.16.17,443,105,68982,51,4524,54,64458,5881.605122,0.742577,48738.3799929177,694424.955257181
172.30.10.168,62078,172.30.6.255,56740,3,198,0,0,3,198,1224.735378,9.009177,0,175.820721471
172.30.10.168,62078,172.30.6.255,57113,3,198,0,0,3,198,1820.379486,9.006485,0,175.8732735357
172.30.13.95,50850,172.30.6.255,80,2,132,2,132,0,0,3473.000136,2.715671,388.8541726888,0
172.30.13.95,50855,172.30.6.255,445,2,132,2,132,0,0,3506.737162,5.906892,178.7742183199,0
172.30.13.95,50858,172.30.6.255,139,1,66,1,66,0,0,3533.665565,0,0,0
172.30.13.95,50862,172.30.6.255,445,3,198,3,198,0,0,3545.696573,8.984559,176.3024762818,0
172.30.13.95,50866,172.30.6.255,139,3,198,3,198,0,0,3566.795306,8.984647,176.3007494897,0
172.30.16.59,62078,172.30.6.255,56628,3,198,0,0,3,198,1007.37647,9.005058,0,175.9011435573
172.30.20.1,62078,172.30.6.255,56830,5,306,2,108,3,198,1314.318774,1.102071,783.9785276992,1437.2939674485
