172.30.15.199,49482,52.114.88.28,443,19,7475,11,2835,8,4640,0,1.51064,15013.5042101361,24572.3666790235
172.30.15.199,49418,172.217.194.188,443,82,4986,41,2285,41,2701,0.159567,1724.011565,10.6031771312,12.5335586133
172.30.15.199,49449,131.253.61.64,443,1,54,0,0,1,54,0.482912,0,0,0
172.30.15.199,49443,204.79.197.200,443,1,54,1,54,0,0,1.079126,0,0,0
172.30.15.199,49483,172.217.166.197,443,198,70778,87,23375,111,47403,4.190212,10.232347,18275.3770957924,37061.2919987956
172.30.15.199,49484,172.217.194.189,443,31,9052,16,3585,15,5467,6.216586,3.229738,8879.9772613135,13541.6557008649
172.30.15.199,49485,180.149.59.227,80,12,1734,7,960,5,774,6.314178,60.047555,127.8986296778,103.1182701777
172.30.15.199,49486,162.125.34.129,443,23,7339,11,2741,12,4598,7.954233,88.492725,247.7943808375,415.6725877749
172.30.15.199,49487,111.221.29.13,443,25,7140,15,1863,10,5277,8.236677,1.20137,12405.836669802,35139.8819680865
172.30.15.199,49475,52.229.207.60,443,1,54,1,54,0,0,9.437414,0,0,0
172.30.15.199,49476,52.229.207.60,443,1,54,1,54,0,0,9.437573,0,0,0
172.30.15.199,49477,52.175.39.99,443,1,54,1,54,0,0,9.437807,0,0,0
172.30.15.199,49411,162.125.82.3,443,1,54,1,54,0,0,9.752845,0,0,0
172.30.15.199,49488,162.125.82.3,443,23,6137,12,1530,11,4607,9.861609,1523.621084,8.0334934509,24.1897413911
172.30.15.199,49489,162.125.82.3,443,23,6288,12,1656,11,4632,9.867013,1523.616768,8.6950998954,24.3210765189
172.30.15.199,49490,162.125.34.129,443,5,330,1,66,4,264,10.904616,7.337954,71.9546620216,287.8186480864
172.30.15.199,49491,162.125.34.129,443,482,156194,200,114613,282,41581,10.952865,5478.165453,167.374280289,60.7225179404
172.30.15.199,49417,40.90.136.20,443,3,162,2,108,1,54,15.11407,0.281307,3071.3775341531,1535.6887670765
172.30.15.199,49492,111.221.29.253,443,24,5929,14,1420,10,4509,15.153124,1.020546,11131.2963844844,35345.7854912958
172.30.15.199,49493,52.114.6.46,443,20,7248,12,2608,8,4640,16.627733,0.952839,21896.668797142,38957.2635041177
172.30.15.199,49468,111.221.29.40,443,3,162,2,108,1,54,20.56142,0.115104,7506.2552126771,3753.1276063385
172.30.15.199,49494,52.114.6.46,443,18,8426,10,3786,8,4640,22.14755,0.729226,41534.4488539904,50903.2864982872
172.30.15.199,49405,52.230.84.0,443,18,2150,12,1081,6,1069,25.051812,4631.089518,1.8673791483,1.8466496851
172.30.15.199,49401,52.230.84.0,443,72,8545,47,4298,25,4247,25.093544,5070.199171,6.781587634,6.7011174224
172.30.15.199,49473,23.57.219.27,80,1,54,1,54,0,0,30.384641,0,0,0
172.30.15.199,49452,122.15.34.26,80,3,162,2,108,1,54,33.483348,0.009351,92396.5351299096,46198.2675649548
172.30.15.199,49434,131.253.61.64,443,1,54,0,0,1,54,34.740678,0,0,0
172.30.15.199,49495,52.114.76.37,443,19,8523,10,3829,9,4694,43.194648,2.700261,11344.0885899548,13906.8038237785
172.30.15.199,49496,172.217.166.197,443,193,127085,76,7640,117,119445,46.83803,2.620887,23320.3491794954,364594.12405037
172.30.15.199,49497,40.77.226.92,443,28,9373,15,3161,13,6212,48.524338,0.711539,35539.8649968588,69842.9741728842
172.30.15.199,49498,52.114.76.37,443,17,7345,9,2705,8,4640,48.741438,1.518804,14248.0530733393,24440.2832755248
172.30.15.199,49499,111.221.29.40,443,33,12805,17,6521,16,6284,50.25222,0.677016,77055.78597847,74255.2613232182
172.30.15.199,49500,52.114.76.37,443,19,8261,11,3621,8,4640,50.740309,0.920376,31474.0931966936,40331.3428424906
172.30.15.199,49501,172.217.166.197,443,767,489922,298,46029,469,443893,50.835682,18.651558,19742.6938811224,190393.960654654
172.30.15.199,49502,52.229.174.29,443,27,9277,15,1465,12,7812,52.018772,0.693301,16904.6344949741,90142.6653069881
172.30.15.199,49503,23.198.126.238,443,17,6648,8,1325,9,5323,52.605377,0.65025,16301.4225297962,65488.6582083814
172.30.15.199,49504,23.198.126.238,443,17,6644,8,1325,9,5319,52.605377,0.642332,16502.3694911665,66246.11571586
172.30.15.199,49505,23.198.126.238,443,17,6653,8,1326,9,5327,52.605754,0.653671,16228.3472878557,65194.8763215743
172.30.15.199,49506,23.198.126.238,443,17,6651,8,1323,9,5328,52.60655,0.652636,16217.3094956453,65310.5253157961
172.30.15.199,49507,23.198.126.238,443,18,6770,9,1412,9,5358,52.607194,0.710581,15896.8506053498,60322.4685152011
172.30.15.199,49508,23.198.126.238,443,17,6382,8,1318,9,5064,53.198656,0.681232,15477.8401484369,59468.7272471051
172.30.15.199,49509,23.198.126.238,443,17,6384,8,1319,9,5065,53.221387,0.667228,15814.6840360416,60728.8662945798
172.30.15.199,49510,23.198.126.238,443,18,6436,8,1318,10,5118,53.221413,0.746357,14127.2876116925,54858.4658548119
172.30.15.199,49511,23.198.126.238,443,17,6380,8,1315,9,5065,53.222211,0.671384,15669.1252695925,60352.9425783162
172.30.15.199,49512,23.198.126.238,443,18,6469,8,1351,10,5118,53.222228,0.900402,12003.5273133556,45473.022050151
172.30.15.199,49513,23.198.126.238,443,17,6662,8,1324,9,5338,53.22302,0.671297,15778.4110460794,63614.1677975618
172.30.15.199,49514,117.18.232.240,80,9,1727,5,596,4,1131,53.8567,0.032161,148254.096576622,281334.535617717
172.30.15.199,49515,13.107.4.50,80,738,720137,240,13842,498,706295,53.917414,4.000567,27680.0763491775,1412389.79374674
172.30.15.199,49400,162.125.34.129,443,520,156474,218,114865,302,41609,54.178358,5410.393538,169.8434676786,61.5245448713
172.30.15.199,49516,13.107.4.50,80,712,718733,215,12492,497,706241,57.970221,3.158274,31642.5997237732,1788929.01629181
172.30.15.199,49517,23.57.219.27,80,16,5496,9,982,7,4514,58.186874,61.52242,127.6932864474,586.9730091892
172.30.15.199,49518,13.107.4.50,80,1131,1112416,364,20532,767,1091884,61.162849,30.149742,5448.0068187648,289722.943566151
172.30.15.199,49519,172.217.194.189,443,30,9067,15,3534,15,5533,63.132334,1.370238,20632.9119466837,32303.8771366726
172.30.15.199,49459,184.29.26.24,443,4,247,2,108,2,139,66.270207,0.027119,31859.5818429895,41004.4618164402
172.30.15.199,49462,180.149.59.227,80,3,162,2,108,1,54,66.34964,0.010115,85417.6964902494,42708.8482451247
172.30.15.199,49480,180.149.59.227,80,3,162,2,108,1,54,66.349953,0.010839,79712.1505673642,39856.0752836821
172.30.15.199,49481,180.149.59.227,80,3,162,2,108,1,54,66.350111,0.010574,81709.8543597085,40854.9271798543
172.30.15.199,49458,111.221.29.13,443,3,162,2,108,1,54,69.129195,0.184019,4695.1673468499,2347.583673425
172.30.15.199,49520,172.217.166.197,443,208,148498,70,7097,138,141401,73.719972,5.767565,9844.0156287792,196132.68337678
172.30.15.199,49521,172.217.161.10,443,42,10725,20,4671,22,6054,76.536132,2.951059,12662.5729949825,16411.7355837345
172.30.15.199,49522,172.217.166.197,443,68,28483,30,7753,38,20730,80.056512,4.451079,13934.5987793072,37258.3816193781
172.30.15.199,49523,172.217.166.197,443,47,12593,22,5429,25,7164,85.411558,4.096515,10602.1825869062,13990.428449548
172.30.15.199,49524,172.217.166.197,443,46,12790,21,5326,25,7464,91.25731,3.335075,12775.7246838527,17904.2450319709
172.30.15.199,49525,184.85.125.146,443,21,8167,10,1229,11,6938,92.418579,0.7725,12727.5080906148,71849.8381877015
172.30.15.199,49526,13.107.4.50,80,1089,1110160,322,18270,767,1091890,93.216564,11.936813,12244.4742997984,731779.914789651
172.30.15.199,49527,13.107.4.50,80,700,718126,203,11439,497,706687,93.262036,11.891765,7695.4093862433,475412.691051328
172.30.15.199,49528,172.217.166.197,443,34,9701,17,4324,17,5377,101.98561,2.559284,13516.2803346561,16807.8259388172
172.30.15.199,49529,52.114.74.45,443,28,11922,16,6708,12,5214,106.803293,4.033208,13305.5374282705,10342.1395573945
172.30.15.199,49530,172.217.166.197,443,37,9548,19,3953,18,5595,111.943984,2.628266,12032.2676624056,17030.239709375
172.30.15.199,49531,172.217.166.197,443,48,13454,23,4923,25,8531,114.537467,5.038591,7816.4709141901,13545.0565445777
172.30.15.199,49532,117.18.237.29,80,180,170338,59,3462,121,166876,123.98745,60.356466,458.8737849562,22118.7237834634
172.30.15.199,49533,52.114.74.45,443,21,8500,13,3860,8,4640,125.047998,1.576646,19585.8804068891,23543.6489865195
172.30.15.199,49534,172.217.166.197,443,43,10547,21,4284,22,6263,176.621322,3.046267,11250.4911749364,16447.6718554217
172.30.15.199,49535,172.217.166.206,443,97,50815,47,7416,50,43399,179.904761,4.73946,12517.8817840008,73255.6029589872
172.30.15.199,49536,23.198.119.161,80,14,5564,7,603,7,4961,206.380496,60.449955,79.8015482394,656.5430859295
172.30.15.199,49537,172.217.166.194,443,16,4830,8,1219,8,3611,213.410859,1.244731,7834.6245092313,23208.2273197984
172.30.15.199,49538,180.149.59.79,443,17,5140,10,1351,7,3789,231.106863,3.762007,2872.9345798666,8057.4012754363
172.30.15.199,49539,180.149.59.79,443,15,5008,8,1219,7,3789,231.107761,3.761184,2592.8005649285,8059.1643482478
172.30.15.199,49540,180.149.59.81,443,15,5008,8,1219,7,3789,252.154328,2.556898,3813.9964910606,11854.9899135592
172.30.15.199,49541,180.149.59.81,443,15,5008,8,1219,7,3789,252.155111,2.55493,3816.9343191399,11864.1215219204
172.30.15.199,49542,172.25.10.224,7680,3,198,3,198,0,0,287.835532,9.005062,175.901065423,0
172.30.15.199,49543,172.217.166.206,443,22,8700,11,1922,11,6778,309.81323,4.900628,3137.557064115,11064.704360339
172.30.15.199,49544,172.217.194.189,443,15,5206,8,1219,7,3987,328.022858,6.696263,1456.334675027,4763.2537730373
172.30.15.199,49545,184.29.26.80,80,16,4639,9,942,7,3697,328.939431,95.570648,78.8526619596,309.4674004931
172.30.15.199,49546,216.58.196.206,443,18,5816,9,1285,9,4531,328.941368,5.777938,1779.1814311611,6273.518338203
172.30.15.199,49547,172.217.166.197,443,35,10574,17,3794,18,6780,328.981732,5.783548,5247.9896423441,9378.326245412
172.30.15.199,49548,192.0.72.17,443,4940,5369186,1224,67766,3716,5301420,390.536182,4.236884,127954.411779979,10010035.6771628
172.30.15.199,49549,192.0.72.17,443,17,8233,7,971,10,7262,390.536697,0.115144,67463.3502397077,504550.823316949
172.30.15.199,49550,192.0.72.17,443,6,348,4,228,2,120,390.569356,4.200741,434.2091073932,228.5311091543
172.30.15.199,49551,192.0.78.13,443,31,9846,16,2036,15,7810,392.625559,2.275482,7158.0438781761,27457.9188057738
172.30.15.199,49552,192.0.78.13,443,6,348,4,228,2,120,392.769547,2.122322,859.436032798,452.3347541042
172.30.15.199,49553,192.0.73.2,443,29,10465,15,1855,14,8610,393.988844,0.781367,18992.3557048085,88153.1981770359
172.30.15.199,49554,172.217.166.197,443,34,9144,17,3783,17,5361,465.667534,4.166689,7263.321068599,10293.0648291725
172.30.15.199,49555,180.149.59.12,443,19,6641,11,1417,8,5224,574.800705,5.142853,2204.2239978471,8126.2287683509
172.30.15.199,49556,180.149.59.12,443,17,5141,10,1351,7,3790,574.812109,5.131563,2106.1809043366,5908.5311824097
172.30.15.199,49557,172.217.161.2,443,20,5150,10,1351,10,3799,575.247065,4.599194,2349.9769742264,6608.1143783019
172.30.15.199,49558,209.197.3.15,443,18,6661,8,1087,10,5574,613.917972,6.36579,1366.051974696,7004.9436126545
172.30.15.199,49559,104.25.219.21,443,275,217311,101,7451,174,209860,613.921261,16.092031,3704.1937092962,104329.900930467
172.30.15.199,49560,209.197.3.15,443,6,348,4,228,2,120,614.172943,6.11109,298.4737583639,157.0914517705
172.30.15.199,49561,162.125.82.3,443,6,348,4,228,2,120,632.7293,0.341734,5337.4847103289,2809.2024791205
172.30.15.199,49562,162.125.248.4,443,6,348,4,228,2,120,633.044044,0.315403,5783.0775230409,3043.7250121268
172.30.15.199,49563,162.125.32.135,443,30,14367,16,8620,14,5747,664.637244,440.181515,156.6626440458,104.4478208041
172.30.15.199,49564,131.247.120.10,443,85,51924,28,3926,57,47998,666.304495,3.845018,8168.4923191517,99865.3322299146
172.30.15.199,49565,131.247.120.10,443,30,13101,13,1811,17,11290,666.305089,3.844529,3768.4720286932,23493.1249055471
172.30.15.199,49566,131.247.120.10,443,14,1537,6,906,8,631,666.5214,3.626218,1998.7766868953,1392.0839839193
172.30.15.199,49567,131.247.120.10,443,24,8973,10,1599,14,7374,670.256498,4.892639,2614.5399241595,12057.2966858989
172.30.15.199,49568,131.247.120.10,443,8,456,4,228,4,228,670.508527,4.64142,392.9831818711,392.9831818711
172.30.15.199,49569,54.86.32.187,80,6,348,4,228,2,120,710.494759,4.707953,387.4295261656,203.9102769293
172.30.15.199,49570,54.86.32.187,80,15,2378,9,1538,6,840,710.495335,4.704116,2615.5817586131,1428.5362010631
172.30.15.199,49571,54.86.32.187,80,6,348,4,228,2,120,710.647502,4.565594,399.5098994786,210.2683681466
172.30.15.199,49572,52.44.218.214,443,25,7578,13,2370,12,5208,712.396728,2.792692,6789.1482483568,14918.9384293005
172.30.15.199,49573,14.139.45.149,80,158,154754,45,3273,113,151481,728.926292,1.06334,24624.29702635,1139661.82030203
172.30.15.199,49574,14.139.45.149,80,306,306423,73,4502,233,301921,728.92702,0.697139,51662.5809200179,3464686.38248617
172.30.15.199,49575,14.139.45.149,80,13,2654,7,822,6,1832,729.351028,0.07055,93210.4890149994,207739.192062626
172.30.15.199,49576,14.139.45.149,80,29,18832,11,1027,18,17805,729.352497,0.141105,58226.1436518745,1009461.03965105
172.30.15.199,49577,14.139.45.149,80,44,39863,12,1011,32,38852,729.353233,0.255379,31670.5758891751,1217077.3634483
172.30.15.199,49578,14.139.45.149,80,13,2642,7,810,6,1832,730.25633,0.073224,88495.5752212607,200152.955315246
172.30.15.199,49579,14.139.45.149,80,12,2546,6,714,6,1832,731.153974,0.096633,59110.2418428505,151666.614924513
172.30.15.199,49580,172.217.166.197,443,34,9145,17,3784,17,5361,749.783307,10.287133,2942.705222145,4169.0916215432
172.30.15.199,49583,52.229.175.79,443,28,10083,15,2234,13,7849,767.445428,123.473002,144.7441927426,508.5484193541
172.30.15.199,49584,172.25.10.63,7680,3,198,3,198,0,0,792.775957,9.012292,175.7599509647,0
172.30.15.199,49586,52.114.128.8,443,37,23194,22,17816,15,5378,806.163162,3.945846,36121.024490059,10903.6186409709
172.30.15.199,49587,180.149.59.76,443,17,5140,10,1351,7,3789,806.508623,3.669456,2945.3957207825,8260.6250081754
172.30.15.199,49588,180.149.59.76,443,17,5406,9,1285,8,4121,806.509395,3.668539,2802.2054556323,8986.6837997361
172.30.15.199,49589,184.85.113.82,443,22,9010,11,1074,11,7936,813.762971,61.686556,139.2848062388,1029.2031865096
172.30.15.199,49590,172.217.166.206,443,27,7614,13,2596,14,5018,814.227216,5.919332,3508.5040001135,6781.8463299574
172.30.15.199,49591,172.217.166.206,443,16,5626,7,1165,9,4461,814.227666,0.310001,30064.4191470295,115122.209283175
172.30.15.199,49592,104.25.218.21,443,110,45163,51,4994,59,40169,865.268666,4.932577,8099.6201377091,65148.906950668
172.30.15.199,49593,104.25.218.21,443,16,6377,8,1037,8,5340,865.269473,0.498005,16658.4672844639,85782.2712623307
172.30.15.199,49596,52.229.170.171,443,30,10141,17,2291,13,7850,897.024418,64.752594,283.0465757094,969.8453161583
172.30.15.199,49597,52.175.23.79,443,30,10424,17,2375,13,8049,897.095709,92.029563,206.4553973814,699.6882077991
172.30.15.199,49598,104.25.218.21,443,215,116361,99,8698,116,107663,956.190399,4.027581,17276.8716507499,213851.440852459
172.30.15.199,49599,104.25.218.21,443,17,6442,9,1103,8,5339,956.191109,0.287246,30719.3137589403,148694.846925641
172.30.15.199,49600,104.25.218.21,443,6,348,4,228,2,120,956.253591,3.964315,460.1047091364,242.1603732297
172.30.15.199,49601,192.0.73.2,443,43,15296,23,2608,20,12688,958.438075,1.72587,12088.9754152979,58813.236222891
172.30.15.199,49602,104.25.218.21,443,43,16048,22,2811,21,13237,961.281712,8.942906,2514.6188498459,11841.3410584882
172.30.15.199,49603,104.25.219.21,443,18,6485,10,1145,8,5340,972.879796,7.25637,1262.33915856,5887.2411412318
172.30.15.199,49604,104.25.218.21,443,260,192258,95,7894,165,184364,972.881076,7.35861,8582.0555784313,200433.50578438
172.30.15.199,49605,104.25.218.21,443,44,13376,21,2791,23,10585,982.642234,7.586083,2943.2844328226,11162.5459410345
172.30.15.199,49606,104.25.219.21,443,18,6485,10,1145,8,5340,982.64361,7.494953,1222.1557626846,5699.8356093761
172.30.15.199,49607,104.25.218.21,443,43,16076,20,2467,23,13609,990.30729,9.94157,1985.1995208,10951.1877902584
172.30.15.199,49608,104.25.219.21,443,18,6497,10,1157,8,5340,990.309579,9.831183,941.4940195905,4345.3570134947
172.30.15.199,49609,172.217.166.206,443,16,5420,8,1054,8,4366,1033.696829,6.454511,1306.3731706399,5411.4091679448
172.30.15.199,49610,52.229.168.53,443,29,10110,16,2260,13,7850,1054.772573,75.596154,239.1656062291,830.730092433
172.30.15.199,49611,172.217.31.14,443,16,5606,8,1219,8,4387,1064.682116,5.475461,1781.0372496489,6409.6886088678
172.30.15.199,49612,172.25.10.63,7680,2,132,2,132,0,0,1089.043204,2.999791,352.0245243752,0
172.30.15.199,49613,172.30.24.126,7680,2,132,2,132,0,0,1089.061444,2.998236,352.2070977735,0
172.30.15.199,49614,172.217.166.197,443,53,29387,23,4309,30,25078,1090.915049,9.304836,3704.7402017618,21561.2612624231
172.30.15.199,49615,162.125.34.137,443,23,5726,12,1572,11,4154,1105.489285,254.072631,49.497657227,130.7972443518
172.30.15.199,49616,162.125.82.3,443,20,6578,12,2056,8,4522,1126.649873,1.978586,8313.0073699098,18283.7642639748
172.30.15.199,49617,52.21.142.16,443,191,132407,103,122979,88,9428,1129.451339,7.830741,125637.152346119,9631.783250142
172.30.15.199,49618,204.4.185.73,80,3,198,3,198,0,0,1158.361471,9.010797,175.7891116624,0
172.30.15.199,49619,204.4.185.73,80,3,198,3,198,0,0,1158.362181,9.00011,175.9978489152,0
172.30.15.199,49620,204.4.185.73,80,3,198,3,198,0,0,1158.364619,9.001658,175.9675828608,0
172.30.15.199,49621,131.253.61.80,443,62,26053,24,7201,38,18852,1221.207317,64.752029,889.670963052,2329.1316477512
172.30.15.199,49622,23.56.26.202,80,12,2412,7,620,5,1792,1293.984411,60.52824,81.9452209415,236.8481224632
172.30.15.199,49623,104.25.218.21,443,17,6432,9,1091,8,5341,1334.378026,5.894332,1480.7445525634,7248.9978508169
172.30.15.199,49624,104.25.218.21,443,259,199783,99,7929,160,191854,1334.465127,5.91054,10732.0143337156,259677.119180308
172.30.15.199,49625,104.25.218.21,443,6,348,4,228,2,120,1334.553431,5.814248,313.7121085994,165.111636105
172.30.15.199,49626,162.125.33.7,443,23,6683,12,2281,11,4402,1359.665691,1068.218826,17.0826422039,32.9670280497
172.30.15.199,49627,52.21.142.16,443,130,94970,77,87825,53,7145,1372.907876,2.541663,276433.185674107,22489.2127713236
172.30.15.199,49628,172.217.166.197,443,34,9175,17,3782,17,5393,1393.805083,6.582256,4596.6003145425,6554.5916172205
172.30.15.199,49629,195.154.150.142,80,12,2691,6,697,6,1994,1399.654361,2.304096,2420.0380539701,6923.3226393349
172.30.15.199,49630,195.154.150.142,80,26,9754,13,1849,13,7905,1399.654975,2.301048,6428.375244671,27483.1294262436
172.30.15.199,49631,195.154.150.142,80,15,4268,8,1248,7,3020,1400.278821,10.230631,975.8928848084,2361.5356667639
172.30.15.199,49632,195.154.150.142,80,6,348,4,228,2,120,1401.806352,8.710367,209.4056427244,110.2134961707
172.30.15.199,49633,62.210.213.13,80,18,9471,8,798,10,8673,1402.328604,2.077181,3073.3961075132,33402.9629579723
172.30.15.199,49634,62.210.213.13,80,20,10973,9,852,11,10121,1402.328963,2.111837,3227.5218210494,38340.0802239918
172.30.15.199,49635,62.210.213.13,80,6,348,4,228,2,120,1402.484849,8.006096,227.826396286,119.9086296242
172.30.15.199,49636,195.154.150.142,80,6,348,4,228,2,120,1442.708307,7.845779,232.4816949343,122.3587868075
172.30.15.199,49637,195.154.150.142,80,14,3848,7,924,7,2924,1442.716201,7.837672,943.1371968615,2984.5597008907
172.30.15.199,49638,62.210.213.13,80,42,29620,17,2127,25,27493,1442.717406,7.836466,2171.3869491682,28066.7331422099
172.30.15.199,49639,172.217.166.206,443,18,5757,10,1351,8,4406,1442.929237,7.454019,1449.9560572625,4728.7241956319
172.30.15.199,49640,62.210.213.13,80,20,9827,9,893,11,8934,1443.09184,7.462034,957.379717112,9578.0855461126
172.30.15.199,49641,62.210.213.13,80,18,9014,8,839,10,8175,1443.110451,7.443419,901.7361510886,8786.2849048267
172.30.15.199,49642,62.210.213.13,80,15,6010,7,785,8,5225,1443.111412,7.449086,843.056450147,5611.4266904691
172.30.15.199,49643,62.210.213.13,80,20,10891,9,893,11,9998,1443.11226,7.441615,960.0066652199,10748.2045228086
172.30.15.199,49644,62.210.213.13,80,16,7310,7,785,9,6525,1443.113082,7.440795,843.9958364664,7015.3794050233
172.30.15.199,49645,195.154.150.142,80,6,348,4,228,2,120,1452.541254,8.012888,227.6332827814,119.8069909376
172.30.15.199,49646,195.154.150.142,80,14,3375,7,931,7,2444,1452.541804,8.008796,929.97748975,2441.3157733072
172.30.15.199,49647,62.210.213.13,80,28,15200,13,1926,15,13274,1452.543072,8.008187,1924.0309947807,13260.4296078498
172.30.15.199,49648,62.210.213.13,80,6,348,4,228,2,120,1455.350979,5.192068,351.3051061735,184.8974243018
172.30.15.199,49649,62.210.213.13,80,16,5467,9,1314,7,4153,1455.37167,5.168915,2033.695659534,6427.6545464571
172.30.15.199,49650,62.210.213.13,80,25,14155,11,1398,14,12757,1455.376423,5.180103,2159.0304285455,19701.5387531864
172.30.15.199,49651,62.210.213.13,80,22,11792,10,1356,12,10436,1455.40435,5.148626,2106.9698983768,16215.5883919324
172.30.15.199,49652,62.210.213.13,80,30,19891,13,1902,17,17989,1455.405312,5.145289,2957.2682894976,27969.6631229082
172.30.15.199,49653,195.154.150.142,80,16,4760,8,1474,8,3286,1466.056197,4.450928,2649.3351498834,5906.1840586952
172.30.15.199,49654,195.154.150.142,80,19,7054,9,1568,10,5486,1466.056687,8.766372,1430.9226211254,5006.4040175343
172.30.15.199,49655,62.210.213.13,80,44,31825,18,2151,26,29674,1466.058807,4.466224,3852.919154973,53152.730360143
172.30.15.199,49656,62.210.213.13,80,34,22592,14,1538,20,21054,1466.437505,4.069247,3023.6552364603,41391.4417089953
172.30.15.199,49657,62.210.213.13,80,38,24754,17,1772,21,22982,1466.473188,4.033108,3514.9071138189,45586.6790574406
172.30.15.199,49658,62.210.213.13,80,18,8496,8,829,10,7667,1466.474226,4.0453,1639.4334165575,15162.2870986083
172.30.15.199,49659,62.210.213.13,80,33,21518,14,1538,19,19980,1466.486278,4.02236,3058.9007448364,39737.8653327903
172.30.15.199,49660,62.210.213.13,80,17,7339,8,829,9,6510,1466.488912,4.029283,1645.9504085466,12925.3765496241
172.30.15.199,49661,195.154.150.142,80,14,3393,7,990,7,2403,1470.366108,9.799371,808.2151395227,1961.7585659324
172.30.15.199,49662,62.210.213.13,80,26,16080,11,1008,15,15072,1470.367199,4.456099,1809.6545880152,27058.6447922275
172.30.15.199,49663,195.154.150.142,80,13,3392,7,1042,6,2350,1474.666563,5.943183,1402.6153998623,3163.2880899006
172.30.15.199,49668,62.210.213.13,80,6,348,4,228,2,120,1474.667595,5.949035,306.6043484363,161.3707097033
172.30.15.199,49669,195.154.150.142,80,6,348,4,228,2,120,1480.002641,0.609327,2993.4665622897,1575.5087169946
172.30.15.199,49670,195.154.150.142,80,14,3446,7,1042,7,2404,1483.412578,3.086068,2701.171847153,6231.8782346985
172.30.15.199,49671,195.154.150.142,80,11,1700,6,905,5,795,1483.418256,7.137328,1014.3852153075,891.0897747729
172.30.15.199,49672,195.154.150.142,80,6,348,4,228,2,120,1486.34643,4.213479,432.8964259701,227.8402241948
172.30.15.199,49673,62.210.213.13,80,1452,1436552,465,25667,987,1410885,1486.635247,3.935731,52172.2648219602,2867848.43781242
172.30.15.199,49674,62.210.213.13,80,6,348,4,228,2,120,1486.778517,3.792963,480.8905333376,253.100280704
172.30.15.199,49675,172.25.10.224,7680,3,198,3,198,0,0,1493.858232,9.013782,175.7308974191,0
172.30.15.199,49676,162.125.82.3,443,6,348,4,228,2,120,1533.531023,0.244112,7471.9800747172,3932.6210919564
172.30.15.199,49677,162.125.248.4,443,6,348,4,228,2,120,1533.676116,0.229106,7961.3803217724,4190.2001693539
172.30.15.199,49678,162.125.82.3,443,37,21520,15,1798,22,19722,1533.686213,61.246828,234.8529788351,2576.0681026616
172.30.15.199,49679,162.125.82.7,443,24,7334,11,1521,13,5813,1537.627301,60.967746,199.5809390756,762.7639703131
172.30.15.199,49680,192.168.121.7,443,91,48513,38,8848,53,39665,1542.106825,8.339484,8487.8153132737,38050.3158228981
172.30.15.199,49681,192.168.121.7,443,28,11151,14,2514,14,8637,1542.107436,8.328188,2414.931075043,8296.6426790558
172.30.15.199,49682,192.168.121.7,8080,24,11347,12,1877,12,9470,1542.108395,8.338533,1800.7963750938,9085.5309920821
172.30.15.199,49683,192.168.121.7,8080,32,11162,19,4426,13,6736,1544.192322,6.252746,5662.7919957089,8618.2934665827
172.30.15.199,49684,192.168.121.7,443,16,2935,8,1691,8,1244,1575.4726,4.992181,2709.8376441079,1993.5174626081
172.30.15.199,49685,192.168.121.7,443,17,4316,8,1580,9,2736,1575.479928,5.019965,2517.9458422519,4360.1897622793
172.30.15.199,49686,192.168.121.7,443,16,2935,8,1691,8,1244,1590.1054,0.35697,37896.7420231342,27879.0934812413
172.30.15.199,49687,192.168.121.7,443,19,4763,10,2292,9,2471,1590.112767,0.350067,52378.544678612,56469.190183617
172.30.15.199,49688,192.168.121.7,8080,191,180186,63,4603,128,175583,1590.232381,0.232662,158272.515494654,6037358.91551116
172.30.15.199,49689,192.168.121.7,443,35,20014,15,1950,20,18064,1604.193512,6.274992,2486.05894637,23029.8301575528
172.30.15.199,49692,54.222.61.197,443,45,24611,20,2223,25,22388,1614.439685,6.445633,2759.0773474071,27786.8752378547
172.30.15.199,49693,54.222.61.197,443,30,13587,15,1465,15,12122,1614.443562,6.024952,1945.2437131449,16095.7298912921
172.30.15.199,49694,54.222.61.197,443,7,398,4,228,3,170,1614.685858,6.209721,293.7330034634,219.0114499508
172.30.15.199,49695,52.84.103.186,443,31,15020,15,1900,16,13120,1616.586427,3.89379,3903.6517120851,26955.7423487137
172.30.15.199,49696,59.63.81.183,443,100,73095,41,3621,59,69474,1616.770962,4.095628,7072.9079887138,135703.730905247
172.30.15.199,49697,59.63.81.183,443,93,58493,42,3693,51,54800,1616.771416,4.080138,7240.9315567267,107447.346143683
172.30.15.199,49698,59.63.81.183,443,1565,1482108,539,34120,1026,1447988,1616.771783,14.128603,19319.6737143791,819890.260912555
172.30.15.199,49699,59.63.81.183,443,151,123942,58,4683,93,119259,1616.772141,4.103362,9130.0743146716,232509.829744484
172.30.15.199,49700,59.63.81.183,443,10,612,6,360,4,252,1616.804653,4.064649,708.5482657912,495.9837860538
172.30.15.199,49701,52.84.103.186,443,104,83673,41,3678,63,79995,1622.998181,7.492251,3927.2576425963,85416.252071639
172.30.15.199,49702,52.84.103.186,443,17,6932,9,1141,8,5791,1622.998571,0.080207,113805.528195832,577605.445908905
172.30.15.199,49703,18.204.234.216,443,40,11344,20,3379,20,7965,1623.020754,7.684981,3517.5103230574,8291.4974025309
172.30.15.199,49704,18.204.234.216,443,6,348,4,228,2,120,1623.219147,7.479426,243.8689813898,128.3520954683
172.30.15.199,49705,172.217.194.156,443,27,6583,13,2175,14,4408,1623.376786,7.178658,2423.851366091,4912.338768611
172.30.15.199,49706,59.63.81.183,443,44,15657,22,3854,22,11803,1623.38306,7.479226,4122.3516978895,12624.8357784613
172.30.15.199,49707,59.63.81.183,443,56,15908,29,4305,27,11603,1623.384199,7.485313,4601.0100045249,12400.8174407672
172.30.15.199,49708,59.63.81.183,443,47,19703,23,2689,24,17014,1623.387474,7.481274,2875.4460804403,18193.6926785465
172.30.15.199,49709,59.63.81.183,443,10,612,6,360,4,252,1623.638215,7.230155,398.3317093479,278.8321965435
172.30.15.199,49710,59.63.81.183,443,45,17447,22,3184,23,14263,1623.838247,7.062013,3606.9035840064,16157.4327319987
172.30.15.199,49711,59.63.81.183,443,48,17325,24,3347,24,13978,1623.844174,7.018342,3815.1460843602,15933.1078479793
172.30.15.199,49712,59.63.81.183,443,90,50661,42,4904,48,45757,1623.845432,7.063015,5554.5684102328,51827.1587983322
172.30.15.199,49713,54.222.61.197,443,24,10987,11,2369,13,8618,1623.934547,6.958418,2723.6075786192,9907.9992032673
172.30.15.199,49714,54.222.61.197,443,7,398,4,228,3,170,1624.191481,6.700564,272.2158910802,202.9679889633
172.30.15.199,49715,23.9.250.106,443,14,4791,8,1099,6,3692,1629.655704,0.158959,55309.859775129,185808.919280961
172.30.15.199,49716,23.9.250.106,443,366,331547,128,9187,238,322360,1629.656222,0.850864,86378.0815735533,3030895.65429962
172.30.15.199,49717,52.84.110.254,443,51,28969,24,5819,27,23150,1632.074528,8.49892,5477.4018345861,21791.0040334537
172.30.15.199,49718,52.84.110.254,443,54,40571,23,3110,31,37461,1632.076806,8.418436,2955.4183223582,35599.0115028495
172.30.15.199,49719,66.117.24.115,443,27,9510,12,3280,15,6230,1632.079151,8.606814,3048.7471903076,5790.7606693952
172.30.15.199,49720,66.117.24.115,443,7,402,4,228,3,174,1632.202107,8.484288,214.9856299079,164.0679807192
172.30.15.199,49721,52.84.110.254,443,15,3321,8,1651,7,1670,1632.626475,7.947239,1661.9608394815,1681.0869787608
172.30.15.199,49722,52.84.110.254,443,15,3310,8,1656,7,1654,1632.628372,7.945191,1667.4237283912,1665.4099316178
172.30.15.199,49723,52.84.110.254,443,15,3281,8,1648,7,1633,1632.6295,7.94462,1659.4878043255,1644.3832429997
172.30.15.199,49724,52.84.110.254,443,17,4056,9,1706,8,2350,1632.630303,7.942367,1718.3794201401,2367.052542397
172.30.15.199,49725,52.84.110.254,443,18,5390,10,2408,8,2982,1632.631084,7.94256,2425.4144759373,3003.5656010153
172.30.15.199,49726,23.9.250.106,443,342,250370,143,12333,199,238037,1632.676235,7.915296,12464.9791997669,240584.306638687
172.30.15.199,49727,18.204.234.216,443,22,4169,12,3066,10,1103,1633.416065,7.399425,3314.8521675671,1192.5250948553
172.30.15.199,49728,172.217.166.200,443,63,39119,27,2791,36,36328,1636.058592,4.553521,4903.458224965,63824.0166236219
172.30.15.199,49729,23.9.250.106,443,16,4947,7,1033,9,3914,1641.166769,0.162102,50980.2470049708,193162.329891051
172.30.15.199,49730,23.9.250.106,443,51,30800,21,3305,30,27495,1641.167762,9.34196,2830.241191356,23545.3801985879
172.30.15.199,49731,151.101.2.110,443,28,10174,14,1920,14,8254,1641.199228,9.315187,1648.9201988108,7088.6392296793
172.30.15.199,49732,23.9.250.106,443,12,1490,6,931,6,559,1641.20754,0.193037,38583.2767811344,23166.5432015619
172.30.15.199,49733,162.247.242.20,443,23,6281,11,2376,12,3905,1641.5506,9.154193,2076.4255243471,3412.643801589
172.30.15.199,49734,18.204.234.216,443,19,2865,10,1816,9,1049,1643.431314,7.274553,1997.0986533468,1153.6104005291
172.30.15.199,49735,23.9.250.106,443,252,202684,94,9981,158,192703,1652.976911,7.533132,10599.5753160836,204645.823277754
172.30.15.199,49736,162.247.242.20,443,22,6261,10,2471,12,3790,1658.501493,2.206195,8960.2233710076,13743.1188086277
172.30.15.199,49737,162.125.82.1,443,36,14933,19,2773,17,12160,1658.530041,2.077505,10678.1933136143,46825.398735503
172.30.15.199,49738,162.125.82.2,443,45,18130,26,13530,19,4600,1659.164387,1.437466,75299.1722934738,25600.6055099763
172.30.15.199,49739,172.217.166.206,443,34,10237,17,4668,17,5569,1682.660153,2.902618,12865.6268237843,15348.9022668497
172.30.15.199,49740,172.25.10.224,7680,3,198,3,198,0,0,1684.651208,9.024084,175.5302809681,0
172.30.15.199,49742,52.175.23.79,443,30,10211,17,2361,13,7850,1684.725195,64.329349,293.6140392156,976.226263381
172.30.15.199,49743,52.229.175.79,443,30,10192,17,2342,13,7850,1695.417803,121.943777,153.6445767134,514.9914292059
172.30.15.199,49744,172.217.166.197,443,39,11248,19,3928,20,7320,1695.749818,9.915927,3169.0430960212,5905.6505760883
172.30.15.199,49745,52.114.75.78,443,21,7974,11,3226,10,4748,1720.755854,1.575197,16383.9824479108,24113.8092568756
172.30.15.199,49746,162.125.82.3,443,6,348,4,228,2,120,1722.127507,0.284936,6401.4375157927,3369.1776398909
172.30.15.199,49747,172.217.194.188,5228,76,9403,40,3028,36,6375,1725.24431,1371.438252,17.6632086532,37.1872375046
172.30.15.199,49748,23.9.250.106,443,177,100103,73,11765,104,88338,1725.483192,10.140767,9281.349231276,69689.4031782796
172.30.15.199,49749,23.9.250.106,443,7,402,4,228,3,174,1725.489846,10.129453,180.0689533778,137.4210433673
172.30.15.199,49750,162.247.242.19,443,23,6229,11,2439,12,3790,1729.213252,6.601441,2955.7183045338,4592.9366027811
172.30.15.199,49751,162.247.242.19,443,7,398,4,228,3,170,1729.403914,6.40843,284.6250953822,212.2204658551
172.30.15.199,49752,172.217.166.196,443,22,5840,11,1374,11,4466,1730.054792,1.4899,7377.6763541176,23980.1328948246
172.30.15.199,49753,172.217.166.196,443,24,6922,12,1440,12,5482,1730.055827,1.444591,7974.5755026846,30358.7659067478
172.30.15.199,49754,172.217.166.196,443,22,5568,11,1374,11,4194,1730.0567,1.452887,7565.6262324604,23093.3307270296
172.30.15.199,49755,172.217.166.196,443,22,5616,11,1374,11,4242,1730.05711,1.45205,7569.9872593914,23371.0960366363
172.30.15.199,49756,172.217.166.196,443,23,5877,12,1428,11,4449,1730.057509,1.443224,7915.6111594591,24661.4524148694
172.30.15.199,49757,172.217.166.196,443,7,402,4,228,3,174,1730.353166,10.575339,172.4767404619,131.626986142
172.30.15.199,49758,172.217.166.196,443,22,5792,11,1374,11,4418,1732.172643,0.557555,19714.6469855039,63391.0555909435
172.30.15.199,49759,172.217.166.196,443,22,5567,11,1374,11,4193,1732.173058,0.5568,19741.3793103505,60244.2528735806
172.30.15.199,49761,162.247.242.19,443,33,15344,17,11298,16,4046,1789.163644,6.733534,13422.9663056577,4806.985455186
172.30.15.199,49763,180.149.59.233,80,8,877,5,468,3,409,1789.470891,14.33401,261.1969713988,228.2682933806
172.30.15.199,49762,180.149.59.233,80,8,877,5,468,3,409,1789.470891,14.333645,261.2036226654,228.2741061328
172.30.15.199,49766,172.25.10.63,7680,3,198,3,198,0,0,1801.25912,9.014999,175.7071742326,0
172.30.15.199,49767,52.114.74.45,443,32,19599,19,14330,13,5269,1807.296609,1.249096,91778.3741201631,33746.005110896
172.30.15.199,49768,172.217.166.212,443,32,6677,16,1915,16,4762,1833.857298,1.931218,7932.8175275907,19726.4110007242
172.30.15.199,49769,172.217.166.195,443,30,10202,14,1779,16,8423,1834.347384,1.428019,9966.2539504014,47187.0472311585
172.30.15.199,49770,23.9.250.106,443,24,7259,13,2568,11,4691,1841.353901,4.418729,4649.3007378366,8492.9399381587
172.30.15.199,49771,172.25.10.224,7680,3,198,3,198,0,0,1841.662096,9.006431,175.8743280218,0
172.30.15.199,49773,23.9.250.106,443,19,3840,10,2349,9,1491,1848.4851,7.284709,2579.6500587739,1637.4024000136
172.30.15.199,49774,162.247.242.19,443,22,6369,10,2539,12,3830,1849.166756,6.789778,2991.5558358463,4512.6659516704
172.30.15.199,49775,162.247.242.19,443,7,398,4,228,3,170,1849.416157,6.546459,278.6239095059,207.7458974386
172.30.15.199,49776,23.9.250.106,443,27,6451,14,2999,13,3452,1858.730308,7.050065,3403.0891913762,3917.1270052119
172.30.15.199,49777,23.9.250.106,443,19,3971,10,2372,9,1599,1866.532526,9.237416,2054.254133407,1384.8028496281
172.30.15.199,49779,172.25.10.63,7680,3,198,3,198,0,0,1881.79518,9.018246,175.6439112439,0
172.30.15.199,49780,23.198.119.161,80,14,5564,7,603,7,4961,1904.719753,60.406453,79.8590177112,657.015898616
172.30.15.199,49781,162.247.242.19,443,26,8071,13,4187,13,3884,1909.173826,6.843644,4894.4685024528,4540.2712356166
172.30.15.199,49782,172.25.10.224,7680,3,198,3,198,0,0,1922.045772,9.028556,175.4433377829,0
172.30.15.199,49785,172.25.10.63,7680,3,198,3,198,0,0,1962.319467,9.016832,175.6714553404,0
172.30.15.199,49786,172.217.166.197,443,83,41004,36,6739,47,34265,1996.660698,9.281125,5808.7785694082,29535.2125954552
172.30.15.199,49787,172.25.10.224,7680,3,198,3,198,0,0,2002.643745,9.000245,175.9952090193,0
172.30.15.199,49788,23.9.250.106,443,20,4239,10,2349,10,1890,2006.739056,9.194805,2043.7627551645,1644.4068145001
172.30.15.199,49789,52.229.168.53,443,30,10177,17,2326,13,7851,2017.979068,102.37407,181.7647769596,613.5147308298
172.30.15.199,49790,52.229.170.171,443,28,10033,15,2183,13,7850,2021.846117,126.799995,137.7287120555,495.2681583308
172.30.15.199,49791,23.9.250.106,443,280,192338,127,77969,153,114369,2027.356593,8.573284,72755.3175655905,106721.298396273
172.30.15.199,49792,162.247.242.19,443,27,8033,13,3920,14,4113,2029.176691,7.065674,4438.359312926,4656.8805750165
172.30.15.199,49793,162.247.242.19,443,7,398,4,228,3,170,2029.427543,6.815348,267.631234678,199.5496048037
172.30.15.199,49795,172.25.10.63,7680,3,198,3,198,0,0,2042.802299,9.006573,175.8715551409,0
172.30.15.199,49796,172.217.166.197,443,32,6320,17,3840,15,2480,2048.735963,7.235785,4245.5656158939,2741.9277935981
172.30.15.199,49797,23.9.250.106,443,285,198609,140,95888,145,102721,2052.693027,13.394688,57269.2697284164,61350.2905032189
172.30.15.199,49798,162.247.242.19,443,38,17038,20,12709,18,4329,2056.851933,9.309643,10921.1491783304,3720.0137534812
172.30.15.199,49799,172.25.10.63,7680,3,198,3,198,0,0,2106.774271,9.01622,175.6833795094,0
172.30.15.199,49800,162.247.242.19,443,24,6638,12,2808,12,3830,2118.412901,7.773054,2889.9837824362,3941.8226092345
172.30.15.199,49801,23.9.250.106,443,67,40026,27,5073,40,34953,2124.085391,1.960478,20701.0739217684,142630.521740109
172.30.15.199,49802,23.9.250.106,443,28,8129,14,2441,14,5688,2126.080426,9.958816,1960.8756703609,4569.217866863
172.30.15.199,49803,162.247.242.19,443,19,3062,9,2196,10,866,2126.136718,10.092368,1740.7213054459,686.4593126212
172.30.15.199,49804,23.9.250.106,443,49,25433,21,3338,28,22095,2136.985066,9.011617,2963.2861671774,19614.6818046092
172.30.15.199,49805,162.247.242.19,443,19,3059,9,2193,10,866,2138.748137,7.60404,2307.1945965565,911.0946286448
172.30.15.199,49806,23.9.250.106,443,47,25348,20,3181,27,22167,2208.913757,7.162003,3553.1959425315,24760.6710022309
172.30.15.199,49807,162.247.242.19,443,22,6145,10,2355,12,3790,2210.195565,6.169296,3053.8330467528,4914.6612514621
172.30.15.199,49809,23.9.250.106,443,233,164824,92,9421,141,155403,2241.781015,14.313309,5265.588830647,86857.9026694659
172.30.15.199,49810,23.56.26.202,80,12,2525,7,617,5,1908,2241.963897,60.51521,81.5662706946,252.2341077557
172.30.15.199,49811,23.56.26.202,80,11,2515,6,553,5,1962,2241.964411,60.506489,73.1161247846,259.4101931778
172.30.15.199,49812,169.44.165.64,443,34,11709,18,2390,16,9319,2246.374694,9.928999,1925.6724670836,7508.511180231
172.30.15.199,49813,52.5.46.238,443,28,13707,14,2713,14,10994,2246.44302,9.834044,2207.0269362229,8943.6248200641
172.30.15.199,49814,169.44.165.64,443,6,348,4,228,2,120,2246.539172,9.762554,186.8363545031,98.3349234227
172.30.15.199,49815,52.5.46.238,443,6,348,4,228,2,120,2246.651153,9.614565,189.7121710655,99.8485110871
172.30.15.199,49816,172.217.166.198,443,29,7451,14,2371,15,5080,2247.611121,8.435302,2248.6450396204,4817.8476597519
172.30.15.199,49817,104.113.219.221,443,172,135608,65,6038,107,129570,2248.098598,7.947605,6077.8058295551,130424.196975066
172.30.15.199,49818,157.240.16.20,443,164,130921,64,4958,100,125963,2248.167073,7.926125,5004.2107587251,127137.031020834
172.30.15.199,49819,52.22.176.255,443,23,9108,12,2249,11,6859,2249.017075,7.249277,2481.9026780188,7569.3065667102
172.30.15.199,49820,64.106.240.4,443,19,5718,11,1773,8,3945,2249.062546,7.207712,1967.8921688325,4378.6433198219
172.30.15.199,49821,52.22.176.255,443,6,348,4,228,2,120,2249.173645,7.094771,257.0907503568,135.3109212404
172.30.15.199,49822,104.16.241.231,443,148,84377,64,6500,84,77877,2249.174309,6.920124,7514.3162174548,90029.6006256508
172.30.15.199,49823,63.131.135.113,443,3,198,3,198,0,0,2249.211825,9.002259,175.9558350854,0
172.30.15.199,49824,64.106.240.4,443,6,344,4,228,2,116,2249.264078,7.006619,260.3252724317,132.4461912372
172.30.15.199,49825,63.131.135.113,443,3,198,3,198,0,0,2249.457667,9.003469,175.9321879156,0
172.30.15.199,49826,104.122.118.96,443,29,9450,15,3103,14,6347,2250.650196,5.442882,4560.8190660758,9328.881280175
172.30.15.199,49827,205.180.87.201,443,20,8083,11,1793,9,6290,2251.236145,1.140318,12578.9472761084,44128.0414761416
172.30.15.199,49828,104.122.118.96,443,23,6450,12,2038,11,4412,2251.38277,4.710127,3461.4777903018,7493.6408296425
172.30.15.199,49829,205.180.87.201,443,6,344,4,228,2,116,2251.455925,4.865228,374.9053487319,190.7413177759
172.30.15.199,49830,204.11.109.66,443,21,8994,10,2362,11,6632,2251.817067,4.498366,4200.6364088647,11794.5049380146
172.30.15.199,49831,52.84.110.92,443,26,13064,13,1771,13,11293,2251.942827,4.102915,3453.1546473666,22019.4666474936
172.30.15.199,49832,204.11.109.66,443,7,402,4,228,3,174,2252.041888,4.273847,426.7817729554,325.7018793607
172.30.15.199,49833,23.56.26.150,443,24,11012,12,1718,12,9294,2252.609726,3.548447,3873.2437035135,20953.391723198
172.30.15.199,49834,157.240.16.39,443,30,7433,15,2619,15,4814,2252.760992,3.333091,6286.0569963437,11554.4400077887
172.30.15.199,49835,151.101.112.84,443,71,56877,27,2484,44,54393,2252.762278,3.424635,5802.6621815174,127062.884073783
172.30.15.199,49836,23.56.26.209,443,22,8713,12,1817,10,6896,2252.764495,3.392636,4284.5740008654,16261.1019867735
172.30.15.199,49837,104.16.241.231,443,35,11688,19,3878,16,7810,2252.767432,3.327084,9324.6819136517,18779.2072577668
172.30.15.199,49838,23.8.185.154,443,25,12451,12,2097,13,10354,2252.848925,3.245677,5168.7213484269,25520.7157089234
172.30.15.199,49839,23.56.26.209,443,6,348,4,228,2,120,2252.849403,3.310024,551.0534062593,290.0281085575
172.30.15.199,49840,151.101.112.84,443,8,480,5,294,3,186,2252.850047,3.338305,704.5491649205,445.7351859701
172.30.15.199,49841,23.8.185.154,443,6,348,4,228,2,120,2252.850562,3.244139,562.2447126957,295.9182698399
172.30.15.199,49842,192.28.147.68,443,24,8373,11,2110,13,6263,2253.354011,2.970606,5682.3422560913,16866.5922037438
172.30.15.199,49843,192.28.147.68,443,8,464,5,294,3,170,2253.579192,12.761914,184.2983740527,106.5670870373
172.30.15.199,49844,151.101.0.84,443,6,348,4,228,2,120,2253.724683,2.48113,735.1489039268,386.920475751
172.30.15.199,49845,151.101.0.84,443,23,8453,12,1837,11,6616,2253.725194,2.472556,5943.6469790782,21406.1885757112
172.30.15.199,49846,151.101.0.84,443,23,8713,12,2201,11,6512,2253.725666,2.47537,7113.2800349036,21045.7426566524
172.30.15.199,49847,151.101.0.84,443,22,8651,11,2139,11,6512,2253.894657,2.311592,7402.6904401814,22536.8490633293
172.30.15.199,49848,144.2.194.69,443,6,360,3,198,3,162,2254.569198,1.090918,1451.988142097,1187.9902980794
172.30.15.199,49849,151.101.2.2,443,39,16760,20,2392,19,14368,2254.60863,1.485573,12881.2249549506,77373.5117695363
172.30.15.199,49850,50.31.185.52,443,18,6639,11,1934,7,4705,2254.609242,1.668125,9275.0843012356,22564.2562757567
172.30.15.199,49851,52.11.15.218,443,38,13264,18,3453,20,9811,2254.62621,1.713302,16123.2520594724,45810.9545193987
172.30.15.199,49852,144.2.194.69,443,24,7330,12,2271,12,5059,2254.810522,1.235824,14701.1224899354,32748.9998575885
172.30.15.199,49853,52.11.15.218,443,6,348,4,228,2,120,2254.847245,1.484801,1228.4474485133,646.5512886912
172.30.15.199,49854,50.31.185.52,443,6,348,4,228,2,120,2254.855419,1.423145,1281.6684174836,674.5623249914
172.30.15.199,49855,144.2.194.65,443,6,360,3,198,3,162,2255.082369,1.075133,1473.3060932929,1205.4322581487
172.30.15.199,49856,144.2.194.65,443,6,360,3,198,3,162,2255.304013,1.041172,1521.3624646069,1244.7511074057
172.30.15.199,49857,103.243.220.231,443,21,8073,10,3231,11,4842,2255.605585,10.702406,2415.1578626338,3619.373064337
172.30.15.199,49858,52.11.15.218,443,28,9576,15,2177,13,7399,2256.231992,10.135666,1718.2886649974,5839.9714434157
172.30.15.199,49859,52.11.15.218,443,6,348,4,228,2,120,2256.483307,9.871344,184.7772704507,97.2511949741
172.30.15.199,49860,104.113.219.221,443,25,7481,12,2376,13,5105,2260.727559,5.362275,3544.7641159769,7616.1703754471
172.30.15.199,49861,54.209.36.227,443,19,7376,11,1285,8,6091,2260.849442,5.183369,1983.2660958539,9400.8356341216
172.30.15.199,49862,54.209.36.227,443,7,402,5,282,2,120,2260.918023,6.021152,374.6791311696,159.4379281573
172.30.15.199,49864,52.175.23.79,443,26,10169,13,2124,13,8045,2262.50037,125.669703,135.2115871556,512.1361669805
172.30.15.199,49865,14.139.45.149,80,10,1151,5,698,5,453,2298.411088,0.147606,37830.4404969998,24551.8474858752
172.30.15.199,49866,14.139.45.149,80,33,20264,16,1398,17,18866,2298.411956,1.499401,7458.9786187949,100658.863105998
172.30.15.199,49867,14.139.45.149,80,79,58755,38,2713,41,56042,2298.600125,3.547333,6118.3993721481,126386.781280473
172.30.15.199,49868,14.139.45.149,80,29,18806,12,1055,17,17751,2298.604306,0.293567,28749.8254231855,483732.844632195
172.30.15.199,49869,172.217.166.197,443,35,6891,17,3864,18,3027,2299.689099,6.515036,4744.7166830699,3716.9403208211
172.30.15.199,49870,172.30.6.35,7680,11,854,6,454,5,400,2302.558169,0.432583,8396.0765910771,7397.424309319
172.30.15.199,49871,13.107.21.200,443,1273,872587,548,63914,725,808673,2310.232362,25.892082,19747.8132503984,249859.551657531
172.30.15.199,49872,104.24.1.12,443,28,8268,15,1926,13,6342,2310.514502,5.660436,2722.0517995433,8963.2671405522
172.30.15.199,49873,23.198.129.83,443,32,13016,16,2074,16,10942,2313.225458,3.03009,5475.7449448693,28888.9108904337
172.30.15.199,49874,23.198.129.83,443,9,534,5,294,4,240,2313.237024,3.018398,779.2212955349,636.0990167632
172.30.15.199,49875,131.253.61.80,443,33,10226,14,2288,19,7938,2315.086648,11.255352,1626.2485615732,5642.115857416
172.30.15.199,49876,131.253.61.80,443,7,398,4,228,3,170,2315.296394,1.944478,938.0409549504,699.4165014981
172.30.15.199,49877,23.56.25.241,443,19,7963,11,1273,8,6690,2321.315144,4.744604,2146.4383539701,11280.1827086097
172.30.15.199,49878,23.56.25.241,443,19,7963,11,1273,8,6690,2321.315706,4.744491,2146.4894758996,11280.4513698099
172.30.15.199,49879,23.56.25.241,443,19,7963,11,1273,8,6690,2321.316245,4.743037,2147.147492208,11283.9094445179
172.30.15.199,49880,23.56.25.241,443,17,7831,9,1141,8,6690,2321.31668,4.743305,1924.3965968876,11283.2718958617
172.30.15.199,49881,23.56.25.241,443,19,7963,11,1273,8,6690,2321.317112,4.74185,2147.6849752734,11286.7340805806
172.30.15.199,49882,23.56.25.241,443,19,7963,11,1273,8,6690,2321.317608,4.741915,2147.6555357909,11286.5793671964
172.30.15.199,49883,111.221.29.14,443,16,5244,10,1186,6,4058,2321.43173,4.628708,2049.8160609828,7013.6202154032
172.30.15.199,49884,111.221.29.14,443,5,294,3,174,2,120,2321.488391,4.730818,294.2408691267,202.9247373287
172.30.15.199,49885,13.107.21.200,443,255,108481,117,19366,138,89115,2336.131267,10.31001,15026.9495373918,69148.3325428415
172.30.15.199,49887,13.107.21.200,443,49,14164,23,5224,26,8940,2347.877805,8.255406,5062.3797303247,8663.4140101652
172.30.15.199,49888,13.107.21.200,443,50,15055,24,4737,26,10318,2356.377892,9.767585,3879.7717142978,8450.8094887323
172.30.15.199,49889,13.107.21.200,443,6,348,3,174,3,174,2367.982993,8.166691,170.448471725,170.448471725
172.30.15.199,49890,13.107.21.200,443,260,94270,119,22508,141,71762,2368.233682,18.203489,9891.7300963568,31537.6903845192
172.30.15.199,49892,13.107.21.200,443,36,11967,16,3598,20,8369,2386.774482,9.363102,3074.1948555083,7150.6216636322
172.30.15.199,49893,104.31.90.207,80,125,101007,53,15808,72,85199,2387.120935,9.168586,13793.1846851845,74339.9254803285
172.30.15.199,49894,104.31.90.207,80,271,207998,126,20666,145,187332,2387.122094,19.151641,8632.5761849858,78252.093384581
172.30.15.199,49895,104.31.90.207,80,228,179867,102,17348,126,162519,2387.209107,9.080472,15283.7870101913,143181.103361152
172.30.15.199,49896,104.31.90.207,80,220,164072,106,21311,114,142761,2388.962568,7.326679,23269.4785727605,155880.720309974
172.30.15.199,49897,104.31.90.207,80,241,175393,119,19326,122,156067,2388.971988,7.317157,21129.5179261551,170631.298467414
172.30.15.199,49898,104.31.90.207,80,193,140338,90,18792,103,121546,2388.973137,7.316064,20548.754084163,132908.624090766
172.30.15.199,49899,151.139.104.40,80,6,348,4,228,2,120,2389.290515,7.005691,260.3597560897,137.0314505735
172.30.15.199,49900,151.139.104.40,80,61,50607,23,1593,38,49014,2389.51379,4.589701,2776.6514637882,85433.0162248065
172.30.15.199,49901,178.237.36.10,80,12,2783,7,728,5,2055,2390.17775,1.664435,3499.0852751832,9877.2256050844
172.30.15.199,49902,192.0.77.32,443,40,13713,22,2259,18,11454,2390.908583,5.266537,3431.4768888931,17398.909378212
172.30.15.199,49903,198.58.102.214,80,33,18484,18,1910,15,16574,2391.20175,5.184971,2946.9788741347,25572.3706072817
172.30.15.199,49904,192.0.73.2,443,62,25544,31,2982,31,22562,2391.209066,4.954949,4814.5803317048,36427.4183245886
172.30.15.199,49905,192.0.73.2,443,21,8410,10,1145,11,7265,2391.296711,0.739028,12394.6589303795,78643.8402875168
172.30.15.199,49906,192.0.73.2,443,21,8410,10,1145,11,7265,2391.297212,0.73976,12382.3942900411,78566.0214123571
172.30.15.199,49907,198.58.102.214,80,12,3633,7,797,5,2836,2391.452702,4.991667,1277.3287961718,4545.1749886363
172.30.15.199,49908,23.198.105.137,443,40,16487,18,2205,22,14282,2391.513985,4.791401,3681.5954248038,23846.0525428786
172.30.15.199,49909,23.198.105.137,443,9,534,5,294,4,240,2391.706322,4.589957,512.4231011314,418.3045723522
172.30.15.199,49910,104.31.90.207,80,22,10971,12,1349,10,9622,2391.849885,4.439052,2431.1497139481,17340.6393977824
172.30.15.199,49911,104.31.90.207,80,6,348,4,228,2,120,2391.896457,4.392568,415.246844215,218.5509706395
172.30.15.199,49912,172.217.166.200,80,49,31061,25,1918,24,29143,2392.057667,4.117385,3726.6371738373,56624.2894458496
172.30.15.199,49913,172.217.160.226,80,19,9747,10,984,9,8763,2392.102248,4.035273,1950.7973809951,17372.8022862395
172.30.15.199,49914,172.217.160.226,80,6,348,4,228,2,120,2392.30722,3.829127,476.3487865511,250.7098876585
172.30.15.199,49915,104.16.208.165,443,37,11050,18,2350,19,8700,2392.429481,3.743206,5022.4326419651,18593.6868021686
172.30.15.199,49916,104.16.208.165,443,6,348,4,228,2,120,2392.446169,3.718217,490.5577054809,258.1882660426
172.30.15.199,49917,23.198.105.137,443,507,423244,211,15554,296,407690,2392.575744,3.721244,33438.2803170137,876459.592544896
172.30.15.199,49918,23.198.105.137,443,19,6259,10,1333,9,4926,2392.882161,3.218569,3313.2736939925,12243.9506501177
172.30.15.199,49919,23.198.105.137,443,19,6145,11,1285,8,4860,2392.883626,3.217285,3195.2407076151,12084.723610124
172.30.15.199,49920,23.198.105.137,443,17,6013,9,1153,8,4860,2392.888824,3.21173,2871.9724260757,12105.6253171967
172.30.15.199,49921,23.198.105.137,443,19,6145,11,1285,8,4860,2392.889557,3.210783,3201.7112336773,12109.1957942969
172.30.15.199,49922,23.198.105.137,443,21,6379,12,1453,9,4926,2392.890324,3.20973,3621.4884117978,12277.6682150834
172.30.15.199,49923,52.84.110.188,443,33,15266,18,2367,15,12899,2393.426757,2.706939,6995.3552702895,38121.2875502594
172.30.15.199,49924,52.84.110.188,443,8,480,5,294,3,186,2393.471051,2.666716,881.9836833018,557.9896771909
172.30.15.199,49925,52.84.110.77,443,18,6765,9,1153,9,5612,2394.06678,0.202756,45493.1050129935,221428.712344249
172.30.15.199,49926,52.84.110.77,443,508,406625,229,15660,279,390965,2394.067232,12.109646,10345.471700824,258283.355269007
172.30.15.199,49927,122.15.34.17,80,13,3134,8,1422,5,1712,2394.180112,1.953285,5824.0348950613,7011.7775951792
172.30.15.199,49928,192.0.73.2,80,15,3334,8,830,7,2504,2394.301267,1.859728,3570.4145982632,10771.467655483
172.30.15.199,49929,192.0.73.2,80,13,2476,7,763,6,1713,2394.302254,1.858795,3283.8478691847,7372.5182174487
172.30.15.199,49930,192.0.76.3,80,11,1327,6,830,5,497,2394.770295,1.3908,4774.2306586133,2858.7863100371
172.30.15.199,49931,50.17.52.222,443,179,127569,87,6605,92,120964,2395.341364,11.042153,4785.2986641281,87637.9814697343
172.30.15.199,49932,50.17.52.222,443,17,7116,9,1153,8,5963,2395.341737,0.819167,11260.219222703,58234.7677580033
172.30.15.199,49933,52.84.110.215,80,9,1334,6,676,3,658,2395.391746,0.743048,7278.1300804228,7084.3337173347
172.30.15.199,49934,146.88.138.85,80,67,56971,24,1652,43,55319,2395.415136,4.692341,2816.5045975986,94313.6911831441
172.30.15.199,49935,50.17.52.222,443,6,348,4,228,2,120,2395.559904,0.782298,2331.5923088144,1227.1538467444
172.30.15.199,49936,146.88.138.85,80,6,348,4,228,2,120,2395.564274,0.732273,2490.8743050745,1310.986476355
172.30.15.199,49937,45.56.120.142,80,16,6078,9,2135,7,3943,2395.567644,7.36588,2318.7996546238,4282.4482614434
172.30.15.199,49938,180.149.59.224,80,24,11927,12,994,12,10933,2395.635115,10.528335,755.2951155145,8307.4864164182
172.30.15.199,49939,157.240.16.20,443,65,39631,27,2498,38,37133,2395.776407,10.407848,1920.0895324374,28542.3076893506
172.30.15.199,49940,45.56.120.142,80,6,348,4,228,2,120,2395.815079,10.640155,171.4260741502,90.2242495528
172.30.15.199,49941,13.229.196.49,80,10,1844,6,1324,4,520,2395.875586,10.398093,1018.6483233032,400.0733596055
172.30.15.199,49942,172.217.166.193,80,47,29257,24,2924,23,26333,2396.043236,10.131333,2308.8768279555,20793.3151540872
172.30.15.199,49943,172.217.160.226,80,95,70692,41,6275,54,64417,2396.538404,9.658062,5197.7301450333,53358.1167733238
172.30.15.199,49944,172.217.160.226,80,130,110719,53,4007,77,106712,2396.538756,9.670583,3314.7949818537,88277.6147001678
172.30.15.199,49945,52.84.110.77,443,33,12466,19,2302,14,10164,2396.681701,9.495142,1939.5181241102,8563.5370171397
172.30.15.199,49946,157.240.16.39,443,35,6565,20,4491,15,2074,2396.744407,9.44108,3805.4968287526,1757.4260571884
172.30.15.199,49947,35.190.14.224,80,10,3884,7,2630,3,1254,2396.761284,9.4481,2226.9027635187,1061.8007853431
172.30.15.199,49948,35.190.14.224,80,19,6291,10,5256,9,1035,2396.761957,9.447295,4450.7978209636,876.4413517308
172.30.15.199,49949,172.217.166.193,443,21,8007,11,1393,10,6614,2397.030425,9.073154,1228.2388241178,5831.7096789054
172.30.15.199,49950,172.217.166.193,443,22,8097,12,1483,10,6614,2397.030959,9.072451,1307.6951311173,5832.1615625149
172.30.15.199,49951,172.217.166.193,443,6,348,4,228,2,120,2397.031542,9.178098,198.7339860612,104.596834769
172.30.15.199,49952,104.27.177.100,80,65,45886,31,2334,34,43552,2397.039683,9.23351,2022.1995752428,37733.8628538875
172.30.15.199,49953,104.27.177.100,80,17,8918,9,913,8,8005,2397.039958,9.233053,791.0709491216,6935.9506546748
172.30.15.199,49954,52.84.110.109,80,6,348,4,228,2,120,2397.044261,9.132516,199.7259024786,105.1188960414
172.30.15.199,49955,104.27.177.100,80,7,402,4,228,3,174,2397.169437,9.104391,200.3428894915,152.8932577698
172.30.15.199,49956,52.84.110.109,80,62,40693,32,3414,30,37279,2397.196109,8.980938,3041.1077328448,33207.2217846282
172.30.15.199,49957,172.217.166.193,443,18,7833,9,1273,9,6560,2397.282215,8.821008,1154.516581325,5949.4334434342
172.30.15.199,49958,35.190.14.224,80,15,3898,8,3158,7,740,2397.40358,8.819095,2864.6930325618,671.2706916073
172.30.15.199,49959,104.17.146.111,443,24,7212,12,1745,12,5467,2397.473161,8.714978,1601.8399587469,5018.4865641658
172.30.15.199,49960,104.31.90.207,80,179,161131,67,5086,112,156045,2397.486805,8.786453,4630.7651107904,142077.810010476
172.30.15.199,49961,104.31.90.207,80,88,68889,38,4711,50,64178,2397.492523,8.781402,4291.7975967846,58467.2014787611
172.30.15.199,49962,104.17.146.111,443,6,348,4,228,2,120,2397.513322,8.673745,210.289788321,110.6788359584
172.30.15.199,49963,104.31.90.207,80,162,121447,79,11438,83,110009,2397.787244,8.486636,10782.1285135829,103700.924606639
172.30.15.199,49964,104.31.90.207,80,114,99909,45,3834,69,96075,2397.79565,8.478133,3617.777640431,90656.7519051652
172.30.15.199,49965,52.84.114.151,443,24,10025,13,2767,11,7258,2397.932762,8.212728,2695.3285193422,7070.0015877794
172.30.15.199,49966,35.190.14.224,80,6,348,4,228,2,120,2398.176345,8.033361,227.0531599414,119.501663127
172.30.15.199,49967,104.31.90.207,80,42,32642,17,2162,25,30480,2398.29378,7.979534,2167.5451223091,30558.1754523508
172.30.15.199,49968,54.248.216.124,443,36,13394,20,4825,16,8569,2398.606551,8.769448,4401.6453487152,7817.1396876976
172.30.15.199,49969,151.139.104.40,443,78,47554,41,3578,37,43976,2398.652165,8.233296,3476.6149546914,42729.91035425
172.30.15.199,49970,23.23.150.12,80,22,11407,13,5032,9,6375,2398.672062,7.710181,5221.1485048147,6614.6307071132
172.30.15.199,49971,23.23.150.12,80,12,4165,7,1651,5,2514,2398.860222,7.532524,1753.462717145,2670.021363357
172.30.15.199,49972,23.23.150.12,80,6,348,4,228,2,120,2399.12382,7.261128,251.2006399006,132.2108631056
172.30.15.199,49973,184.29.32.107,443,23,10161,12,2849,11,7312,2399.271105,7.054953,3230.6381063062,8291.4797589718
172.30.15.199,49974,52.222.150.199,443,22,10144,12,1909,10,8235,2399.660047,6.652574,2295.6527804125,9902.9338117845
172.30.15.199,49975,104.16.208.165,443,42,12004,22,2392,20,9612,2399.905874,6.288926,3042.8088993255,12227.2069984601
172.30.15.199,49976,172.217.166.198,443,39,17423,19,3660,20,13763,2400.092529,6.074371,4820.2521709654,18125.9919751357
172.30.15.199,49977,23.56.25.39,443,22,8388,11,1679,11,6709,2401.83559,4.489428,2991.9179013452,11955.197855941
172.30.15.199,49978,23.56.25.39,443,8,480,5,294,3,186,2402.028242,4.29904,547.0988871934,346.1237857754
172.30.15.199,49979,23.56.25.39,80,15,3944,9,846,6,3098,2402.400864,4.393526,1540.4483779088,5641.0272751319
172.30.15.199,49980,54.248.216.124,443,15,2738,8,1497,7,1241,2402.409121,3.90971,3063.1427906418,2539.3187730037
172.30.15.199,49981,54.248.216.124,443,15,2683,8,1497,7,1186,2402.409654,3.909064,3063.6489962815,2427.179498724
172.30.15.199,49982,54.248.216.124,443,18,3877,10,2141,8,1736,2402.410225,3.908931,4381.7606399295,3552.8895240157
172.30.15.199,49983,54.248.216.124,443,21,4111,12,2201,9,1910,2402.410653,4.586211,3839.33491067,3331.7263422898
172.30.15.199,49984,54.248.216.124,443,13,1470,7,958,6,512,2402.411125,4.769801,1606.775628585,858.7360353189
172.30.15.199,49985,217.12.15.54,443,23,10135,13,2550,10,7585,2402.6507,3.676851,5548.2259139687,16503.2523754715
172.30.15.199,49986,35.187.209.245,443,20,8738,10,1714,10,7024,2403.086521,3.221498,4256.4049395655,17442.8169752091
172.30.15.199,49987,103.243.221.17,443,21,7953,11,2855,10,5098,2403.197786,3.163176,7220.5909503612,12893.370460575
172.30.15.199,49988,35.187.209.245,443,9,546,6,360,3,186,2403.213012,13.082654,220.1388189277,113.7383897793
172.30.15.199,49989,34.239.20.30,443,29,10960,16,2577,13,8383,2403.252592,3.141471,6562.5307379879,21347.960875651
172.30.15.199,49990,173.241.248.143,443,6,348,4,228,2,120,2403.255422,3.112155,586.0890604742,308.4679265654
172.30.15.199,49991,103.243.221.17,443,6,340,4,228,2,112,2403.370161,2.98976,610.0824146419,299.6896071925
172.30.15.199,49992,34.239.20.30,443,6,348,4,228,2,120,2403.406413,2.985062,611.0425847102,321.6013603738
172.30.15.199,49993,173.241.248.143,443,21,5096,12,1806,9,3290,2403.407107,2.961537,4878.5478621403,8887.2771132013
172.30.15.199,49994,151.139.104.66,80,26,18004,11,961,15,17043,2403.560099,2.728829,2817.3256733931,49964.2887113826
172.30.15.199,49995,52.84.114.126,443,25,9872,14,3098,11,6774,2403.766301,2.398303,10333.9736472,22595.9772389066
172.30.15.199,49996,107.178.254.65,443,33,9301,18,2462,15,6839,2404.275319,1.934436,10181.7790818616,28283.1791798746
172.30.15.199,49997,104.16.208.165,443,25,7295,13,1764,12,5531,2404.85403,1.339668,10533.9531884013,33029.0788463989
172.30.15.199,49998,35.161.126.85,443,21,9129,11,2381,10,6748,2404.943654,11.520561,1653.3917054908,4685.8829183753
172.30.15.199,49999,35.161.126.85,443,6,340,4,228,2,112,2405.135754,1.331945,1369.4259147338,672.7004493429
172.30.15.199,50000,172.217.166.234,80,17,8296,9,860,8,7436,2405.616796,0.593009,11601.8475267628,100315.509545358
172.30.15.199,50001,104.17.146.111,443,21,3624,11,1651,10,1973,2406.260034,9.929239,1330.2127182154,1589.6485118346
172.30.15.199,50002,151.139.104.116,443,31,12037,16,1975,15,10062,2406.274132,10.02049,1576.7691999094,8033.1400959435
172.30.15.199,50003,35.190.14.224,80,14,3397,8,2711,6,686,2406.748367,9.441326,2297.1349575262,581.2742828709
172.30.15.199,50004,52.19.169.14,443,21,8022,10,1732,11,6290,2407.973121,8.33895,1661.6000815451,6034.3328596527
172.30.15.199,50005,52.19.169.14,443,6,340,4,228,2,112,2408.171051,8.146576,223.8977455068,109.9848574419
172.30.15.199,50006,104.20.185.29,443,27,6222,14,1883,13,4339,2409.004401,7.184777,2096.6551919427,4831.3260105359
172.30.15.199,50007,104.31.90.207,80,17,5718,10,4416,7,1302,2409.382308,6.845792,5160.5424178827,1521.5186204899
172.30.15.199,50008,198.58.102.214,80,11,1667,6,732,5,935,2409.438934,6.23486,939.2352033566,1199.7061682219
172.30.15.199,50009,35.190.14.224,80,13,3033,8,2552,5,481,2409.476531,7.033854,2902.5339451173,547.0685061134
172.30.15.199,50010,198.58.102.214,80,6,348,4,228,2,120,2409.691046,6.722796,271.315684724,142.7977288021
172.30.15.199,50011,157.240.16.39,443,21,3366,11,2097,10,1269,2415.33233,0.856703,19582.048854739,11850.0810666017
172.30.15.199,50012,151.139.104.116,443,1127,976092,455,28334,672,947758,2416.678434,27.316058,8298.1226646979,277568.015121363
172.30.15.199,50013,104.31.90.207,80,19,5670,11,4302,8,1368,2416.979248,9.694578,3550.0255916245,1128.8784308095
172.30.15.199,50014,162.125.34.6,443,22,7209,12,2813,10,4396,2428.093894,1117.669575,20.134752259,31.4654713581
172.30.15.199,50015,104.31.90.207,80,17,4890,10,3588,7,1302,2431.139522,5.091602,5637.5184077625,2045.721562683
172.30.15.199,50016,162.125.82.3,443,6,348,4,228,2,120,2434.00658,0.337818,5399.3570502465,2841.7668685508
172.30.15.199,50017,162.125.248.4,443,6,348,4,228,2,120,2434.342568,0.174014,10481.9152481882,5516.7974990464
172.30.15.199,50018,104.31.90.207,80,12,2646,7,1908,5,738,2439.907186,6.33523,2409.3837161397,931.9314373748
172.30.15.199,50019,104.31.90.207,80,12,2646,7,1908,5,738,2454.909099,1.340576,11386.1504308591,4404.0770534455
172.30.15.199,50020,104.31.90.207,80,12,2626,7,1888,5,738,2469.906714,6.330377,2385.9558443361,932.6458755932
172.30.15.199,50021,104.31.90.207,80,13,2670,8,1932,5,738,2491.365993,5.261661,2937.475447392,1122.0791305255
172.30.15.199,50022,104.31.90.207,80,12,2628,7,1890,5,738,2491.366934,4.970135,3042.1708867063,1187.8952986187
172.30.15.199,50023,172.25.10.63,7680,3,198,3,198,0,0,2493.152756,9.002767,175.9459064086,0
172.30.15.199,50025,157.240.16.52,443,43,23154,19,2014,24,21140,2495.830209,10.355702,1555.8578259591,16331.0995237216
172.30.15.199,50026,158.85.224.180,443,1401,526852,725,59473,676,467379,2499.592954,3001.454189,158.5178283726,1245.740152791
172.30.15.199,50027,157.240.16.52,443,27,4745,14,1865,13,2880,2532.63753,3.563849,4186.4848931589,6464.9203712052
172.30.15.199,50029,157.240.16.52,443,27,4178,14,1841,13,2337,2537.329813,8.880718,1658.424465229,2105.2351848127
172.30.15.199,50030,157.240.16.52,443,241,173021,116,8908,125,164113,2545.747993,10.451601,6818.4769012899,125617.501089065
172.30.15.199,50031,157.240.16.52,443,6,348,4,228,2,120,2545.776,0.434618,4196.788904277,2208.8362654089
172.30.15.199,50032,158.85.224.180,443,26,8586,11,3810,15,4776,2547.61545,1.419781,21468.0996576224,26911.192641681
172.30.15.199,50033,158.85.224.180,443,25,7238,12,2570,13,4668,2547.616018,1.117118,18404.5015835446,33428.8768062203
172.30.15.199,50034,158.85.224.180,443,7,402,4,228,3,174,2547.818027,8.652145,210.8147748333,160.8849597412
172.30.15.199,50036,52.84.110.85,443,48,27007,24,2649,24,24358,2575.919599,10.308253,2055.8284706438,18903.6881419186
172.30.15.199,50037,23.111.9.22,443,25,9087,14,1874,11,7213,2575.988768,10.175737,1473.3085180955,5670.7440453699
172.30.15.199,50038,104.19.196.151,443,16,5897,9,1091,7,4806,2576.169602,9.994009,873.3232079339,3847.104800486
172.30.15.199,50039,128.199.67.15,443,25,9132,13,2174,12,6958,2576.19138,10.143434,1714.6067101142,5487.6878974125
172.30.15.199,50040,23.111.9.22,443,6,348,4,228,2,120,2576.241453,10.152273,179.6641993374,94.5601049144
172.30.15.199,50041,52.84.108.50,443,18,6915,10,1207,8,5708,2576.242993,9.920964,973.2925147193,4602.778520313
172.30.15.199,50042,108.161.189.78,443,18,6846,10,1321,8,5525,2576.264136,9.900114,1067.4624554828,4464.595054158
172.30.15.199,50043,34.213.23.47,443,22,9049,12,2408,10,6641,2578.471676,7.693213,2504.0253012623,6905.8272531906
172.30.15.199,50044,34.213.23.47,443,6,340,4,228,2,112,2578.703722,7.816163,233.3625846851,114.634252126
172.30.15.199,50045,104.25.149.25,443,26,7576,14,1776,12,5800,2582.039005,4.214691,3371.0656368402,11009.110750942
172.30.15.199,50046,216.239.36.21,443,37,7290,18,2270,19,5020,2586.950767,9.324905,1947.4729233166,4306.7462885679
172.30.15.199,50047,104.16.37.47,443,32,10902,17,2033,15,8869,2588.690126,7.585162,2144.1862415068,9354.0520294756
172.30.15.199,50048,169.55.60.80,443,20,7668,11,1753,9,5915,2589.028365,7.365449,1904.0251313939,6424.5913589247
172.30.15.199,50049,169.55.60.80,443,6,348,4,228,2,120,2589.227327,7.16699,254.5001458074,133.9474451618
172.30.15.199,50051,104.27.189.78,443,266,173703,109,8940,157,164763,2615.717083,10.580766,6759.4349974283,124575.479695893
172.30.15.199,50052,104.27.189.78,443,7,414,5,294,2,120,2615.762274,10.534589,223.2645241309,91.1283771963
172.30.15.199,50053,209.197.3.15,443,28,13149,13,1791,15,11358,2617.478088,8.898241,1610.2058822636,10211.456399079
172.30.15.199,50054,209.197.3.15,443,46,28983,19,2109,27,26874,2617.478735,8.882347,1899.4979592669,24204.4135407011
172.30.15.199,50055,209.197.3.15,443,6,348,4,228,2,120,2617.680404,8.683658,210.0497278912,110.5524883638
172.30.15.199,50056,117.18.237.66,443,18,6710,10,1775,8,4935,2617.841807,8.390237,1692.4432527949,4705.468987348
172.30.15.199,50057,209.197.3.15,443,19,6715,9,1141,10,5574,2618.654245,7.709367,1184.0141998688,5784.1324715765
172.30.15.199,50058,209.197.3.15,443,117,97619,41,3900,76,93719,2618.657888,7.718869,4042.0429469655,97132.3648581182
172.30.15.199,50059,104.244.42.8,443,34,9010,18,3225,16,5785,2623.027748,3.360358,7677.7533822291,13772.342113549
172.30.15.199,50060,104.244.42.8,443,6,348,4,228,2,120,2623.232803,3.143614,580.2239078971,305.3810041564
172.30.15.199,50061,157.240.16.39,443,234,177157,108,9335,126,167822,2625.926473,10.312685,7241.5670603728,130186.852405558
172.30.15.199,50062,157.240.16.20,443,174,126800,76,5801,98,120999,2626.52832,9.710047,4779.3795436829,99689.7337366129
172.30.15.199,50063,157.240.16.20,443,70,39799,32,3107,38,36692,2627.684659,8.554893,2905.4717575077,34312.0597767851
172.30.15.199,50064,184.85.113.82,443,25,9310,12,1254,13,8056,2648.509065,62.022235,161.748443925,1039.1112155181
172.30.15.199,50066,34.200.202.18,443,122,98034,52,5419,70,92615,2657.618984,8.825023,4912.3951291686,83956.7216991968
172.30.15.199,50067,34.200.202.18,443,142,101903,69,7652,73,94251,2657.619594,8.827651,6934.5741013096,85414.3418220765
172.30.15.199,50068,34.200.202.18,443,72,58665,27,4421,45,54244,2657.850894,8.59346,4115.6879766706,50497.9368031035
172.30.15.199,50069,52.84.108.93,443,211,155911,103,7912,108,147999,2660.239093,5.994323,10559.3242139273,197518.885785771
172.30.15.199,50070,52.84.108.93,443,2035,1833640,783,49049,1252,1784591,2660.239472,16.078049,24405.4486959212,887963.956323322
172.30.15.199,50071,52.84.108.93,443,49,30947,24,2495,25,28452,2660.239815,5.990818,3331.7653782838,37994.1437045812
172.30.15.199,50072,34.200.202.18,443,12,1416,6,904,6,512,2661.121034,5.333332,1356.0003390001,768.000192
172.30.15.199,50073,34.200.202.18,443,20,9264,9,2269,11,6995,2661.122696,5.320051,3411.9973661906,10518.6961553561
172.30.15.199,50074,52.84.108.93,443,37,24317,17,2930,20,21387,2674.64732,1.667658,14055.6397055045,102596.575556868
172.30.15.199,50075,52.84.108.93,443,16,5114,9,1567,7,3547,2674.648214,1.666356,7523.0022876256,17028.7741635023
172.30.15.199,50076,34.200.202.18,443,134,99065,60,12603,74,86462,2674.669865,11.797732,8546.0493593175,58629.5738875913
172.30.15.199,50077,34.200.202.18,443,140,97259,66,10619,74,86640,2674.689606,11.781983,7210.3312320174,58828.8066618312
172.30.15.199,50078,34.200.202.18,443,31,13250,18,8325,13,4925,2674.694069,4.107026,16216.1135575975,9593.3164289691
172.30.15.199,50079,34.200.202.18,443,78,54260,36,7970,42,46290,2674.716916,14.381801,4433.3807706003,25749.2090177023
172.30.15.199,50080,34.200.202.18,443,126,100842,55,10467,71,90375,2674.743773,31.756224,2636.8374275229,22767.1904569008
172.30.15.199,50081,34.200.202.18,443,27,14222,13,4990,14,9232,2674.749447,1.792144,22274.9957592693,41210.974118151
172.30.15.199,50082,52.84.108.93,443,11,1344,6,906,5,438,2674.815809,1.502167,4825.0294408023,2332.6301270104
172.30.15.199,50083,52.84.108.93,443,11,1344,6,906,5,438,2674.81965,1.497985,4838.4997179546,2339.1422477529
172.30.15.199,50084,34.200.202.18,443,18,4397,11,2698,7,1699,2676.379042,11.516301,1874.2129091624,1180.2400788239
172.30.15.199,50085,52.84.108.93,443,122,84308,60,6860,62,77448,2676.647022,9.579122,5729.1263228508,64680.6669755322
172.30.15.199,50086,52.4.148.116,443,90,16964,40,5203,50,11761,2677.095517,602.584049,69.0758410699,156.140873885
172.30.15.199,50087,34.200.202.18,443,27,10862,14,3871,13,6991,2677.500042,10.394924,2979.1463602813,5380.3183169017
172.30.15.199,50088,52.84.108.164,443,42,23406,22,2749,20,20657,2677.549596,8.676735,2534.5939457642,19045.8738223537
172.30.15.199,50089,52.84.108.164,443,82,57645,38,5092,44,52553,2677.550064,8.676006,4695.2480208058,48458.2421911641
172.30.15.199,50090,52.84.108.164,443,40,24948,18,3318,22,21630,2679.553044,6.672914,3977.8723358342,25931.699404489
172.30.15.199,50091,52.84.108.164,443,30,18109,13,2154,17,15955,2679.554169,6.672499,2582.5406642999,19129.2647627229
172.30.15.199,50092,52.84.108.164,443,11,1345,6,907,5,438,2680.203778,6.022494,1204.8164763635,581.8187614633
172.30.15.199,50093,52.84.108.164,443,11,1345,6,907,5,438,2680.204769,6.009504,1207.4207788197,583.0764069713
172.30.15.199,50094,52.84.108.93,443,14,3306,8,1483,6,1823,2685.64787,0.578338,20513.9555069781,25217.0875854492
172.30.15.199,50095,52.84.108.93,443,18,3676,10,1641,8,2035,2685.648915,10.656954,1231.8716961714,1527.6410126196
172.30.15.199,50096,192.168.1.44,7680,3,198,3,198,0,0,2694.44195,9.001646,175.9678174414,0
172.30.15.199,50097,34.200.202.18,443,17,4237,10,2633,7,1604,2695.865999,10.635205,1980.5918174591,1206.5587828349
172.30.15.199,50098,34.200.202.18,443,15,3949,8,2250,7,1699,2695.932819,10.567873,1703.2755787281,1286.1623147818
172.30.15.199,50099,34.200.202.18,443,12,1416,6,904,6,512,2696.023168,10.462737,691.2149277957,391.4845608754
172.30.15.199,50100,172.25.10.224,7680,3,198,3,198,0,0,2701.317139,9.000507,175.9900858918,0
172.30.15.199,50101,192.168.45.1,7680,3,198,3,198,0,0,2734.510854,9.004756,175.9070429004,0
172.30.15.199,50102,52.229.175.79,443,28,10096,15,2246,13,7850,2765.344672,125.224878,143.4858654843,501.4977934337
172.30.15.199,50106,34.200.202.18,443,17,4268,10,2663,7,1605,2856.642104,9.999729,2130.4577354046,1284.034797343
172.30.15.199,50107,34.200.202.18,443,6,348,4,228,2,120,2856.856454,9.787919,186.3521755748,98.0800924078
172.30.15.199,50108,172.30.24.126,7680,3,198,3,198,0,0,2896.144392,8.21049,192.9239302405,0
172.30.15.199,50109,172.30.30.101,7680,3,198,3,198,0,0,2935.642989,8.883378,178.310548082,0
172.30.15.199,50112,34.232.42.95,443,21,9748,12,2706,9,7042,3037.712474,9.328207,2320.7032176709,6039.3170949144
172.30.15.199,50113,34.232.42.95,443,6,348,4,228,2,120,3037.855766,9.185406,198.5758713333,104.5136164912
172.30.15.199,50115,13.107.4.52,80,10,1685,6,644,4,1041,3093.179094,0.432092,11923.3866861684,19273.6731992256
172.30.15.199,50116,184.29.26.80,80,14,2545,8,686,6,1859,3093.433272,60.196761,91.1676958832,247.0564819924
172.30.15.199,50117,162.125.82.3,443,6,348,4,228,2,120,3094.591516,1.348483,1352.6310676514,711.9110882376
172.30.15.199,50119,74.125.24.188,5228,6,348,4,228,2,120,3097.67552,9.164409,199.0308376678,104.7530724567
172.30.15.199,50120,74.125.24.188,5228,98,7101,49,3514,49,3587,3097.886435,1821.684965,15.4318669474,15.7524492716
172.30.15.199,50121,172.217.166.196,443,19,3351,10,1478,9,1873,3102.163388,1.188345,9949.9724406631,12609.132869663
172.30.15.199,50122,172.217.166.196,443,19,3303,10,1478,9,1825,3102.163886,1.187717,9955.233443655,12292.4905511978
172.30.15.199,50123,172.217.166.196,443,19,3207,10,1478,9,1729,3102.164363,1.187759,9954.881419548,11645.460063869
172.30.15.199,50124,172.217.166.196,443,19,3235,10,1490,9,1745,3102.164762,1.256348,9487.8170697902,11111.5709978415
172.30.15.199,50125,172.217.166.196,443,21,3348,11,1544,10,1804,3102.165165,1.101646,11212.3132113212,13100.3970422432
172.30.15.199,50126,172.217.166.196,443,18,3097,10,1502,8,1595,3104.308793,1.6651,7216.3834003976,7663.2034112079
172.30.15.199,50127,172.217.166.196,443,7,402,4,228,3,174,3104.309377,10.629687,171.5948926812,130.9539970462
172.30.15.199,50128,172.217.166.196,443,16,2965,8,1370,8,1595,3104.554916,0.392197,27945.1398149311,32534.6700765074
172.30.15.199,50130,52.229.170.171,443,31,10730,19,2447,12,8283,3161.135299,110.641061,176.9325042897,598.9096579614
172.30.15.199,50132,34.232.42.95,443,17,4484,10,2599,7,1885,3199.139926,7.943576,2617.4609520951,1898.3893400151
172.30.15.199,50133,34.232.42.95,443,6,348,4,228,2,120,3199.335924,7.752758,235.2711125512,123.8269013427
172.30.15.199,50134,52.84.108.149,443,15,4471,8,1437,7,3034,3200.183294,6.639324,1731.5015805826,3655.7938729906
172.30.15.199,50136,52.229.168.53,443,30,10163,17,2314,13,7849,3211.263062,119.133318,155.3889399773,527.073375057
172.30.15.199,50137,34.232.42.95,443,6,348,4,228,2,120,3214.096633,2.963133,615.5646742823,323.981407517
172.30.15.199,50138,34.232.42.95,443,197,144425,104,137777,93,6648,3214.348247,2.711147,406549.70018225,19616.7894990572
172.30.15.199,50140,34.232.42.95,443,23,7424,14,4360,9,3064,3217.431917,9.606707,3630.7966923526,2551.5507030661
172.30.15.199,50141,34.232.42.95,443,18,4306,10,2655,8,1651,3230.438824,6.741381,3150.6897473973,1959.2424756885
172.30.15.199,50142,34.232.42.95,443,20,5230,11,2996,9,2234,3230.464685,6.653599,3602.2609718439,2686.065090487
172.30.15.199,50143,34.232.42.95,443,18,4841,10,2636,8,2205,3240.18689,6.862292,3073.0257470826,2570.5697163571
172.30.15.199,50144,34.232.42.95,443,6,348,4,228,2,120,3240.438315,6.714147,271.6651869552,142.9816773449
172.30.15.199,50145,52.175.23.79,443,25,10117,12,2071,13,8046,3240.577953,121.393953,136.4812627858,530.2405796111
172.30.15.199,50146,34.232.42.95,443,19,4987,10,2635,9,2352,3251.649385,5.399918,3903.7629830678,3484.4973571823
172.30.15.199,50147,192.168.1.44,7680,3,198,3,198,0,0,3256.834415,9.001746,175.9658626226,0
172.30.15.199,50148,192.168.45.1,7680,3,198,3,198,0,0,3296.924546,9.010689,175.7912186293,0
172.30.15.199,50149,157.240.16.52,443,398,354151,143,9729,255,344422,3316.145715,10.740664,7246.4793610526,256536.839808043
172.30.15.199,50150,52.114.132.21,443,26,12939,16,8189,10,4750,3331.969873,1.459968,44872.2163773417,26027.9677362771
172.30.15.199,50151,162.125.82.3,443,6,348,4,228,2,120,3334.537952,0.379933,4800.8464650383,2526.7612973886
172.30.15.199,50152,162.125.248.4,443,6,348,4,228,2,120,3334.716867,0.344615,5292.8630500707,2785.7173947741
172.30.15.199,50153,34.195.182.87,443,100,79990,61,73818,39,6172,3336.084574,88.040885,6707.6109014579,560.8303460375
172.30.15.199,50155,157.240.16.52,443,28,10166,13,1702,15,8464,3342.280227,4.640783,2933.9876482052,14590.6412775608
172.30.15.199,50156,158.85.224.180,443,10,600,6,360,4,240,3354.009527,13.181926,218.480971597,145.6539810647
172.30.15.199,50157,158.85.224.180,443,24,7272,11,2604,13,4668,3354.259815,1.146554,18169.2270926632,32570.6421154193
172.30.15.199,50159,204.79.197.200,443,877,740215,305,28726,572,711489,3404.468485,12.455245,18450.7008894645,456989.164002792
172.30.15.199,50161,204.79.197.200,443,563,333008,229,29698,334,303310,3427.93861,9.113805,26068.5849653357,266242.255567242
172.30.15.199,50162,180.149.59.138,80,40,31159,16,1375,24,29784,3433.443968,3.60041,3055.2076013565,66179.1295991288
172.30.15.199,50163,180.149.59.138,80,6,348,4,228,2,120,3433.444915,3.601526,506.4519872965,266.5536775245
172.30.15.199,50164,180.149.59.138,80,6,348,4,228,2,120,3433.511514,3.532245,516.3854715627,271.7818271382
172.30.15.199,50165,68.232.44.114,80,20,12084,9,1007,11,11077,3434.378877,2.674093,3012.6102570104,33138.7128271145
172.30.15.199,50166,52.84.112.65,80,18,9721,8,869,10,8852,3434.380804,2.672025,2601.7720642581,26502.7460446635
172.30.15.199,50167,172.217.167.2,80,12,1830,7,876,5,954,3434.381385,2.671155,2623.5841798773,2857.1909904143
172.30.15.199,50168,104.18.255.119,80,10,2251,6,753,4,1498,3434.381994,2.765649,2178.1505896085,4333.1601370963
172.30.15.199,50169,180.149.59.136,80,187,159953,75,7189,112,152764,3434.518974,12.45369,4618.0690221132,98132.521365155
172.30.15.199,50170,180.149.59.136,80,107,80273,48,6092,59,74181,3434.51947,12.453244,3913.518437445,47654.0891674498
172.30.15.199,50171,180.149.59.136,80,47,34967,21,3052,26,31915,3434.51988,2.523371,9675.9453920957,101182.10917062
172.30.15.199,50172,180.149.59.136,80,144,117907,61,5877,83,112030,3434.520276,2.523322,18632.5803841126,355182.572814725
172.30.15.199,50173,180.149.59.136,80,86,73948,33,2689,53,71259,3434.520673,12.452284,1727.5545594688,45780.5170521329
172.30.15.199,50174,180.149.59.136,80,107,77868,47,6452,60,71416,3434.521059,12.461785,4141.9427473673,45846.4016190298
172.30.15.199,50175,54.85.78.249,80,10,1259,6,751,4,508,3434.604226,2.584592,2324.5448411199,1572.3951788134
172.30.15.199,50176,54.85.78.249,80,6,348,4,228,2,120,3434.821903,2.376645,767.4684271316,403.9307511219
172.30.15.199,50177,180.149.59.139,80,19,9280,10,1014,9,8266,3435.215181,1.828645,4436.0715174349,36162.2950326598
172.30.15.199,50178,180.149.59.139,80,15,7197,7,819,8,6378,3435.215685,1.827999,3584.2470373341,27912.4879171145
172.30.15.199,50179,151.139.104.143,80,14,5068,7,841,7,4227,3435.469579,1.679112,4006.8798269566,20139.2164429793
172.30.15.199,50180,52.84.101.238,443,231,196041,92,6214,139,189827,3435.477524,1.575387,31555.4209854404,963963.77524995
172.30.15.199,50181,184.29.26.86,80,38,30747,14,1287,24,29460,3436.047511,1.005721,10237.4316535103,234339.34460949
172.30.15.199,50182,104.18.255.119,443,66,35126,31,2856,35,32270,3436.186861,10.829603,2109.7726297077,23838.3623111584
172.30.15.199,50183,54.231.114.138,443,114,89937,43,3477,71,86460,3436.876375,8.941469,3110.8982204154,77356.4164903971
172.30.15.199,50184,205.185.216.42,80,46,34037,18,1396,28,32641,3436.885359,10.284796,1085.8747222599,25389.7111814374
172.30.15.199,50185,205.185.216.42,80,6,348,4,228,2,120,3436.938528,10.273882,177.5375656446,93.4408240235
172.30.15.199,50186,54.231.114.138,443,7,409,4,228,3,181,3436.998366,10.264138,177.7061064456,141.0737073099
172.30.15.199,50187,122.15.34.17,80,10,1641,6,1165,4,476,3437.206914,9.765675,954.3631136608,389.9372035215
172.30.15.199,50188,151.101.66.202,80,10,1987,6,944,4,1043,3437.20917,10.043362,751.9394401994,830.7974958983
172.30.15.199,50189,180.149.59.145,80,10,1522,6,769,4,753,3437.357996,9.625148,639.1590030616,625.8605062489
172.30.15.199,50190,151.101.66.202,80,6,348,4,228,2,120,3437.411192,9.849317,185.1905061031,97.4686874227
172.30.15.199,50191,50.23.131.235,80,16,5973,8,904,8,5069,3437.797803,4.836904,1495.171291388,8383.8753053602
172.30.15.199,50192,50.23.131.235,80,6,348,4,228,2,120,3438.005845,9.258247,197.0135383081,103.6913359516
172.30.15.199,50193,157.240.16.63,80,14,2056,8,1278,6,778,3438.057757,8.942914,1143.2515173466,695.9700160373
172.30.15.199,50194,151.101.130.2,443,55,25488,26,2879,29,22609,3438.458176,8.563466,2689.5651830696,21121.3543674954
172.30.15.199,50195,192.229.237.25,443,32,15837,17,3074,15,12763,3438.46999,8.504921,2891.5024607519,12005.2849403308
172.30.15.199,50196,210.176.156.62,80,15,6620,9,5100,6,1520,3438.482986,8.686792,4696.7856488333,1399.8263110248
172.30.15.199,50197,210.176.156.62,80,14,5168,8,3648,6,1520,3438.483429,8.686627,3359.6469607824,1399.852900326
172.30.15.199,50198,210.176.156.62,80,16,6669,9,5083,7,1586,3438.483759,8.686254,4681.4196315237,1460.6987085573
172.30.15.199,50199,210.176.156.62,80,15,6604,9,5084,6,1520,3438.484069,8.685854,4682.5562575656,1399.9774806254
172.30.15.199,50200,210.176.156.62,80,14,5165,8,3648,6,1517,3438.484391,8.685321,3360.1521463628,1397.3001113028
172.30.15.199,50201,210.176.156.62,80,14,5184,8,3664,6,1520,3438.484708,8.685123,3374.9665951765,1400.0953124095
172.30.15.199,50202,103.243.220.231,80,24,9337,13,5358,11,3979,3438.495529,8.76619,4889.6955233686,3631.2240551481
172.30.15.199,50203,103.243.220.231,80,32,14984,17,8748,15,6236,3438.495958,8.765944,7983.6238972093,5691.1155261771
172.30.15.199,50204,103.243.220.231,80,13,4618,8,3550,5,1068,3438.496365,8.765493,3239.9774890015,974.7312558461
172.30.15.199,50205,103.243.220.231,80,27,11563,14,6945,13,4618,3438.496682,8.76513,6338.7536750737,4214.8832932311
172.30.15.199,50206,103.243.220.231,80,30,13935,17,10004,13,3931,3438.496985,8.764687,9131.1874571221,3588.0345755645
172.30.15.199,50207,103.243.220.231,80,13,4627,8,3558,5,1069,3438.497305,8.764461,3247.661208145,975.7588059323
172.30.15.199,50208,173.241.248.220,80,18,8651,9,1931,9,6720,3438.519985,8.719979,1771.5638994085,6165.1524619498
172.30.15.199,50209,104.20.15.243,80,19,8567,10,1061,9,7506,3438.568638,8.448555,1004.6688457375,7107.4876117869
172.30.15.199,50210,157.240.16.63,443,25,6211,13,1699,12,4512,3438.677545,8.32922,1631.8454789284,4333.6590941288
172.30.15.199,50211,173.241.248.220,80,6,535,4,228,2,307,3438.745835,8.424387,216.5142698217,291.5345650669
172.30.15.199,50212,104.28.18.232,443,42,12097,21,2372,21,9725,3439.403906,7.658915,2477.6355397599,10158.0968061403
172.30.15.199,50213,104.28.18.232,443,6,348,4,228,2,120,3439.518773,7.542347,241.8345377109,127.2813356373
172.30.15.199,50214,104.244.42.72,443,11,1376,7,958,4,418,3439.68662,7.259911,1055.6603242106,460.6117072234
172.30.15.199,50215,104.244.42.72,443,29,7040,16,5239,13,1801,3439.686961,7.574364,5533.4018803427,1902.2059145824
172.30.15.199,50216,67.202.94.86,80,8,1472,5,747,3,725,3439.702824,0.845314,7069.5623164871,6861.3556619186
172.30.15.199,50217,157.240.16.37,443,49,22735,22,2305,27,20430,3439.703232,7.298065,2526.6971450652,22394.9772987773
172.30.15.199,50218,67.202.94.86,80,8,1358,5,982,3,376,3439.752884,1.185428,6627.1422642273,2537.4801337571
172.30.15.199,50219,184.29.25.103,80,13,3215,7,2003,6,1212,3439.760544,2.338132,6853.3342001226,4146.9001750118
172.30.15.199,50220,184.29.26.86,443,23,10140,12,2115,11,8025,3439.970791,7.019774,2410.334007904,9145.5935760897
172.30.15.199,50221,184.29.26.86,443,24,8947,13,2170,11,6777,3439.973033,7.017679,2473.752361714,7725.6312236572
172.30.15.199,50222,184.29.26.86,443,25,10432,13,2268,12,8164,3439.987112,7.003353,2590.7590264263,9325.8186471537
172.30.15.199,50223,184.29.26.86,443,73,50644,34,3442,39,47202,3440.001857,6.988774,3940.0329728791,54031.794417734
172.30.15.199,50224,184.29.24.49,443,46,32864,19,2311,27,30553,3440.030584,6.970467,2652.333050282,35065.6562895996
172.30.15.199,50225,184.29.24.49,443,45,30437,19,2335,26,28102,3440.030888,6.960466,2683.7283595667,32298.9868781774
172.30.15.199,50226,184.29.24.49,443,34,19875,16,2173,18,17702,3440.031177,6.969351,2494.3499043167,20319.8260497995
172.30.15.199,50227,184.29.24.49,443,76,60242,29,2863,47,57379,3440.031465,6.959688,3290.9521231412,65955.8302038835
172.30.15.199,50228,184.29.24.49,443,27,14020,12,1870,15,12150,3440.209774,6.781453,2206.0169111251,14333.2114813742
172.30.15.199,50229,50.31.185.52,443,18,6955,10,2170,8,4785,3440.309718,1.368973,12681.0389978464,27962.5675597673
172.30.15.199,50230,104.16.87.26,80,19,8085,10,1059,9,7026,3440.35958,6.641556,1275.6046926353,8463.0770259258
172.30.15.199,50231,50.31.185.52,443,6,348,4,228,2,120,3440.545589,6.718124,271.5043663975,142.8970349461
172.30.15.199,50232,50.23.131.235,443,23,6923,12,1760,11,5163,3440.647838,6.616358,2128.0589714159,6242.7093576253
172.30.15.199,50233,208.100.17.185,80,8,2062,5,1431,3,631,3440.769247,0.909442,12587.9385381411,5550.6563365248
172.30.15.199,50234,208.100.17.185,80,6,531,4,228,2,303,3440.884009,6.379643,285.9094153074,379.9585650796
172.30.15.199,50235,50.23.131.235,443,6,348,4,228,2,120,3440.898657,6.365244,286.5561791504,150.8190416581
172.30.15.199,50236,172.217.160.226,80,14,3861,8,1769,6,2092,3440.934681,6.072247,2330.6034817096,2756.1461185622
172.30.15.199,50237,103.229.205.253,80,13,3514,8,2324,5,1190,3440.953026,6.288238,2956.6310944339,1513.9376085957
172.30.15.199,50238,13.107.21.200,443,32,12055,15,2266,17,9789,3440.980791,6.009566,3016.5239885874,13031.223885385
172.30.15.199,50239,52.221.102.82,80,16,5023,10,2415,6,2608,3440.981157,6.081571,3176.8107286754,3430.692497054
172.30.15.199,50240,13.228.208.99,80,10,1352,6,832,4,520,3440.981513,6.079883,1094.7579089927,684.2236931204
172.30.15.199,50241,182.161.72.94,80,12,1888,6,918,6,970,3440.981882,6.188087,1186.7965010835,1254.0224466786
172.30.15.199,50242,35.203.66.107,443,53,12467,27,4050,26,8417,3440.999409,6.284769,5155.3207444857,10714.1567176139
172.30.15.199,50243,161.170.232.82,80,11,1706,6,815,5,891,3441.00004,6.264105,1040.8510074464,1137.911960288
172.30.15.199,50244,54.169.20.177,80,38,18528,20,8500,18,10028,3441.007512,6.055168,11230.0765230629,13248.8479262676
172.30.15.199,50245,103.15.158.128,443,25,10895,12,3192,13,7703,3441.018164,10.519969,2427.3835787919,5857.8119384192
172.30.15.199,50246,52.0.136.218,80,10,1565,6,929,4,636,3441.02031,6.243207,1190.4138369912,814.9657699961
172.30.15.199,50247,208.100.17.187,80,12,2814,7,1037,5,1777,3441.042575,1.002748,8273.2650675952,14177.0414899872
172.30.15.199,50248,13.228.144.151,443,29,11846,15,6355,14,5491,3441.172199,5.890286,8631.1598452098,7457.7023933984
172.30.15.199,50249,161.170.232.82,80,7,398,4,228,3,170,3441.188719,6.075529,300.2207708991,223.8488204073
172.30.15.199,50250,23.58.57.98,443,17,3198,9,2017,8,1181,3441.193498,5.823284,2770.9450543714,1622.4522108144
172.30.15.199,50251,103.15.158.128,443,6,348,3,174,3,174,3441.193839,10.3614,134.344779663,134.344779663
172.30.15.199,50252,52.0.136.218,80,7,402,4,228,3,174,3441.195014,6.068411,300.572917688,229.3845950777
172.30.15.199,50253,208.100.17.187,80,6,531,4,228,2,303,3441.195314,6.06847,300.5699954025,399.4417044164
172.30.15.199,50254,35.203.66.107,443,7,402,4,228,3,174,3441.230854,6.033459,302.3141451695,230.7134265767
172.30.15.199,50255,103.243.221.108,443,32,15669,17,6806,15,8863,3441.276389,5.985236,9097.0514780036,11846.4835805974
172.30.15.199,50256,117.18.237.29,80,15,3676,9,976,6,2700,3441.409729,109.969554,71.0014700978,196.4180012952
172.30.15.199,50257,103.243.221.108,443,6,348,4,228,2,120,3441.452798,5.809149,313.9874704539,165.2565633968
172.30.15.199,50258,172.217.160.226,80,14,4576,8,2044,6,2532,3441.696044,5.310963,3078.9143136563,3813.9975744509
172.30.15.199,50259,52.77.33.157,80,14,3577,8,1588,6,1989,3441.830505,5.232058,2428.1076394795,3041.2506894992
172.30.15.199,50260,52.77.33.157,80,6,348,4,228,2,120,3441.954804,5.106379,357.2002783186,188.0001464835
172.30.15.199,50261,54.169.236.196,80,15,3090,10,2178,5,912,3442.050456,5.011022,3477.135003598,1455.9904147297
172.30.15.199,50262,103.243.220.231,443,19,6992,10,2692,9,4300,3442.086306,5.17527,4161.3287809141,6646.9961953679
172.30.15.199,50263,64.124.217.61,443,18,6082,9,1605,9,4477,3442.138191,1.493909,8594.9010281093,23974.6865438288
172.30.15.199,50264,151.101.130.49,443,34,14650,17,2115,17,12535,3442.144198,5.117232,3306.4750630809,19596.5318750447
172.30.15.199,50265,13.232.120.220,80,10,1613,6,1100,4,513,3442.1471,4.854101,1812.900061206,845.4706649079
172.30.15.199,50266,159.127.41.169,443,20,8060,10,1717,10,6343,3442.177565,1.559309,8809.03015374,32542.6198399375
172.30.15.199,50267,35.201.85.114,80,16,4604,9,1905,7,2699,3442.260913,4.747106,3210.3770170712,4548.4554168373
172.30.15.199,50268,54.173.180.162,80,11,1566,6,786,5,780,3442.314341,4.949242,1270.4975832663,1260.7991284322
172.30.15.199,50269,64.124.217.61,443,7,402,4,228,3,174,3442.332334,4.930991,369.9053597948,282.2961956329
172.30.15.199,50270,159.127.41.169,443,6,344,4,228,2,116,3442.33812,4.925907,370.2871369679,188.3917012643
172.30.15.199,50271,151.101.130.49,80,10,1585,5,911,5,674,3442.374005,0.563407,12935.5865298066,9570.3461263333
172.30.15.199,50272,13.250.77.177,80,10,1571,6,848,4,723,3442.416125,4.645125,1460.4558542558,1245.1763946073
172.30.15.199,50273,104.113.219.221,80,10,1888,6,1031,4,857,3442.416535,4.574768,1802.9329574746,1498.6552323528
172.30.15.199,50274,52.187.52.94,80,9,1340,6,779,3,561,3442.41691,4.622787,1348.1045092494,970.842913593
172.30.15.199,50275,119.42.60.92,80,10,1652,6,837,4,815,3442.418287,4.750782,1409.4521701901,1372.4056376403
172.30.15.199,50276,52.0.128.155,80,10,2020,6,810,4,1210,3442.427714,4.834728,1340.3029084572,2002.1808879423
172.30.15.199,50277,104.122.118.96,80,10,1542,6,812,4,730,3442.439282,4.568452,1421.9258514701,1278.3323541541
172.30.15.199,50278,147.75.111.32,80,17,7539,10,6366,7,1173,3442.484429,4.152581,12264.1797956505,2259.7993874172
172.30.15.199,50279,199.166.0.201,80,12,1497,6,857,6,640,3442.48497,0.738316,9285.9967818665,6934.7000471349
172.30.15.199,50280,54.173.180.162,80,6,348,4,228,2,120,3442.51235,4.749838,384.0130968677,202.1121562462
172.30.15.199,50281,52.187.52.94,80,5,294,3,174,2,120,3442.512677,4.527853,307.4304753268,212.0210174668
172.30.15.199,50282,173.241.248.220,80,14,3928,8,2984,6,944,3442.538524,4.687395,5092.8074122195,1611.1294226324
172.30.15.199,50283,77.238.185.37,80,16,5759,9,2274,7,3485,3442.554319,4.686126,3882.0979205424,5949.4772441031
172.30.15.199,50284,173.241.248.220,80,12,3816,8,2980,4,836,3442.616229,4.59698,5186.0134262061,1454.8681960766
172.30.15.199,50285,199.166.0.201,80,7,402,4,228,3,174,3442.629255,4.541068,401.6676253251,306.5358193271
172.30.15.199,50286,52.0.128.155,80,6,348,4,228,2,120,3442.630759,4.631623,393.8144361059,207.2707558452
172.30.15.199,50287,147.75.111.32,80,6,348,4,228,2,120,3442.632094,4.63175,393.8036379338,207.2650725968
172.30.15.199,50288,13.251.188.116,443,23,8583,12,2393,11,6190,3442.647923,4.414694,4336.4273945147,11217.0854876916
172.30.15.199,50289,87.248.118.23,443,30,13267,15,2935,15,10332,3442.682411,4.561354,5147.594332735,18120.9351433791
172.30.15.199,50290,54.94.182.41,80,9,1023,5,731,4,292,3442.718363,1.167325,5009.7445013176,2001.1564902664
172.30.15.199,50291,77.238.185.37,80,5,294,3,174,2,120,3442.724571,4.534355,306.989637997,211.7169917221
172.30.15.199,50292,173.241.248.220,80,11,3436,7,2892,4,544,3442.725077,4.515778,5123.3696607761,963.7320523728
172.30.15.199,50293,13.251.188.116,443,6,348,4,228,2,120,3442.725336,4.336012,420.6630424454,221.4016012871
172.30.15.199,50294,52.85.51.95,80,10,1572,6,818,4,754,3442.741825,4.498372,1454.7485179083,1340.9295629619
172.30.15.199,50295,52.220.73.112,80,10,1417,6,853,4,564,3442.830026,4.232849,1612.1529494674,1065.9487262598
172.30.15.199,50296,52.220.73.112,80,6,348,4,228,2,120,3442.847773,4.215206,432.719065213,227.7468764279
172.30.15.199,50297,52.221.102.82,443,21,8037,11,2544,10,5493,3442.85446,4.206531,4838.1908988668,10446.612660171
172.30.15.199,50298,54.94.182.41,80,7,398,4,228,3,170,3442.926187,4.37951,416.4849492295,310.5370235483
172.30.15.199,50299,52.220.73.112,80,16,3322,9,1588,7,1734,3443.010009,4.052911,3134.5371265248,3422.7250487368
172.30.15.199,50300,34.241.15.178,80,10,1726,6,965,4,761,3443.077221,4.183213,1845.4714115682,1455.3406675683
172.30.15.199,50301,188.125.88.204,443,124,98267,47,3894,77,94373,3443.088902,4.172619,7465.8146358439,180937.679668336
172.30.15.199,50302,8.41.222.241,443,30,12910,14,2304,16,10606,3443.089194,4.172855,4417.1196938309,20333.3209517235
172.30.15.199,50303,34.241.15.178,80,6,348,4,228,2,120,3443.096481,4.165513,437.8812405579,230.4638108199
172.30.15.199,50304,52.221.102.82,443,6,340,4,228,2,112,3443.105876,3.956529,461.0101429814,226.461122868
172.30.15.199,50305,104.121.243.213,80,10,1992,5,837,5,1155,3443.22315,0.31025,21582.5946817086,29782.4335213541
172.30.15.199,50306,188.125.88.204,443,20,7306,10,1195,10,6111,3443.241662,3.704183,2580.8660101294,13198.0520400845
172.30.15.199,50307,188.125.88.204,443,7,402,4,228,3,174,3443.293122,3.967354,459.7522681364,350.8635730515
172.30.15.199,50308,8.41.222.241,443,7,402,4,228,3,174,3443.306715,3.955409,461.140681027,351.92315131
172.30.15.199,50309,188.125.88.204,443,20,7318,11,1261,9,6057,3443.316114,3.629505,2779.4423757511,13350.5808643332
172.30.15.199,50310,119.81.211.112,443,21,8278,12,2551,9,5727,3443.355585,3.707191,5504.9766791076,12358.6834344372
172.30.15.199,50311,104.18.255.119,80,14,4909,8,988,6,3921,3443.355929,3.645321,2168.2589818565,8605.003509979
172.30.15.199,50312,104.121.243.213,80,7,402,4,228,3,174,3443.356302,3.660592,498.2800596188,380.266361288
172.30.15.199,50313,52.85.51.95,80,12,2666,7,884,5,1782,3443.612361,3.628298,1949.1232528309,3929.1149734668
172.30.15.199,50314,52.85.51.95,80,8,480,5,294,3,186,3443.628482,3.631884,647.5977756999,409.7047152387
172.30.15.199,50315,35.190.91.160,80,12,1911,7,1015,5,896,3443.639118,3.368835,2410.3287931883,2127.7385208835
172.30.15.199,50316,185.84.60.24,443,28,9743,15,2491,13,7252,3443.736259,3.525989,5651.7476373292,16453.8233102816
172.30.15.199,50317,35.203.66.107,443,29,7131,15,2430,14,4701,3443.959677,3.32439,5847.6893505271,11312.7521139209
172.30.15.199,50318,35.203.66.107,443,6,348,4,228,2,120,3444.210841,3.05352,597.3433938537,314.391259923
172.30.15.199,50319,52.0.128.155,443,21,8454,11,1821,10,6633,3444.357195,2.905114,5014.6052788288,18265.720381368
172.30.15.199,50320,52.85.51.95,443,8,480,5,294,3,186,3444.360981,2.876875,817.5537692808,517.2278948511
172.30.15.199,50321,52.0.128.155,443,6,348,4,228,2,120,3444.608525,2.654082,687.2432728152,361.7069856922
172.30.15.199,50322,52.85.51.95,443,21,8579,11,1813,10,6766,3444.612206,2.612884,5550.9544243064,20715.8067484042
172.30.15.199,50323,23.58.23.32,443,34,18339,17,5927,17,12412,3445.269068,1.737477,27290.1454235058,57149.5334902233
172.30.15.199,50324,23.58.23.32,443,6,348,4,228,2,120,3445.30982,1.698056,1074.1695209109,565.3523794268
172.30.15.199,50325,173.241.248.143,80,17,5259,10,3300,7,1959,3445.435797,11.820076,2233.4881772334,1325.8797997576
172.30.15.199,50326,173.241.248.143,80,6,535,4,228,2,307,3445.5648,1.676267,1088.1321412402,1465.1603831611
172.30.15.199,50327,52.221.149.123,443,20,8343,10,1922,10,6421,3446.431874,10.787761,1425.3189331873,4761.6924401644
172.30.15.199,50328,151.101.130.49,80,10,1601,5,929,5,672,3446.505577,0.755587,9836.061234509,7114.9980081702
172.30.15.199,50329,50.116.239.135,443,29,8860,16,3045,13,5815,3446.634573,10.309349,2362.9038070202,4512.4090764606
172.30.15.199,50330,203.174.85.189,80,13,4127,7,3395,6,732,3446.661549,0.50833,53429.8585564375,11520.0755414764
172.30.15.199,50331,14.128.26.213,80,10,1948,6,855,4,1093,3446.723776,10.536323,649.1828316197,829.8910350413
172.30.15.199,50332,151.101.130.49,80,6,348,4,228,2,120,3446.756903,0.503636,3621.6632647394,1906.1385603892
172.30.15.199,50333,50.116.239.135,443,6,344,4,228,2,116,3446.759906,0.409268,4456.7373945642,2267.4628849537
172.30.15.199,50334,173.241.248.143,80,9,1479,6,987,3,492,3446.930643,10.329395,764.4203750559,381.0484544351
172.30.15.199,50335,173.241.248.143,443,25,5693,14,1998,11,3695,3446.931257,10.324564,1548.152541841,2863.0748959472
172.30.15.199,50336,54.94.182.41,443,21,5448,10,1965,11,3483,3446.942906,1.799166,8737.3816535005,15487.1757247543
172.30.15.199,50337,173.241.248.143,80,9,1413,6,921,3,492,3446.970439,10.285801,716.3272942963,382.6634406013
172.30.15.199,50338,52.221.102.82,443,15,2907,8,1667,7,1240,3446.987535,10.079601,1323.0682444672,984.1659406955
172.30.15.199,50339,173.241.248.143,80,6,535,4,228,2,307,3447.067563,10.188619,179.0232807803,241.053277191
172.30.15.199,50340,173.241.248.143,80,6,535,4,228,2,307,3447.162618,10.097676,180.6356234841,243.2242824983
172.30.15.199,50341,54.94.182.41,443,7,398,4,228,3,170,3447.194647,10.290367,177.2531533618,132.1624389101
172.30.15.199,50342,119.81.211.112,443,14,2721,8,1448,6,1273,3447.531365,9.687943,1195.7130631342,1051.2035423825
172.30.15.199,50343,103.15.158.128,443,28,11053,14,3392,14,7661,3447.533519,10.251747,2646.9634882719,5978.2981378687
172.30.15.199,50344,185.84.60.24,443,17,2336,10,1536,7,800,3447.534877,9.778782,1256.5982143789,654.4782366557
172.30.15.199,50345,209.15.36.33,443,19,6384,11,1882,8,4502,3447.549423,9.394965,1602.560520449,3833.5427540177
172.30.15.199,50346,52.221.118.237,443,20,8289,10,1943,10,6346,3447.557783,9.509691,1634.543120276,5338.554112852
172.30.15.199,50347,52.45.111.226,443,18,5717,10,1767,8,3950,3447.574929,9.370055,1508.6357550729,3372.4455192631
172.30.15.199,50348,4.78.226.234,443,24,8751,11,1791,13,6960,3447.577355,9.824485,1458.3970559271,5667.4726461488
172.30.15.199,50349,210.176.156.55,443,41,23882,23,18203,18,5679,3447.681195,9.538684,15266.6761997775,4762.9211744513
172.30.15.199,50350,52.45.111.226,443,7,402,4,228,3,174,3447.781083,8.204668,222.3124689506,169.6595157781
172.30.15.199,50351,209.15.36.33,443,7,402,4,228,3,174,3447.783199,8.202553,222.369791454,169.7032618991
172.30.15.199,50352,4.78.226.234,443,7,398,4,228,3,170,3447.785606,9.616633,189.6713745861,141.4216389458
172.30.15.199,50353,210.176.156.55,443,33,18623,18,13906,15,4717,3447.843194,9.376525,11864.5233708648,4024.518678295
172.30.15.199,50354,210.176.156.55,443,23,9295,13,5597,10,3698,3448.024044,9.195739,4869.2117077267,3217.1422003168
172.30.15.199,50355,52.77.33.157,80,13,3175,8,1673,5,1502,3448.432521,8.786729,1523.2061896981,1367.5168541104
172.30.15.199,50356,151.139.104.143,80,339,341168,101,6354,238,334814,3448.440716,8.819774,5763.4129854121,303693.949527503
172.30.15.199,50357,52.84.112.65,80,24,16721,9,919,15,15802,3448.441608,8.663179,848.6492083333,14592.3338303408
172.30.15.199,50358,157.240.16.39,443,248,220722,85,6505,163,214217,3448.548907,8.599551,6051.4787341803,199282.032282843
172.30.15.199,50359,210.176.156.55,443,16,4430,9,1345,7,3085,3448.768218,8.451615,1273.1294551397,2920.1519472906
172.30.15.199,50360,157.240.16.39,443,7,402,4,228,3,174,3448.799706,8.348787,218.4748514964,166.7308077209
172.30.15.199,50361,184.72.247.8,80,10,1759,6,1318,4,441,3448.823316,8.496422,1240.9929732774,415.2336124547
172.30.15.199,50362,184.72.247.8,80,6,348,4,228,2,120,3448.911791,8.409277,216.9033080965,114.1596358403
172.30.15.199,50363,104.121.243.213,80,10,2019,5,864,5,1155,3448.984476,0.592767,11660.5681490348,15587.9122825639
172.30.15.199,50364,172.217.160.226,80,14,3810,8,1766,6,2044,3448.985342,8.163441,1730.6427522413,2003.0768887776
172.30.15.199,50365,52.220.73.112,80,12,1910,7,958,5,952,3449.342848,7.876307,973.0448546508,966.9506280037
172.30.15.199,50366,157.240.16.20,443,411,336512,169,10772,242,325740,3449.981348,7.167173,12023.7086505372,363591.056055142
172.30.15.199,50367,157.240.16.20,443,6,348,4,228,2,120,3450.06777,7.080616,257.6047055793,135.5814239891
172.30.15.199,50368,180.149.59.138,80,17,8304,9,1441,8,6863,3451.969848,5.134655,2245.1362360276,10692.8313586797
172.30.15.199,50369,23.23.178.66,80,23,7609,14,6593,9,1016,3452.289021,17.543567,3006.4581507284,463.3037283695
172.30.15.199,50370,23.23.178.66,80,6,348,4,228,2,120,3452.489684,4.829629,377.6687608924,198.7730320486
172.30.15.199,50371,23.237.44.42,80,13,1453,7,926,6,527,3452.679757,10.18437,727.3891266716,413.9676779222
172.30.15.199,50372,199.115.115.133,80,15,2776,9,1576,6,1200,3452.687079,6.581674,1915.6220742626,1458.5954880172
172.30.15.199,50373,144.217.255.209,80,11,1348,7,929,4,419,3452.69526,6.359097,1168.7193952223,527.1188660906
172.30.15.199,50374,23.237.44.42,80,9,1871,5,1269,4,602,3452.706072,0.954451,10636.4810765554,5045.8326304857
172.30.15.199,50375,108.59.8.1,80,12,1393,7,922,5,471,3452.723689,1.491294,4946.0401503663,2526.6647622804
172.30.15.199,50376,173.208.120.210,80,12,1398,7,927,5,471,3452.728576,1.489289,4979.5573592496,2530.0663605249
172.30.15.199,50377,147.135.222.139,80,12,1398,7,927,5,471,3452.735733,1.345485,5511.7671322987,2800.4771513621
172.30.15.199,50378,108.59.8.1,80,10,2407,6,1443,4,964,3452.739931,4.612067,2502.9991975398,1672.1352920502
172.30.15.199,50379,162.210.197.200,80,12,1398,7,927,5,471,3452.75136,1.465217,5061.3663368636,2571.6327342641
172.30.15.199,50380,162.210.197.200,80,10,2695,6,1681,4,1014,3452.763099,4.557618,2950.6641407857,1779.8771200218
172.30.15.199,50381,212.32.225.97,80,12,1396,7,925,5,471,3452.764616,1.317104,5618.387006644,2860.8219244642
172.30.15.199,50382,173.208.120.210,80,15,4413,8,2345,7,2068,3452.775378,5.195483,3610.8288680764,3184.304519907
172.30.15.199,50383,108.59.14.130,80,12,1396,6,871,6,525,3452.776794,1.660733,4195.7376652354,2529.0037591832
172.30.15.199,50384,23.108.191.211,80,12,1401,7,928,5,473,3452.780868,6.42413,1155.6428652595,589.0291759351
172.30.15.199,50385,54.37.85.231,80,6,360,3,198,3,162,3452.787225,1.812348,874.0043302942,715.0944520589
172.30.15.199,50386,144.217.79.15,80,14,4184,8,2194,6,1990,3452.804655,4.547207,3859.9518341698,3501.0502051039
172.30.15.199,50387,50.7.74.138,80,10,1871,6,1120,4,751,3452.813076,4.671322,1918.0865716386,1286.1455493755
172.30.15.199,50388,217.182.174.173,80,12,1398,7,927,5,471,3452.817074,1.307652,5671.2336309662,2881.5005827239
172.30.15.199,50389,54.37.85.231,80,6,360,3,198,3,162,3452.848607,1.650032,959.9813821792,785.4393126921
172.30.15.199,50390,205.185.216.42,80,126,97581,54,4240,72,93341,3452.949105,4.306573,7876.3322948435,173392.625644573
172.30.15.199,50391,23.237.44.42,80,7,402,4,228,3,174,3452.958504,9.845552,185.2613240984,141.3836420751
172.30.15.199,50392,145.239.8.193,80,15,4935,9,1877,6,3058,3452.962261,6.005766,2500.2639130463,4073.4187778879
172.30.15.199,50393,108.59.8.1,80,6,348,4,228,2,120,3452.992316,4.328221,421.4202555738,221.8001345125
172.30.15.199,50394,162.210.197.200,80,7,402,4,228,3,174,3453.014136,4.306504,423.5454094551,323.2320230052
172.30.15.199,50395,54.37.85.231,80,6,360,3,198,3,162,3453.038365,1.6263,973.9900387383,796.9009407859
172.30.15.199,50396,144.217.79.15,80,7,402,4,228,3,174,3453.055629,4.299927,424.1932479319,323.7264260533
172.30.15.199,50397,50.7.74.138,80,6,348,4,228,2,120,3453.06534,4.41922,412.7425201733,217.2329053544
172.30.15.199,50398,205.185.216.42,80,6,348,4,228,2,120,3453.102262,4.153502,439.1474952943,231.1302606812
172.30.15.199,50399,144.217.79.15,80,9,1226,5,811,4,415,3453.346839,0.58285,11131.5089645662,5696.1482371085
172.30.15.199,50400,217.182.138.56,80,6,396,1,66,5,330,3453.472772,15.185949,34.7689828275,173.8449141374
172.30.15.199,50401,217.182.138.56,443,23,8904,12,1920,11,6984,3453.688912,5.302625,2896.6785318593,10536.6681596383
172.30.15.199,50402,144.217.79.15,443,30,13482,16,2196,14,11286,3453.689407,5.365471,3274.2698637267,16827.6000373497
172.30.15.199,50403,54.37.85.234,443,30,13483,16,2197,14,11286,3453.692897,5.298025,3317.4626393797,17041.8221884569
172.30.15.199,50404,50.7.74.138,443,23,8916,12,1932,11,6984,3453.748415,5.37918,2873.3003915095,10386.7132165127
172.30.15.199,50405,50.7.77.122,443,24,8947,11,1855,13,7092,3453.786705,5.267771,2817.1308130138,10770.3998522339
172.30.15.199,50406,54.37.85.231,443,6,360,3,198,3,162,3454.948042,1.749742,905.2763207376,740.680626058
172.30.15.199,50407,180.149.59.136,80,11,3066,6,905,5,2161,3456.467921,0.636479,11375.0807175057,27161.9330724087
172.30.15.199,50410,184.72.247.8,80,10,1771,6,1330,4,441,3458.185226,9.468549,1123.7202236583,372.6019688972
172.30.15.199,50411,23.23.178.66,80,16,4397,9,3742,7,655,3458.199864,11.091866,2698.9146821645,472.4182567658
172.30.15.199,50412,87.248.118.22,443,57,16500,25,4983,32,11517,3458.242156,9.436787,4224.3191459127,9763.49259552
172.30.15.199,50413,180.149.59.138,80,24,17313,10,1794,14,15519,3458.262633,8.769648,1636.5537134444,14157.0106348625
172.30.15.199,50414,180.149.59.138,80,6,348,4,228,2,120,3458.263245,8.769066,208.003908284,109.4757412021
172.30.15.199,50415,122.15.34.17,80,10,1567,6,1091,4,476,3458.264859,8.767208,995.5278807118,434.3458031337
172.30.15.199,50416,103.243.220.231,80,58,27639,33,17537,25,10102,3458.266466,13.767619,10190.2878050302,5870.0055543374
172.30.15.199,50417,151.101.130.2,443,13,1479,6,904,7,575,3458.26796,9.371457,771.7049760779,490.8521695186
172.30.15.199,50418,50.31.185.52,443,12,1412,7,958,5,454,3458.269324,8.67684,883.2708681962,418.5855680178
172.30.15.199,50419,208.100.17.187,80,9,2655,5,1069,4,1586,3458.270339,4.81014,1777.9108300382,2637.7610630875
172.30.15.199,50420,172.217.160.226,80,10,2507,6,1095,4,1412,3458.271389,8.760979,999.8882544976,1289.3536213247
172.30.15.199,50421,173.241.248.220,80,9,1917,6,1439,3,478,3458.272373,9.108928,1263.81501753,419.8079071434
172.30.15.199,50422,68.232.44.114,80,6,348,4,228,2,120,3458.273331,8.759409,208.2332266937,109.596435102
172.30.15.199,50423,52.84.112.65,80,8,480,5,294,3,186,3458.274285,8.758136,268.5502942635,169.8991657586
172.30.15.199,50424,104.18.255.119,80,6,348,4,228,2,120,3458.275271,8.925845,204.3504004383,107.5528423359
172.30.15.199,50425,172.217.167.2,80,6,348,4,228,2,120,3458.276433,8.945796,203.8946562162,107.3129769559
172.30.15.199,50426,180.149.59.136,80,87,74241,33,3444,54,70797,3458.277476,8.754625,3147.1365135573,64694.4900552596
172.30.15.199,50427,54.85.78.249,80,6,348,4,228,2,120,3458.279542,9.367696,194.7116985863,102.4798413612
172.30.15.199,50428,180.149.59.139,80,14,4674,8,935,6,3739,3458.280627,8.7514,854.7203875951,3417.9674109285
172.30.15.199,50429,52.84.101.238,443,22,3088,13,1827,9,1261,3458.281568,8.750876,1670.2327858377,1152.7988740784
172.30.15.199,50430,151.139.104.143,80,6,348,4,228,2,120,3458.282488,8.997672,202.7191033414,106.6942649165
172.30.15.199,50431,184.29.26.86,80,6,348,4,228,2,120,3458.283483,8.865702,205.7366692451,108.2824574974
172.30.15.199,50432,104.18.255.119,443,12,2051,7,1001,5,1050,3458.294702,8.650867,925.6875640326,971.000941293
172.30.15.199,50433,180.149.59.145,80,6,348,4,228,2,120,3458.29567,8.736671,208.7751730608,109.881670032
172.30.15.199,50434,205.185.216.42,80,10,1175,6,752,4,423,3458.29675,9.031891,666.0842120437,374.6723692746
172.30.15.199,50435,54.231.114.138,443,27,7001,14,1459,13,5542,3458.29777,9.381362,1244.169023645,4725.966229637
172.30.15.199,50436,157.240.16.63,80,9,510,5,282,4,228,3458.298726,9.379619,240.5214966621,194.4641887906
172.30.15.199,50437,50.23.131.235,80,6,348,4,228,2,120,3458.299798,9.60015,189.9970312964,99.9984375244
172.30.15.199,50438,104.20.15.243,80,7,402,4,228,3,174,3458.300782,8.921474,204.4505201719,156.0280285522
172.30.15.199,50439,157.240.16.63,443,12,1688,7,971,5,717,3458.301777,8.644698,898.5854682257,663.528095487
172.30.15.199,50440,184.29.26.86,443,13,1477,6,904,7,573,3458.302715,8.967451,806.4722070965,511.182051622
172.30.15.199,50441,67.202.94.86,80,10,1903,6,1112,4,791,3458.303509,3.371185,2638.8347124231,1877.0847639628
172.30.15.199,50442,184.29.24.49,443,13,1477,6,904,7,573,3458.30425,8.969901,806.2519307627,511.0424295653
172.30.15.199,50443,104.16.87.26,80,7,402,4,228,3,174,3458.305057,8.916766,204.558468844,156.1104104336
172.30.15.199,50444,157.240.16.37,443,12,1688,7,971,5,717,3458.30607,8.640954,898.9748122719,663.8155925839
172.30.15.199,50445,208.100.17.185,80,8,1684,5,1053,3,631,3458.30701,4.760635,1769.5118403322,1060.3627457261
172.30.15.199,50446,50.23.131.235,443,11,1405,7,958,4,447,3458.307866,8.638899,887.1500870655,413.9416377017
172.30.15.199,50447,54.169.236.196,80,12,1975,8,1401,4,574,3458.308723,8.914334,1257.3008819279,515.1254148655
172.30.15.199,50448,13.232.120.220,80,10,1468,6,955,4,513,3458.309873,8.874193,860.9233538194,462.4645869208
172.30.15.199,50449,104.18.255.119,443,16,5869,9,1091,7,4778,3458.310906,8.634796,1010.794001387,4426.7403653776
172.30.15.199,50450,104.18.255.119,80,7,402,4,228,3,174,3458.3128,8.909085,204.7348296711,156.2450015911
172.30.15.199,50451,192.229.237.25,443,11,1342,6,904,5,438,3458.317175,8.714795,829.8531405501,402.0748623462
172.30.15.199,50452,172.217.167.2,80,55,36952,23,6024,32,30928,3458.318387,19.189634,2511.3558705705,12893.6278826369
172.30.15.199,50453,157.240.16.20,443,12,1688,7,971,5,717,3458.351008,8.594831,903.7990392132,667.3778693264
172.30.15.199,50454,23.23.178.66,80,6,348,4,228,2,120,3458.451416,9.189463,198.4882032824,104.4674754118
172.30.15.199,50455,50.31.185.52,443,7,402,4,228,3,174,3458.520202,8.032265,227.0841412727,173.3010551818
172.30.15.199,50456,87.248.118.22,443,20,7306,10,1195,10,6111,3458.536717,8.408562,1136.9363750901,5814.0737976362
172.30.15.199,50457,87.248.118.22,443,20,7306,10,1195,10,6111,3458.537684,8.407446,1137.0872914319,5814.8455547617
172.30.15.199,50458,87.248.118.22,443,20,7306,10,1195,10,6111,3458.546585,8.398826,1138.2543226875,5820.8135279859
172.30.15.199,50459,50.23.131.235,443,6,348,4,228,2,120,3458.561236,9.105616,200.3159368899,105.4294404684
172.30.15.199,50460,180.149.59.136,80,112,95311,44,3630,68,91681,3459.393197,7.639055,3801.5173342776,96012.9230644354
172.30.15.199,50461,180.149.59.136,80,150,126209,60,5692,90,120517,3459.394813,7.637382,5962.252510088,126239.06988023
172.30.15.199,50462,180.149.59.136,80,101,87464,39,3831,62,83633,3459.396,7.636133,4013.5497901883,87618.1700868754
172.30.15.199,50463,180.149.59.136,80,87,70972,35,4188,52,66784,3459.397782,7.634382,4388.56740467,69982.3508962463
172.30.15.199,50464,180.149.59.136,80,60,51179,22,2301,38,48878,3459.399106,7.633118,2411.5964144665,51227.2966302879
172.30.15.199,50465,151.101.66.202,80,10,1783,6,792,4,991,3460.108829,7.478142,847.2692815942,1060.1563864393
172.30.15.199,50466,173.241.248.220,80,26,17879,11,1736,15,16143,3460.501886,7.052246,1969.3016948075,18312.4638590311
172.30.15.199,50467,103.243.220.231,80,11,2977,7,1963,4,1014,3460.51158,7.127603,2203.2652492009,1138.1105260773
172.30.15.199,50468,103.243.220.231,80,11,2960,7,1945,4,1015,3460.524682,7.106644,2189.5004167931,1142.592762491
172.30.15.199,50469,103.243.220.231,80,13,4127,7,1945,6,2182,3460.530436,7.105957,2189.7120964846,2456.5304856193
172.30.15.199,50470,103.243.220.231,80,11,2984,7,1971,4,1013,3460.531432,7.095861,2222.1404844318,1142.0742317247
172.30.15.199,50471,103.243.220.231,80,11,2994,7,1971,4,1023,3460.532432,7.096934,2221.8045144565,1153.1740326175
172.30.15.199,50472,210.176.156.62,80,14,5126,8,3606,6,1520,3460.536657,6.734025,4283.916379877,1805.7551018894
172.30.15.199,50473,210.176.156.62,80,21,11238,10,3715,11,7523,3460.537942,6.73914,4410.0582566914,8930.5163566863
172.30.15.199,50474,210.176.156.62,80,17,10924,7,3553,10,7371,3460.540079,7.137995,3982.0705954543,8261.1433602853
172.30.15.199,50475,210.176.156.62,80,21,11286,10,3699,11,7587,3460.541087,6.731178,4396.2587232131,9017.1438045466
172.30.15.199,50476,210.176.156.62,80,21,11375,10,3699,11,7676,3460.542249,6.724941,4400.3360029479,9131.3812269878
172.30.15.199,50477,210.176.156.62,80,20,11066,10,3699,10,7367,3460.54956,6.723668,4401.169123758,8765.4536184712
172.30.15.199,50478,173.241.248.220,80,6,535,4,228,2,307,3460.752883,6.724486,271.2474975783,365.2323761251
172.30.15.199,50479,172.217.166.193,80,11,2992,6,805,5,2187,3460.758157,6.464045,996.2801929752,2706.6643255115
172.30.15.199,50480,67.202.94.86,80,8,1359,5,983,3,376,3461.526172,1.345405,5845.0801059903,2235.7580059536
172.30.15.199,50481,67.202.94.86,80,6,535,4,228,2,307,3461.778226,5.888479,309.7574093412,417.0856345076
172.30.15.199,50482,52.221.102.82,80,12,2601,7,941,5,1660,3462.931503,4.291847,1754.0233843376,3094.2389139219
172.30.15.199,50483,172.217.167.2,80,16,4183,9,2467,7,1716,3463.660295,3.3721,5852.732718484,4071.0536460959
172.30.15.199,50484,107.6.122.24,443,16,4805,9,1153,7,3652,3464.378358,2.844227,3243.060416767,10272.0352489445
172.30.15.199,50485,104.36.113.23,443,23,7016,12,1441,11,5575,3464.38581,3.812417,3023.8035346084,11698.6153403482
172.30.15.199,50486,104.36.113.23,443,7,402,5,282,2,120,3464.443425,3.756601,600.5428843787,255.5501635654
172.30.15.199,50487,52.86.241.228,80,11,2026,6,1404,5,622,3464.491838,3.149435,3566.353965076,1579.9659303969
172.30.15.199,50488,52.86.241.228,80,13,2148,7,1459,6,689,3464.492137,3.956642,2949.9762677546,1393.1005130109
172.30.15.199,50489,52.86.241.228,80,12,2082,7,1459,5,623,3464.492442,3.554014,3284.1738946444,1402.3580098447
172.30.15.199,50490,52.86.241.228,80,11,2028,6,1405,5,623,3464.492705,3.154882,3562.7322987043,1579.7738235536
172.30.15.199,50491,52.86.241.228,80,15,3654,8,2582,7,1072,3464.492983,3.154194,6548.741136405,2718.9196352541
172.30.15.199,50492,52.86.241.228,80,11,2027,6,1404,5,623,3464.493241,3.149139,3566.6891807574,1582.6548145384
172.30.15.199,50493,172.217.160.226,443,30,6867,14,2224,16,4643,3464.72287,2.499296,7118.8046553911,14861.7850786784
172.30.15.199,50494,54.169.236.175,443,103,80543,40,3878,63,76665,3464.910148,2.31324,13411.4921063101,265134.616382223
172.30.15.199,50495,151.101.130.49,80,12,1677,6,955,6,722,3465.127358,1.407309,5428.800640088,4104.2869760665
172.30.15.199,50496,50.116.239.135,80,12,2694,7,994,5,1700,3465.128256,2.137511,3720.2147731639,6362.5403565178
172.30.15.199,50497,13.251.188.116,443,18,2648,9,1554,9,1094,3465.148681,2.074254,5993.4800656053,4219.3482572537
172.30.15.199,50498,37.157.6.252,80,12,1721,7,851,5,870,3465.312738,2.268703,3000.8335158903,3067.83214903
172.30.15.199,50499,103.71.26.125,80,11,1928,6,1077,5,851,3465.313613,1.909385,4512.4477253138,3565.5459742266
172.30.15.199,50500,34.228.252.44,80,10,1539,6,958,4,581,3465.344926,2.296764,3336.868742283,2023.7168468335
172.30.15.199,50501,72.21.206.140,80,6,344,4,228,2,116,3465.345537,2.307858,790.3432533545,402.104462233
172.30.15.199,50502,103.71.26.125,80,7,398,4,228,3,170,3465.364885,1.858146,981.6236183809,731.9123470384
172.30.15.199,50503,72.21.206.140,80,9,1765,6,871,3,894,3465.369549,2.283769,3051.0966739629,3131.6652428506
172.30.15.199,50504,34.228.252.44,80,6,348,4,228,2,120,3465.37584,2.265482,805.126679444,423.7508839179
172.30.15.199,50505,37.157.6.252,80,6,344,4,228,2,116,3465.377021,2.103717,867.0367734822,441.1239724734
172.30.15.199,50506,151.101.130.49,80,6,348,4,228,2,120,3465.37778,2.187828,833.7035635342,438.7913492285
172.30.15.199,50507,50.116.239.135,80,6,531,4,228,2,303,3465.378959,1.880809,969.7954444073,1288.8071037518
172.30.15.199,50508,184.29.25.201,80,18,7793,10,5047,8,2746,3465.450231,1.750559,23064.63249739,12549.1343050986
172.30.15.199,50509,184.29.25.121,80,12,1786,7,894,5,892,3465.470423,1.678406,4261.1859109179,4251.653056531
172.30.15.199,50510,72.247.228.146,80,10,2332,6,1463,4,869,3465.528647,1.672207,6999.1334804839,4157.3800372799
172.30.15.199,50511,72.247.228.146,80,6,348,4,228,2,120,3465.630367,1.570521,1161.3980328824,611.2621225697
172.30.15.199,50512,103.243.220.231,443,19,5359,10,2750,9,2609,3466.149007,11.310702,1945.0605276312,1845.3319696691
172.30.15.199,50513,199.166.0.200,443,22,9321,11,1826,11,7495,3466.348713,1.330231,10981.5513245451,45074.8779723251
172.30.15.199,50514,103.243.220.231,443,6,340,4,228,2,112,3466.400439,1.238811,1472.3795639527,723.2741717662
172.30.15.199,50515,52.221.149.164,443,30,9637,15,3122,15,6515,3466.493031,11.015707,2267.307944919,4731.4257723086
172.30.15.199,50516,199.166.0.200,443,6,348,4,228,2,120,3466.527488,0.909019,2006.5587187953,1056.0835362081
172.30.15.199,50517,217.156.250.128,80,9,1391,6,825,3,566,3466.584813,10.948188,602.8394835748,413.5844214586
172.30.15.199,50518,52.221.149.164,443,6,348,4,228,2,120,3466.616816,0.606601,3006.9188807802,1582.5888846212
172.30.15.199,50519,172.217.166.198,443,28,7758,16,2829,12,4929,3466.647561,10.860831,2083.8184481464,3630.6614107153
172.30.15.199,50520,52.76.199.39,443,20,7894,10,3397,10,4497,3466.648016,10.86057,2502.2627725801,3312.5333200744
172.30.15.199,50521,217.156.250.128,80,6,348,4,228,2,120,3466.790184,10.831528,168.3972935305,88.6301544897
172.30.15.199,50522,172.217.166.198,443,12,672,6,336,6,336,3466.846216,10.667697,251.975660726,251.975660726
172.30.15.199,50523,52.76.199.39,443,6,340,4,228,2,112,3466.846734,10.662065,171.0738023075,84.0362537651
172.30.15.199,50524,173.241.248.220,80,9,1939,6,1461,3,478,3467.150113,10.47288,1116.0253912964,365.1335640244
172.30.15.199,50525,173.241.248.220,80,9,1921,6,1443,3,478,3467.150643,10.47313,1102.2492798237,365.1248480636
172.30.15.199,50526,173.241.248.143,80,13,4252,9,2402,4,1850,3467.151336,2.594479,7406.4966415213,5704.4208104973
172.30.15.199,50527,173.241.248.220,80,9,1939,6,1461,3,478,3467.151767,10.472151,1116.1030814013,365.1589821423
172.30.15.199,50528,173.241.248.220,80,9,1939,6,1461,3,478,3467.152203,10.470643,1116.2638244853,365.2115729664
172.30.15.199,50529,50.116.239.135,443,23,8325,12,2296,11,6029,3467.267572,6.150828,2986.2646134798,7841.5458861801
172.30.15.199,50530,72.247.228.146,80,11,2394,6,1480,5,914,3467.287405,10.219734,1158.5428740122,715.4785046265
172.30.15.199,50531,103.229.205.253,443,17,6402,9,2122,8,4280,3467.303752,10.319284,1645.0753753846,3318.0596638293
172.30.15.199,50532,173.241.248.220,80,6,535,4,228,2,307,3467.401858,10.220193,178.4702108855,240.3085734291
172.30.15.199,50533,173.241.248.143,80,6,535,4,228,2,307,3467.402144,10.221455,178.4481759202,240.2789035416
172.30.15.199,50534,50.116.239.135,443,8,452,5,282,3,170,3467.518798,10.007481,225.4313548035,135.898334456
172.30.15.199,50535,72.247.228.146,80,8,468,5,282,3,186,3467.538668,9.969349,226.2936125518,149.2574891299
172.30.15.199,50536,103.229.205.253,443,8,468,5,282,3,186,3467.555785,10.175046,221.7188993544,146.2401251061
172.30.15.199,50537,103.15.158.128,80,15,5361,8,2180,7,3181,3468.182952,10.266377,1698.7492276974,2478.7712354612
172.30.15.199,50538,103.15.158.128,80,19,5640,10,2314,9,3326,3468.228246,10.530338,1757.9682627471,2526.7944865587
172.30.15.199,50539,42.125.207.29,80,7,398,4,228,3,170,3468.42763,9.196395,198.3385881098,147.8840349941
172.30.15.199,50540,103.15.158.128,80,6,348,3,174,3,174,3468.435171,10.323009,134.8444043786,134.8444043786
172.30.15.199,50541,42.125.207.29,80,11,1504,6,796,5,708,3468.47813,9.145553,696.2946909826,619.3173884619
172.30.15.199,50542,202.131.200.84,80,10,1261,5,736,5,525,3468.555804,1.189827,4948.6185806857,3529.9249386685
172.30.15.199,50543,77.238.185.35,443,29,8188,14,1934,15,6254,3468.556376,9.067859,1706.2462043135,5517.5097010219
172.30.15.199,50544,52.198.219.213,8088,14,1980,8,1400,6,580,3468.584478,9.134165,1226.1657195814,507.9829409694
172.30.15.199,50545,52.198.219.213,8088,6,348,4,228,2,120,3468.705361,8.918627,204.5157847727,107.6398867225
172.30.15.199,50546,202.131.200.84,80,6,348,4,228,2,120,3468.730414,8.893716,205.0886266213,107.9413824323
172.30.15.199,50547,77.238.185.35,443,5,294,3,174,2,120,3468.74338,8.880116,156.7547090601,108.1066959035
172.30.15.199,50548,173.241.248.143,80,6,535,4,228,2,307,3468.791558,8.83261,206.5074762726,278.0605053319
172.30.15.199,50549,173.241.248.143,80,10,1485,7,993,3,492,3469.043167,8.580928,925.7739955398,458.691647337
172.30.15.199,50550,173.241.248.143,443,12,3724,8,1046,4,2678,3469.256167,7.69289,1087.7576567454,2784.909182375
172.30.15.199,50551,87.248.118.22,443,6,348,4,228,2,120,3469.496895,8.126952,224.438387233,118.1254669647
172.30.15.199,50552,180.149.59.138,80,8,468,5,282,3,186,3469.510366,7.9963,282.1304853495,186.086064805
172.30.15.199,50553,180.149.59.138,80,9,522,5,282,4,240,3469.510934,7.995644,282.153632653,240.130751194
172.30.15.199,50554,122.15.34.17,80,12,1761,7,1219,5,542,3469.513071,7.993384,1220.0089473995,542.4486049963
172.30.15.199,50555,151.101.130.2,443,41,13466,20,2633,21,10833,3469.515321,7.993139,2635.2600649131,10842.2986263592
172.30.15.199,50556,50.31.185.52,443,12,1412,6,904,6,508,3469.516759,7.832565,923.3246069455,518.8594030181
172.30.15.199,50557,208.100.17.187,80,6,531,4,228,2,303,3469.51815,8.200265,222.4318360443,295.6002031642
172.30.15.199,50558,172.217.160.226,80,8,468,5,282,3,186,3469.519431,7.988589,282.4028123114,186.265684716
172.30.15.199,50559,68.232.44.114,80,9,522,5,282,4,240,3469.52124,7.986766,282.4672714839,240.3976778586
172.30.15.199,50560,52.84.112.65,80,10,600,6,348,4,252,3469.522375,7.985626,348.6263944743,252.4535959986
172.30.15.199,50561,104.18.255.119,80,9,522,5,282,4,240,3469.523252,7.984985,282.530274008,240.4512970281
172.30.15.199,50562,172.217.167.2,80,8,468,5,282,3,186,3469.524156,7.982617,282.6140850801,186.4050348401
172.30.15.199,50563,180.149.59.136,80,8,468,5,282,3,186,3469.525002,7.981468,282.6547697742,186.4318694255
172.30.15.199,50564,54.85.78.249,80,6,348,4,228,2,120,3469.527073,8.097862,225.2446386466,118.549809814
172.30.15.199,50565,180.149.59.139,80,8,468,5,282,3,186,3469.528217,7.978254,282.7686358444,186.5069725782
172.30.15.199,50566,52.84.101.238,443,11,1405,7,958,4,447,3469.529572,7.42056,1032.8061494011,481.9043306705
172.30.15.199,50567,151.139.104.143,80,7,402,5,282,2,120,3469.531167,7.9949,282.1798896797,120.0765487999
172.30.15.199,50568,184.29.26.86,80,8,468,5,282,3,186,3469.532456,7.975557,282.8642563773,186.5700414404
172.30.15.199,50569,104.18.255.119,443,12,2051,7,1001,5,1050,3469.533995,7.413796,1080.1484151978,1133.0228131445
172.30.15.199,50570,180.149.59.145,80,8,468,5,282,3,186,3469.535078,7.971393,283.0120155912,186.6674996453
172.30.15.199,50571,205.185.216.42,80,6,348,4,228,2,120,3469.536181,7.996553,228.0982818472,120.051727288
172.30.15.199,50572,54.231.114.138,443,25,6640,12,1339,13,5301,3469.53716,8.08718,1324.5655469521,5243.8550891658
172.30.15.199,50573,157.240.16.63,80,8,456,5,282,3,174,3469.538033,7.969981,283.0621553552,174.6553724532
172.30.15.199,50574,50.23.131.235,80,6,348,4,228,2,120,3469.53908,8.19229,222.6483681608,117.1833516636
172.30.15.199,50575,104.20.15.243,80,8,468,5,282,3,186,3469.540114,7.968196,283.1255656864,186.7423943889
172.30.15.199,50576,157.240.16.63,443,15,4976,8,1025,7,3951,3469.541523,7.408125,1106.8927697629,4266.6666666667
172.30.15.199,50577,184.29.26.86,443,14,1543,7,958,7,585,3469.542771,7.964237,962.3018501333,587.6269126597
172.30.15.199,50578,67.202.94.86,80,6,535,4,228,2,307,3469.543777,8.187169,222.787632697,299.981593149
172.30.15.199,50579,184.29.24.49,443,14,1543,7,958,7,585,3469.544683,7.962216,962.5461052551,587.7760663614
172.30.15.199,50580,104.16.87.26,80,9,522,5,282,4,240,3469.545776,7.96224,283.3373523029,241.1381721726
172.30.15.199,50581,157.240.16.37,443,15,5291,8,1025,7,4266,3469.546767,7.404272,1107.4687693807,4609.2309952956
172.30.15.199,50582,208.100.17.185,80,6,531,4,228,2,303,3469.547744,8.105205,225.0405757782,299.0670809683
172.30.15.199,50583,50.23.131.235,443,11,1405,7,958,4,447,3469.549121,7.401389,1035.4813130346,483.152554203
172.30.15.199,50584,54.169.236.196,80,6,535,4,228,2,307,3469.550092,7.958582,229.1865560976,308.597687377
172.30.15.199,50585,13.232.120.220,80,8,468,5,282,3,186,3469.551414,7.956603,283.5380877995,187.0144834422
172.30.15.199,50586,104.18.255.119,443,15,5802,8,1025,7,4777,3469.552359,7.395745,1108.7456368493,5167.2955192477
172.30.15.199,50587,104.18.255.119,80,9,522,5,282,4,240,3469.553231,7.954923,283.5979682016,241.3599729375
172.30.15.199,50588,157.240.16.20,443,15,4923,8,1025,7,3898,3469.554959,7.393449,1109.0899524701,4217.7879363203
172.30.15.199,50589,192.229.237.25,443,16,5669,10,1219,6,4450,3469.556195,7.393684,1318.9635910867,4814.9204104478
172.30.15.199,50590,87.248.118.22,443,28,5036,13,2357,15,2679,3469.750469,7.87334,2394.9175318226,2722.0976104169
172.30.15.199,50591,50.31.185.52,443,9,510,5,282,4,228,3469.782298,8.037795,280.6739908147,226.9279074672
172.30.15.199,50592,54.231.114.138,443,7,409,4,228,3,181,3469.807933,7.816446,233.3541356264,185.2504322297
172.30.15.199,50593,50.23.131.235,443,6,348,4,228,2,120,3469.809842,7.921212,230.267792353,121.1935749226
172.30.15.199,50594,87.248.118.22,443,14,1621,8,1014,6,607,3469.811335,7.136094,1136.7563263601,680.4843097639
172.30.15.199,50595,151.101.66.202,80,10,1987,6,944,4,1043,3470.768206,6.855747,1101.5575691461,1217.0810854019
172.30.15.199,50596,151.101.66.202,80,7,402,5,282,2,120,3471.020035,6.603848,341.6190075847,145.3697904616
172.30.15.199,50597,103.243.220.231,80,10,3140,6,2125,4,1015,3471.101613,0.932253,18235.3931818859,8710.0819198185
172.30.15.199,50598,103.243.220.231,80,6,340,4,228,2,112,3471.106161,6.518127,279.8349894072,137.4628018141
172.30.15.199,50599,103.243.220.231,80,11,3209,6,2133,5,1076,3471.108793,0.925074,18446.0918802127,9305.2015298213
172.30.15.199,50600,210.176.156.62,80,12,5188,7,3714,5,1474,3471.125978,0.667683,44500.1595068235,17661.0756901071
172.30.15.199,50601,210.176.156.62,80,14,5311,7,3729,7,1582,3471.134462,1.181888,25240.9703795945,10708.2904640704
172.30.15.199,50602,210.176.156.62,80,14,5295,7,3713,7,1582,3471.13612,1.995755,14883.5904206685,6341.4597483161
172.30.15.199,50603,210.176.156.62,80,14,4104,9,3822,5,282,3471.140254,120.893749,252.9163025625,18.6610144748
172.30.15.199,50604,210.176.156.62,80,10,3902,5,3620,5,282,3471.141719,0.521016,55583.705682776,4330.0013819179
172.30.15.199,50605,210.176.156.62,80,14,5294,7,3712,7,1582,3471.143126,0.890822,33335.5036135224,14207.1031025303
172.30.15.199,50606,173.241.248.220,80,14,7830,5,1647,9,6183,3471.16043,0.968603,13603.09641824,51067.3619635566
172.30.15.199,50607,173.241.248.220,80,6,535,4,228,2,307,3471.411242,6.211699,293.6394696523,395.3829701021
172.30.15.199,50608,204.79.197.200,443,68,23324,32,11029,36,12295,3473.111747,4.394982,20075.622607782,22380.0689058554
172.30.15.199,50609,204.79.197.200,443,21,10081,10,1174,11,8907,3473.419525,3.531316,2659.6317067065,20178.313127457
172.30.15.199,50610,204.79.197.200,443,85,20926,39,10383,46,10543,3478.108836,9.434567,8804.2196319129,8939.8909351111
172.30.15.199,50611,23.8.189.227,443,1485,1354109,539,35009,946,1319100,3485.814136,11.219477,24963.0174383349,940578.602728087
172.30.15.199,50612,23.8.189.227,443,17,5384,8,1099,9,4285,3485.814931,0.265175,33155.4633732442,129273.121523523
172.30.15.199,50613,23.8.189.227,443,6,348,4,228,2,120,3485.887161,1.240494,1470.3819607354,773.8852424923
172.30.15.199,50614,52.220.14.37,443,26,8167,13,1728,13,6439,3486.383574,0.836976,16516.6026265976,61545.3728661239
172.30.15.199,50615,151.101.193.2,443,34,13228,17,2153,17,11075,3486.794186,10.364588,1661.8123170936,8548.3378596429
172.30.15.199,50616,139.59.82.147,443,87,66757,34,2898,53,63859,3486.973686,10.060054,2304.5601942097,50782.232381655
172.30.15.199,50617,151.101.193.2,443,8,480,5,294,3,186,3487.002959,10.142629,231.8925398928,146.7075252383
172.30.15.199,50618,23.58.57.98,443,18,3872,10,2691,8,1181,3487.116297,9.917577,2170.6914904719,952.6520439418
172.30.15.199,50619,139.59.82.147,443,6,348,4,228,2,120,3487.176872,9.849886,185.1798081724,97.4630569328
172.30.15.199,50620,23.58.57.98,443,7,402,4,228,3,174,3487.367813,9.665147,188.7193231515,144.0226413525
172.30.15.199,50621,180.179.41.214,443,25,9471,14,1985,11,7486,3487.519923,1.156137,13735.3964106337,51800.0894357701
172.30.15.199,50622,180.179.41.214,443,14,3402,7,2137,7,1265,3487.653649,4.268166,4005.4674537023,2371.0418010919
172.30.15.199,50623,157.240.16.20,443,74,41715,33,3274,41,38441,3487.830369,9.18861,2850.4855467802,33468.3918459914
172.30.15.199,50624,52.84.108.64,443,21,8718,11,1653,10,7065,3487.90361,9.107974,1451.9145531158,6205.5513114113
172.30.15.199,50625,104.244.43.48,443,24,6899,13,1791,11,5108,3488.016911,9.12367,1570.4206750135,4478.8993902673
172.30.15.199,50626,104.244.43.48,443,8,480,5,294,3,186,3488.120331,9.006664,261.1399736906,165.2110037634
172.30.15.199,50627,104.19.199.151,443,34,14928,17,1902,17,13026,3488.274468,8.759596,1737.0664126519,11896.4390595184
172.30.15.199,50628,104.19.199.151,443,6,348,4,228,2,120,3488.480208,8.538511,213.620384163,112.4317811384
172.30.15.199,50629,169.38.89.75,443,20,8479,11,1762,9,6717,3488.534083,8.492534,1659.8108409104,6327.4400785443
172.30.15.199,50630,52.85.51.33,443,60,35570,30,2667,30,32903,3488.537885,8.602394,2480.239803013,30598.9239739542
172.30.15.199,50631,52.84.110.244,443,43,29794,19,2069,24,27725,3488.538973,8.472812,1953.5426963327,26177.8498094848
172.30.15.199,50632,52.85.51.33,443,8,480,5,294,3,186,3488.591802,8.547605,275.1647976246,174.0838515584
172.30.15.199,50633,169.38.89.75,443,6,348,4,228,2,120,3488.598608,8.434094,216.265078383,113.8237254648
172.30.15.199,50634,34.233.218.142,443,21,7885,10,1979,11,5906,3488.600514,8.759162,1807.4788432958,5394.123319103
172.30.15.199,50635,52.84.110.244,443,8,480,5,294,3,186,3488.604764,8.40762,279.7462302055,176.9823089055
172.30.15.199,50636,34.233.218.142,443,6,340,4,228,2,112,3488.682205,8.678854,210.1659965705,103.2394369118
172.30.15.199,50637,157.240.16.39,443,29,5819,15,4242,14,1577,3489.615763,7.403274,4583.9178720116,1704.1109109294
172.30.15.199,50638,52.84.110.238,443,21,8769,11,1776,10,6993,3489.650309,7.361401,1930.0673879877,7599.6403402014
172.30.15.199,50639,104.244.42.133,443,25,7017,13,1824,12,5193,3489.854824,7.285306,2002.9357723615,5702.4372071673
172.30.15.199,50640,52.220.69.147,443,18,6379,9,1761,9,4618,3489.868893,7.222709,1950.5146891561,5114.9783273837
172.30.15.199,50641,13.232.120.220,443,22,9108,11,1748,11,7360,3489.869685,7.148959,1956.0889914182,8236.1641743923
172.30.15.199,50642,104.244.42.133,443,6,348,4,228,2,120,3489.928993,7.21057,252.9619711063,133.1378795296
172.30.15.199,50643,180.179.41.214,443,20,8121,10,1654,10,6467,3490.040479,0.296032,44697.8705004569,174764.890282016
172.30.15.199,50644,13.232.120.220,443,6,340,4,228,2,112,3490.042494,6.976603,261.4452907812,128.4292656469
172.30.15.199,50645,52.220.69.147,443,6,340,4,228,2,112,3490.048085,7.044368,258.9302546375,127.1938092956
172.30.15.199,50646,104.20.90.77,443,26,7507,13,1768,13,5739,3491.275174,5.751002,2459.3975102078,7983.3044745942
172.30.15.199,50647,104.244.42.195,443,27,7041,14,2029,13,5012,3491.417566,5.722906,2836.3212675519,7006.2307506012
172.30.15.199,50648,184.29.26.86,443,69,52085,29,5837,40,46248,3491.429304,5.589263,8354.5898627417,66195.4894589824
172.30.15.199,50649,104.244.42.195,443,6,348,4,228,2,120,3491.552505,5.587872,326.4212208154,171.8006425344
172.30.15.199,50650,35.201.123.46,443,75,15133,32,5036,43,10097,3491.682813,5.351196,7528.7842194529,15094.9432612819
172.30.15.199,50651,35.201.123.46,443,7,402,4,228,3,174,3491.797145,5.215131,349.7515211027,266.9156345258
172.30.15.199,50652,13.232.120.220,443,21,7678,10,1658,11,6020,3492.021936,4.994841,2655.5399861579,9641.9485625274
172.30.15.199,50653,172.217.166.206,443,6,348,4,228,2,120,3492.023196,5.009706,364.093222237,191.6280117037
172.30.15.199,50654,192.229.237.25,443,28,14413,14,2800,14,11613,3492.127894,4.883952,4586.4496620772,19022.2999734654
172.30.15.199,50655,52.221.149.123,443,15,3390,8,1888,7,1502,3492.168618,4.923612,3067.6665829882,2440.4847498137
172.30.15.199,50656,13.232.120.220,443,6,340,4,228,2,112,3492.272376,4.746403,384.2910094233,188.7745309448
172.30.15.199,50657,172.217.166.206,443,20,6750,10,1351,10,5399,3492.273661,4.688691,2305.1209815278,9211.9527603763
172.30.15.199,50658,52.84.102.103,443,42,11978,21,4660,21,7318,3492.305803,4.711128,7913.1791791691,12426.7479041115
172.30.15.199,50659,35.189.131.178,443,21,9139,11,1892,10,7247,3492.353286,4.773259,3170.9991014525,12145.9992009651
172.30.15.199,50660,52.221.149.123,443,6,348,4,228,2,120,3492.419691,4.672669,390.3550625991,205.4500329469
172.30.15.199,50661,35.189.131.178,443,33,16283,18,3721,15,12562,3492.432449,4.689117,6348.3167513203,21431.753568956
172.30.15.199,50662,119.42.60.92,443,26,8218,14,2016,12,6202,3492.474726,4.631651,3482.127647355,10712.3788040158
172.30.15.199,50663,35.189.131.178,443,6,348,4,228,2,120,3492.475159,4.651264,392.1514667841,206.3955088337
172.30.15.199,50664,103.243.220.231,443,20,6422,11,4812,9,1610,3493.095403,4.241043,9077.0124235949,3036.988778468
172.30.15.199,50665,103.243.220.231,443,27,11864,14,5092,13,6772,3493.138649,4.198477,9702.5659542736,12903.7267561549
172.30.15.199,50666,54.169.20.177,443,30,9175,15,3060,15,6115,3493.151327,3.941295,6211.1564853683,12412.164022231
172.30.15.199,50667,13.228.208.99,443,32,10581,17,2841,15,7740,3493.177843,3.914684,5805.8326036025,15817.3686560658
172.30.15.199,50668,8.41.222.241,443,35,14804,17,3147,18,11657,3493.18763,4.149904,6066.6463609762,22471.8451318398
172.30.15.199,50669,104.24.246.16,443,22,9720,12,1898,10,7822,3493.250511,3.767779,4029.9603559553,16608.1927841318
172.30.15.199,50670,67.231.251.190,443,22,9169,11,1972,11,7197,3493.274365,3.818324,4131.6556688224,15078.8670631414
172.30.15.199,50671,209.191.163.213,443,20,8833,11,2320,9,6513,3493.274912,4.091154,4536.6172967332,12735.7708851824
172.30.15.199,50672,72.247.218.153,443,21,8576,11,4395,10,4181,3493.278238,3.7406,9399.5615676627,8941.8809816605
172.30.15.199,50673,184.29.25.122,443,32,16057,18,10389,14,5668,3493.317521,3.700224,22461.3428808624,12254.3932475434
172.30.15.199,50674,151.101.128.166,443,39,19295,20,4884,19,14411,3493.387016,3.639873,10734.440459873,31673.6325690477
172.30.15.199,50675,103.243.220.231,443,19,7282,10,2955,9,4327,3493.393395,3.943598,5994.5258112011,8777.7709594136
172.30.15.199,50676,151.101.128.166,443,8,480,5,294,3,186,3493.434098,3.598928,653.5279394309,413.4564514767
172.30.15.199,50677,8.41.222.241,443,7,402,4,228,3,174,3493.439159,3.912451,466.2039217871,355.7872034691
172.30.15.199,50678,67.231.251.190,443,7,402,4,228,3,174,3493.459214,3.897166,468.0324112445,357.1826296339
172.30.15.199,50679,35.190.74.53,443,28,7950,14,2122,14,5828,3493.460706,3.573243,4750.8663698491,13048.0910478231
172.30.15.199,50680,209.191.163.213,443,6,348,4,228,2,120,3493.464521,3.902754,467.3622780221,245.9801463274
172.30.15.199,50681,35.190.74.53,443,8,480,5,294,3,186,3493.567534,3.465298,678.7295060915,429.4002997722
172.30.15.199,50682,151.101.130.2,443,39,13606,18,2363,21,11243,3494.228557,2.805564,6738.0391251094,32059.1510298794
172.30.15.199,50683,104.244.42.72,443,23,5675,12,4352,11,1323,3494.363742,2.782256,12513.586097038,3804.1071705839
172.30.15.199,50684,151.101.130.2,443,8,480,5,294,3,186,3494.479502,2.554309,920.7969748375,582.5450248972
172.30.15.199,50685,104.244.42.72,443,6,348,4,228,2,120,3494.614687,2.539441,718.2683118055,378.0359535819
172.30.15.199,50686,13.232.120.220,443,21,7562,10,1800,11,5762,3494.683079,2.33583,6164.8322009736,19734.312856672
172.30.15.199,50687,210.176.156.55,443,23,9450,13,5766,10,3684,3494.774827,2.331067,19788.3630114482,12643.1372414456
172.30.15.199,50688,23.58.23.32,443,19,6490,11,5588,8,902,3494.850952,2.175076,20552.8450500078,3317.5852246076
172.30.15.199,50689,50.116.239.135,443,19,6116,10,2164,9,3952,3495.374335,1.718436,10074.2768424305,18398.1248065089
172.30.15.199,50690,184.29.26.86,443,16,3623,8,1781,8,1842,3495.659277,1.359149,10483.0301902155,10842.0783887574
172.30.15.199,50691,184.29.26.86,443,12,1423,6,904,6,519,3495.6607,1.357786,5326.3179912003,3057.9192891957
172.30.15.199,50692,184.29.24.49,443,103,78052,45,3852,58,74200,3495.661491,1.356864,22711.1928682557,437479.364180834
172.30.15.199,50693,184.29.24.49,443,42,30563,16,1998,26,28565,3495.662568,1.355383,11792.976597762,168601.790047584
172.30.15.199,50694,184.29.24.49,443,52,40683,19,2160,33,38523,3495.663528,1.354686,12755.7234665438,227494.78476929
172.30.15.199,50695,184.29.24.49,443,42,31432,15,1968,27,29464,3495.664319,1.353817,11629.3413363831,174109.203828857
172.30.15.199,50696,184.29.24.49,443,27,14530,12,1782,15,12748,3495.665028,1.353026,10536.3828928621,75374.7525915857
172.30.15.199,50697,50.31.185.52,443,13,2705,8,1923,5,782,3495.944325,1.061082,14498.4082285795,5895.8685568118
172.30.15.199,50698,156.154.136.36,443,23,7783,10,2086,13,5697,3495.999072,1.974563,8451.490279116,23081.5628572021
172.30.15.199,50699,50.31.185.52,443,6,348,4,228,2,120,3496.196499,1.163577,1567.5799710722,825.042090038
172.30.15.199,50700,156.154.136.36,443,7,398,4,228,3,170,3496.207414,1.163939,1567.0924335382,1168.4461127258
172.30.15.199,50701,52.33.0.53,443,20,7794,10,2105,10,5689,3497.688052,9.568492,1759.9429460776,4756.4443801595
172.30.15.199,50702,52.33.0.53,443,6,348,4,228,2,120,3497.933785,9.323127,195.6425135043,102.9697439496
172.30.15.199,50703,172.30.30.101,7680,3,198,3,198,0,0,3497.976834,8.985221,176.2894869253,0
172.30.15.199,50704,104.36.113.23,443,42,18642,20,9039,22,9603,3498.626956,8.644545,8365.0440827133,8886.9917387207
172.30.15.199,50705,104.36.113.23,443,7,398,4,228,3,170,3498.877975,8.39391,217.3003999328,162.0222280201
172.30.15.199,50706,182.161.72.94,443,19,6378,10,2494,9,3884,3499.767146,7.3332,2720.7767413953,4237.1679485081
172.30.15.199,50707,209.15.36.33,443,21,6998,12,2044,9,4954,3499.787381,6.592053,2480.5625804283,6012.0875848542
172.30.15.199,50708,8.41.222.241,443,35,14846,17,3092,18,11754,3499.799274,7.389684,3347.3691161895,12724.7660387098
172.30.15.199,50709,204.2.197.204,443,19,7648,10,1722,9,5926,3499.814109,1.42891,9640.91510312,33177.7368763583
172.30.15.199,50710,104.24.246.16,443,14,2727,8,1607,6,1120,3499.832139,7.181048,1790.2679386073,1247.7287437711
172.30.15.199,50711,35.186.239.238,443,35,10263,17,2254,18,8009,3499.851089,7.163372,2517.2502558849,8944.3909935148
172.30.15.199,50712,23.8.186.54,443,19,6876,10,1894,9,4982,3499.880836,7.131939,2124.5274251504,5588.3820655222
172.30.15.199,50713,217.12.15.83,443,20,8075,10,1794,10,6281,3499.958978,7.170391,2001.5644893005,7007.7071110905
172.30.15.199,50714,13.231.12.16,443,19,7651,10,1744,9,5907,3499.973686,6.989496,1996.1382051009,6761.0025100521
172.30.15.199,50715,103.243.220.231,443,7,406,5,294,2,112,3499.97512,7.192065,327.0270777586,124.581743908
172.30.15.199,50716,119.42.60.92,443,6,348,4,228,2,120,3500.005051,7.084016,257.4810672364,135.5163511771
172.30.15.199,50717,209.15.36.33,443,7,402,4,228,3,174,3500.034382,6.43294,283.5406517082,216.38628683
172.30.15.199,50718,207.244.67.99,443,20,6926,11,1986,9,4940,3500.068638,6.310365,2517.7624432185,6262.7122202917
172.30.15.199,50719,72.251.245.179,443,22,9087,12,1898,10,7189,3500.069766,7.059963,2150.7194867735,8146.2183300392
172.30.15.199,50720,72.251.245.179,443,8,480,5,294,3,186,3500.108331,7.02031,335.0279403616,211.9564520655
172.30.15.199,50721,35.201.123.46,443,27,4504,14,2688,13,1816,3500.145971,6.868821,3130.6682762588,2115.0645794962
172.30.15.199,50722,52.45.111.226,443,15,2736,9,1704,6,1032,3500.158162,6.221634,2191.0642766836,1326.9825901042
172.30.15.199,50723,103.231.98.244,443,8,973,5,799,3,174,3500.200058,0.73464,8700.8602853083,1894.8056190784
172.30.15.199,50724,52.4.175.160,443,21,7975,11,1843,10,6132,3500.207651,6.99791,2106.9147788411,7010.0930134854
172.30.15.199,50725,207.244.67.99,443,7,402,4,228,3,174,3500.219322,2.071693,880.4393315033,671.9142266736
172.30.15.199,50726,103.243.220.231,443,15,4203,9,2829,6,1374,3500.225739,6.94041,3260.9024538895,1583.7681059188
172.30.15.199,50727,159.127.41.201,443,20,8207,11,1810,9,6397,3500.248593,1.666194,8690.4646157632,30714.3105784734
172.30.15.199,50728,52.4.175.160,443,6,348,4,228,2,120,3500.249249,6.964834,261.8870744084,137.8353023202
172.30.15.199,50729,52.9.96.194,443,19,7097,10,1840,9,5257,3500.254874,7.00375,2101.7312154204,6004.7831518831
172.30.15.199,50730,119.42.60.92,443,18,2862,10,1679,8,1183,3500.256249,6.836021,1964.8857134874,1384.431089372
172.30.15.199,50731,103.231.98.244,443,8,973,5,799,3,174,3500.301032,1.030299,6204.0242686831,1351.0641085743
172.30.15.199,50732,159.127.41.201,443,6,344,4,228,2,116,3500.406313,6.835286,266.8505750893,135.766082063
172.30.15.199,50733,52.9.96.194,443,6,348,4,228,2,120,3500.40683,6.858222,265.9581448369,139.9779709668
172.30.15.199,50734,52.45.111.226,443,7,402,4,228,3,174,3500.409581,6.001015,303.9485820315,231.9607599714
172.30.15.199,50735,74.217.250.126,443,22,10405,11,1808,11,8597,3500.62087,6.582427,2197.3658044366,10448.4257858085
172.30.15.199,50736,74.217.250.126,443,6,348,4,228,2,120,3500.664206,6.542324,278.8000105161,146.7368476401
172.30.15.199,50737,103.231.98.48,443,37,17231,15,9136,22,8095,3500.725669,6.34457,11519.772025527,10207.1535186779
172.30.15.199,50738,103.231.98.48,443,7,402,4,228,3,174,3500.772252,6.298087,289.6117503617,221.0194936971
172.30.15.199,50739,103.231.98.244,443,8,664,5,490,3,174,3500.808371,0.356397,10998.9702494685,3905.7567824643
172.30.15.199,50740,103.231.98.244,443,17,6428,8,1087,9,5341,3501.136693,1.033357,8415.2911336526,41348.7304000356
172.30.15.199,50741,103.231.98.244,443,8,973,5,799,3,174,3501.149082,0.286395,22318.8253984815,4860.4200492313
172.30.15.199,50742,103.231.98.43,443,50,17590,18,9164,32,8426,3501.165904,5.904198,12416.9277520838,11416.9612875446
172.30.15.199,50743,103.231.98.244,443,17,6428,8,1087,9,5341,3501.170994,0.999057,8704.2080682084,42768.3305356954
172.30.15.199,50744,202.58.9.200,443,20,8435,11,1919,9,6516,3501.206936,5.846839,2625.6922757751,8915.586695649
172.30.15.199,50745,103.231.98.244,443,8,664,5,490,3,174,3501.23138,0.337795,11604.6714723456,4120.8425228329
172.30.15.199,50746,103.231.98.244,443,8,973,5,799,3,174,3501.242145,0.327031,19545.5476698044,4256.4772147008
172.30.15.199,50747,103.231.98.244,443,8,664,5,490,3,174,3501.344332,0.320565,12228.4092149803,4342.3330681767
172.30.15.199,50748,103.231.98.244,443,8,973,5,799,3,174,3501.361179,0.359938,17758.6139835166,3867.332707299
172.30.15.199,50749,103.231.98.244,443,8,664,5,490,3,174,3501.437643,0.37713,10394.2937448666,3691.0349216465
172.30.15.199,50750,103.231.98.244,443,8,973,5,799,3,174,3501.501965,0.320041,19972.4410309962,4349.4427276513
172.30.15.199,50751,103.231.98.244,443,8,664,5,490,3,174,3501.620599,0.318832,12294.8762984922,4365.9356651789
172.30.15.199,50752,103.231.98.244,443,27,11581,12,1042,15,10539,3501.726914,2.746537,3035.0947393026,30697.5656981866
172.30.15.199,50753,103.231.98.244,443,8,973,5,799,3,174,3501.829534,0.338177,18901.3445621623,4116.1876768664
172.30.15.199,50754,103.231.98.244,443,16,6374,7,1033,9,5341,3501.903119,1.135366,7278.7101251933,37633.6793597843
172.30.15.199,50755,103.231.98.244,443,10,1081,6,853,4,228,3501.92025,0.85342,7996.0628998625,2137.2829322024
172.30.15.199,50756,103.231.98.244,443,17,6428,8,1087,9,5341,3501.921874,1.115954,7792.4358889354,38288.3165435178
172.30.15.199,50757,103.231.98.244,443,13,1142,8,860,5,282,3502.038663,0.85117,8082.9916467886,2650.469353947
172.30.15.199,50758,103.231.98.244,443,15,1250,8,860,7,390,3502.039565,0.763142,9015.360181987,4088.3610127615
172.30.15.199,50759,103.231.98.244,443,14,1196,8,860,6,336,3502.044832,0.758692,9068.2384946738,3542.9396909423
172.30.15.199,50760,184.29.25.122,443,30,12483,15,10506,15,1977,3502.104231,4.892206,17179.9797473778,3232.897388213
172.30.15.199,50761,103.231.98.244,443,28,11616,14,1162,14,10454,3502.140225,1.740565,5340.7945121266,48048.7657743302
172.30.15.199,50762,103.231.98.43,443,52,17586,18,8973,34,8613,3502.238838,4.830672,14860.0443168168,14263.853973113
172.30.15.199,50763,103.231.98.43,443,7,402,4,228,3,174,3502.387027,4.683381,389.4622282492,297.2211741902
172.30.15.199,50764,103.231.98.244,443,18,6185,9,844,9,5341,3502.910349,1.028667,6563.8345548197,41537.2516081659
172.30.15.199,50765,103.231.98.244,443,9,718,6,544,3,174,3502.911647,0.781683,5567.4742830522,1780.7730243586
172.30.15.199,50766,111.221.29.253,443,24,6388,14,1870,10,4518,3504.266188,0.646776,23130.1099607885,55883.3351886858
172.30.15.199,50767,13.228.208.99,443,15,2392,8,1513,7,879,3504.757235,2.306964,5246.7225322981,3048.1619999273
172.30.15.199,50768,103.229.206.238,443,18,6074,10,1942,8,4132,3504.764706,2.330244,6667.1129718598,14185.6389287975
172.30.15.199,50769,54.148.121.12,443,21,9058,10,2415,11,6643,3504.76525,2.516936,7675.999707581,21114.5615144764
172.30.15.199,50770,4.78.226.233,443,25,9010,12,1896,13,7114,3504.774888,2.471448,6137.2927935358,23027.7958508512
172.30.15.199,50771,54.148.121.12,443,6,340,4,228,2,112,3504.997832,2.275433,801.605672415,393.7712075021
172.30.15.199,50772,4.78.226.233,443,7,398,4,228,3,170,3505.010638,2.235854,815.7956646543,608.26869733
172.30.15.199,50773,103.231.98.244,443,8,973,5,799,3,174,3506.111701,0.382542,16709.276367027,3638.8161299909
172.30.15.199,50774,103.231.98.244,443,8,973,5,799,3,174,3506.142702,0.327926,19492.2025091066,4244.8601208818
172.30.15.199,50775,103.231.98.244,443,8,664,5,490,3,174,3506.380644,0.313723,12495.0991798414,4437.0352189641
172.30.15.199,50776,103.231.98.244,443,17,6119,8,778,9,5341,3506.3879,1.064608,5846.2833268225,40134.9604737263
172.30.15.199,50777,184.29.25.122,443,18,5955,10,5008,8,947,3507.183956,9.82202,4078.99800652,771.3280974789
172.30.15.199,50778,104.36.113.23,443,23,6068,11,4944,12,1124,3507.403025,10.06232,3930.7038535845,893.6308922793
172.30.15.199,50779,104.36.113.23,443,7,402,4,228,3,174,3507.654056,9.810865,185.9163284787,141.883513839
172.30.15.199,50780,35.201.123.46,443,21,3546,11,2333,10,1213,3508.482558,8.541569,2185.0786430456,1136.0910390117
172.30.15.199,50781,35.201.123.46,443,6,348,4,228,2,120,3508.734592,8.249789,221.096563803,116.3666125279
172.30.15.199,50782,54.164.214.76,443,19,6466,10,1638,9,4828,3509.300044,8.163554,1605.183232695,4731.2726785419
172.30.15.199,50783,54.164.214.76,443,6,340,4,228,2,112,3509.482459,7.98232,228.5049960412,112.2480682308
172.30.15.199,50784,23.8.189.227,443,31,9597,15,2259,16,7338,3509.558703,7.479222,2416.2941011779,7848.9447164425
172.30.15.199,50785,52.85.51.65,443,24,4854,14,1754,10,3100,3510.652249,6.810277,2060.4154574037,3641.5552553885
172.30.15.199,50786,151.139.104.66,443,78,57610,31,2724,47,54886,3511.216854,6.248394,3487.616177853,70272.1371283544
172.30.15.199,50787,23.8.189.227,443,286,205542,119,11133,167,194409,3520.884419,6.153382,14473.9917008241,252750.763726356
172.30.15.199,50788,52.220.14.37,443,21,2757,12,1656,9,1101,3520.885888,6.176851,2144.782187558,1425.9693167279
172.30.15.199,50789,139.59.82.147,443,22,3067,13,1874,9,1193,3520.886852,6.150989,2437.3316226058,1551.6203979556
172.30.15.199,50790,23.58.57.98,443,19,4252,10,3017,9,1235,3520.905212,6.132994,3935.4351235302,1610.9586932581
172.30.15.199,50791,104.244.43.48,443,19,2634,10,1599,9,1035,3520.927009,6.191559,2066.0386180605,1337.3045463994
172.30.15.199,50792,52.220.69.147,443,16,3034,8,1732,8,1302,3520.938763,6.119542,2264.2217342409,1702.088162807
172.30.15.199,50793,104.244.42.133,443,21,3066,12,1764,9,1302,3520.940056,6.179881,2283.5391166917,1685.4693480344
172.30.15.199,50794,104.244.42.195,443,20,3293,11,1909,9,1384,3520.941033,6.177813,2472.0722365667,1792.2199975947
172.30.15.199,50795,157.240.16.39,443,31,6893,17,5078,14,1815,3520.94309,6.09449,6665.6931096778,2382.479912183
172.30.15.199,50796,151.101.66.2,443,61,28552,25,3719,36,24833,3520.953702,4.000116,7437.7843042549,49664.5597277659
172.30.15.199,50797,151.101.193.2,443,12,1425,6,904,6,521,3520.963561,6.164892,1173.0943542888,676.0864586111
172.30.15.199,50798,103.243.221.51,443,20,7542,11,3090,9,4452,3520.964725,6.197839,3988.4869548884,5746.5190689848
172.30.15.199,50799,180.179.41.214,443,18,4071,9,2858,9,1213,3520.965752,4.444496,5144.3403256521,2183.3746728538
172.30.15.199,50800,52.84.108.64,443,16,3204,9,2254,7,950,3520.966723,6.013167,2998.7525708167,1263.8930533611
172.30.15.199,50801,64.74.232.52,443,14,3057,8,2221,6,836,3520.971252,4.790386,3709.0956762147,1396.1296647076
172.30.15.199,50802,52.84.110.244,443,15,2564,8,1577,7,987,3520.983323,5.996338,2103.9507779582,1316.803689185
172.30.15.199,50803,104.19.199.151,443,15,5831,8,1025,7,4806,3520.984228,5.980743,1371.0671065451,6428.6326966398
172.30.15.199,50804,169.38.89.75,443,15,2930,8,1755,7,1175,3520.98514,6.052618,2319.6573780139,1553.0469624879
172.30.15.199,50805,52.85.51.65,443,19,2596,11,1635,8,961,3520.986129,6.142604,2129.3900762608,1251.5864607258
172.30.15.199,50806,34.233.218.142,443,16,2824,8,2000,8,824,3520.987789,6.20898,2576.9127940498,1061.6880711485
172.30.15.199,50807,13.232.120.220,443,17,4169,8,1599,9,2570,3520.988611,6.049038,2114.7164226776,3398.88755865
172.30.15.199,50808,52.84.110.238,443,15,2925,8,1649,7,1276,3520.989511,5.993418,2201.0812528012,1703.2017456484
172.30.15.199,50809,157.240.16.20,443,12,1688,7,971,5,717,3520.99162,5.973515,1300.4068793667,960.2386534561
172.30.15.199,50810,184.29.24.49,443,124,103844,46,5691,78,98153,3521.02797,6.009346,7576.1988076575,130667.130832544
172.30.15.199,50811,117.18.237.66,443,16,6753,9,1153,7,5600,3521.084564,5.881781,1568.232479244,7616.7405756861
172.30.15.199,50812,13.232.236.27,443,22,7716,11,1954,11,5762,3521.107731,5.929806,2636.1739321657,7773.6101315961
172.30.15.199,50813,64.74.232.52,443,14,3057,7,2167,7,890,3521.223434,5.3721,3227.0434280821,1325.3662441131
172.30.15.199,50814,52.114.158.52,443,18,7787,10,3147,8,4640,3521.445415,1.555988,16180.0733681743,23856.2251122749
172.30.15.199,50815,184.29.26.86,443,42,30652,16,2226,26,28426,3521.722558,5.314938,3350.5564881472,42786.5762498077
172.30.15.199,50816,184.29.24.49,443,79,63143,31,4881,48,58262,3524.107265,2.9301,13326.5076277258,159071.704037403
172.30.15.199,50817,184.29.24.49,443,54,38678,23,2560,31,36118,3524.110163,2.92709,6996.71004308,98713.7395843608
172.30.15.199,50818,184.29.24.49,443,39,27754,15,2698,24,25056,3524.11107,2.926378,7375.6705388023,68496.9610897814
172.30.15.199,50819,184.29.24.49,443,55,43073,21,3022,34,40051,3524.111974,2.925434,8264.0729546447,109524.945700356
172.30.15.199,50820,184.29.24.49,443,45,35346,16,2098,29,33248,3524.113182,2.923609,5740.8497511125,90977.9659318347
172.30.15.199,50821,104.20.90.77,443,114,72967,49,4639,65,68328,3524.538132,2.499593,14847.2171269482,218685.201950877
172.30.15.199,50822,104.20.90.77,443,6,348,4,228,2,120,3524.736243,2.301449,792.5441754303,417.1285133844
172.30.15.199,50823,157.240.16.16,443,26,7512,13,1863,13,5649,3525.437177,1.600439,9312.4448979295,28237.2524038668
172.30.15.199,50824,151.101.65.140,443,25,7976,13,1820,12,6156,3525.461995,1.576301,9236.8145423999,31242.7639137438
172.30.15.199,50825,180.179.41.214,443,20,8134,10,1667,10,6467,3525.462928,0.334588,39857.9745836472,154625.987781911
172.30.15.199,50826,52.84.102.103,443,29,6604,15,4812,14,1792,3525.737811,11.243951,3423.7075561785,1274.99666265
172.30.15.199,50827,13.232.120.220,443,15,2713,8,1575,7,1138,3525.750357,1.286339,9795.2406014261,7077.4500345542
172.30.15.199,50828,34.199.78.214,443,34,15504,18,2722,16,12782,3525.915317,1.28663,16924.8346455461,79475.8399850736
172.30.15.199,50829,34.199.78.214,443,6,348,4,228,2,120,3526.093072,1.105393,1650.0918677794,868.4694040944
172.30.15.199,50830,180.179.41.214,443,22,12360,10,2185,12,10175,3526.164259,0.386523,45223.6994952821,210595.488496337
172.30.15.199,50831,104.20.90.77,8443,28,7921,14,2505,14,5416,3526.360966,41.421668,483.8047564864,1046.0225792935
172.30.15.199,50832,172.217.166.212,443,29,6969,14,2390,15,4579,3526.49481,0.543449,35182.6942362718,67406.5091664805
172.30.15.199,50833,52.221.3.46,443,20,7516,10,3070,10,4446,3526.666024,10.396004,2362.4461860539,3421.3145743308
172.30.15.199,50834,104.244.42.72,443,27,6448,15,5071,12,1377,3526.782481,10.35222,3918.7729781632,1064.1195801481
172.30.15.199,50835,151.139.104.66,443,89,66112,38,3339,51,62773,3526.943991,0.992317,26918.8172731166,506072.152346616
172.30.15.199,50836,34.199.78.214,443,23,3976,12,2215,11,1761,3527.04648,5.704307,3106.4246717437,2469.7127977159
172.30.15.199,50837,104.20.90.77,443,170,112417,73,5879,97,106538,3527.097701,9.901368,4750.050700065,86079.4185207555
172.30.15.199,50838,117.18.237.66,443,17,6735,9,1801,8,4934,3527.41392,9.567444,1505.9403535573,4125.6578036933
172.30.15.199,50839,104.20.90.77,443,18,3305,11,1619,7,1686,3527.903399,9.096066,1423.9122715249,1482.8388448369
172.30.15.199,50840,23.8.189.227,443,72,47698,28,3215,44,44483,3528.090444,8.924497,2881.9551398807,39874.9643817462
172.30.15.199,50841,107.6.122.24,443,11,1354,6,904,5,450,3528.356175,8.705169,830.7707753864,413.5473992521
172.30.15.199,50842,107.6.122.24,443,16,4414,9,2563,7,1851,3528.382086,8.669962,2364.9469282565,1707.9659634033
172.30.15.199,50843,151.101.66.110,443,46,24316,23,2337,23,21979,3528.458089,8.545012,2187.9430947553,20577.1507401053
172.30.15.199,50844,162.247.242.19,443,22,5799,10,2009,12,3790,3528.819649,8.386821,1916.3399338081,3615.1957934955
172.30.15.199,50845,85.159.213.174,443,71,33068,33,3809,38,29259,3530.805441,6.312874,4826.9615392291,37078.5160609879
172.30.15.199,50846,85.159.213.174,443,40,14974,20,2593,20,12381,3531.396277,5.724533,3623.7017063226,17302.3720886925
172.30.15.199,50847,182.161.72.100,443,18,5817,9,1970,9,3847,3531.590949,5.503893,2863.4277592242,5591.678471947
172.30.15.199,50848,23.11.214.58,443,146,104998,64,5033,82,99965,3532.170519,4.823684,8347.1471182599,165790.296379268
172.30.15.199,50849,172.217.166.206,443,35,12746,16,2785,19,9961,3532.248266,4.767269,4673.5353092096,16715.6499874458
172.30.15.199,50850,180.179.41.214,443,17,4019,9,2860,8,1159,3533.880468,0.221453,103317.633990005,41868.9292987468
172.30.15.199,50851,180.179.41.214,443,17,4022,9,2863,8,1159,3536.236514,0.253919,90201.9935492061,36515.5817406671
172.30.15.199,50852,180.179.41.214,443,17,4022,9,2863,8,1159,3536.658988,0.273427,83766.4166303731,33910.3307281182
172.30.15.199,50854,180.179.41.214,443,17,4022,9,2863,8,1159,3543.534902,0.222608,102889.384029308,41651.6926615327
172.30.15.199,50855,180.179.41.214,443,17,4022,9,2863,8,1159,3543.93225,0.243926,93897.3295179296,38011.5280863711
172.30.15.199,50856,162.125.34.137,443,24,9166,13,4716,11,4450,3545.852607,1093.574277,34.4997141881,32.5538015558
172.30.15.199,50857,180.179.41.214,443,17,4014,9,2855,8,1159,3547.263253,0.206578,110563.564368041,44883.7727154324
172.30.15.199,50858,180.179.41.214,443,17,4015,9,2856,8,1159,3550.098644,0.232222,98388.6108983457,39927.3109352881
172.30.15.199,50859,64.74.232.52,443,13,3005,7,2169,6,836,3551.003144,1.079525,16073.7361339463,6195.3173849604
172.30.15.199,50860,64.74.232.52,443,6,348,4,228,2,120,3551.255705,6.014534,303.2653901366,159.6133632298
172.30.15.199,50861,180.179.41.214,443,17,4015,9,2856,8,1159,3551.763864,1.005026,22733.7402216502,9225.6319737019
172.30.15.199,50862,151.101.2.2,443,18,8942,9,1120,9,7822,3554.60773,0.13162,68074.7606748469,475429.266070225
172.30.15.199,50863,151.101.2.2,443,35,13902,17,4252,18,9650,3554.608403,2.404969,14144.0492580171,32100.2058654433
172.30.15.199,50864,54.169.137.62,80,10,1888,6,998,4,890,3555.231347,1.830215,4362.32901599,3890.2533308929
172.30.15.199,50865,54.169.137.62,80,6,348,4,228,2,120,3555.240344,1.862311,979.4282480207,515.4885515898
172.30.15.199,50866,54.169.137.62,443,101,89356,36,3306,65,86050,3555.428531,1.633495,16191.0504776564,421427.67501583
172.30.15.199,50867,54.169.137.62,443,54,41848,20,3066,34,38782,3557.004497,10.082783,2432.6616966763,30770.8695109268
172.30.15.199,50868,52.84.108.98,443,2146,1727557,918,74404,1228,1653153,3557.048569,9.935111,59911.9627349924,1331160.16519597
172.30.15.199,50869,52.84.108.98,443,17,6861,9,1153,8,5708,3557.049129,0.154755,59603.8900196998,295072.857096658
172.30.15.199,50870,52.84.108.98,443,17,6861,9,1153,8,5708,3557.049669,0.154717,59618.5293148553,295145.329860533
172.30.15.199,50871,52.84.108.98,443,18,6927,10,1219,8,5708,3557.050158,0.154592,63082.1776030355,295383.978472622
172.30.15.199,50872,52.84.108.98,443,17,6849,8,1087,9,5762,3557.050667,0.169107,51423.063504121,272584.813165359
172.30.15.199,50873,52.84.108.98,443,18,6915,10,1207,8,5708,3557.051183,0.153914,62736.3332770305,296685.161843654
172.30.15.199,50874,54.169.137.62,443,92,81673,32,3807,60,77866,3557.421194,9.66578,3150.9097041316,64446.7389077769
172.30.15.199,50875,54.169.137.62,443,45,35414,17,3021,28,32393,3557.467262,9.593576,2519.1857551346,27012.2423588458
172.30.15.199,50876,54.169.137.62,443,11,1323,6,904,5,419,3557.468566,9.587635,754.3048937512,349.6169806214
172.30.15.199,50877,151.101.130.2,443,39,16982,18,2781,21,14201,3557.571274,9.443661,2355.8660142501,12030.080283483
172.30.15.199,50878,172.217.166.198,443,32,8728,15,3073,17,5655,3557.764189,9.25363,2656.6871595255,4888.8922509328
172.30.15.199,50879,52.84.108.98,443,96,69070,44,3520,52,65550,3558.916304,8.067013,3490.7592190565,65005.4735253283
172.30.15.199,50880,172.217.166.202,443,111,94384,38,3525,73,90859,3560.255062,6.762349,4170.1485681975,107488.093264639
172.30.15.199,50881,52.84.108.216,443,14,2673,8,1671,6,1002,3560.266226,6.716611,1990.2894480565,1193.4590227125
172.30.15.199,50882,104.113.143.112,443,26,8726,13,2078,13,6648,3560.332431,6.651638,2499.2340232585,7995.6245363921
172.30.15.199,50883,104.16.208.165,443,20,4283,10,1756,10,2527,3560.563734,6.45305,2176.9550832552,3132.782172771
172.30.15.199,50884,52.84.109.95,443,46,27881,23,4069,23,23812,3560.719028,1.245382,26138.1648361694,152961.902452412
172.30.15.199,50885,52.84.109.95,443,11,1342,6,904,5,438,3561.414882,5.567526,1298.9611543799,629.3639221443
172.30.15.199,50886,52.84.102.103,443,19,2900,10,1774,9,1126,3561.974001,5.010499,2832.452416416,1797.8249272178
172.30.15.199,50887,52.84.110.128,443,16,3721,9,1715,7,2006,3561.989263,4.991273,2748.7977515956,3215.2118307293
172.30.15.199,50888,52.84.110.128,443,8,480,5,294,3,186,3562.003645,4.979305,472.3550776664,298.8368858706
172.30.15.199,50889,184.29.25.7,443,310,283346,114,23264,196,260082,3567.691722,9.3759,19850.0410627246,221915.336127732
172.30.15.199,50890,184.29.25.7,443,211,193120,75,12162,136,180958,3567.692423,9.375385,10377.8138177794,154411.15218202
172.30.15.199,50891,184.29.25.7,443,133,117414,50,10720,83,106694,3568.122602,8.945122,9587.3482776422,95420.9456282421
172.30.15.199,50892,184.29.25.7,443,78,65658,30,7088,48,58570,3568.124286,8.943977,6339.9089689073,52388.3279216846
172.30.15.199,50893,184.29.25.7,443,22,7985,11,1678,11,6307,3571.02616,6.038739,2222.9806587104,8355.3867785972
172.30.15.199,50894,184.29.25.7,443,167,95048,71,7911,96,87137,3571.075505,6.029346,10496.6608318709,115617.183024489
172.30.15.199,50895,104.122.123.186,443,18,6530,9,1514,9,5016,3571.275291,5.79122,2091.4418723516,6929.1099284779
172.30.15.199,50896,151.101.66.110,443,19,2512,10,1528,9,984,3571.325604,5.793783,2109.8477454195,1358.6977627571
172.30.15.199,50897,162.247.242.19,443,29,9567,14,5404,15,4163,3571.72932,5.517315,7835.6954424389,6036.2694535294
172.30.15.199,50898,162.247.242.19,443,7,398,4,228,3,170,3571.981065,5.271445,346.0151817955,257.9937759002
172.30.15.199,50899,103.254.155.35,443,22,7891,12,2171,10,5720,3572.41452,4.756221,3651.6385592679,9621.0836292088
172.30.15.199,50900,103.254.155.35,443,35,15023,19,5163,16,9860,3572.417096,4.754161,8687.9682871492,16591.7813889775
172.30.15.199,50901,130.211.5.208,443,30,8124,15,2709,15,5415,3572.493976,4.657308,4653.3319247945,9301.5106580887
172.30.15.199,50902,52.84.101.37,443,148,122058,58,4213,90,117845,3572.5043,4.508115,7476.2955248478,209125.099958626
172.30.15.199,50903,157.240.16.20,443,47,24531,24,2246,23,22285,3572.836349,4.280418,4197.7208767931,41650.1379070939
172.30.15.199,50904,13.107.21.200,443,34,10919,16,2601,18,8318,3572.915189,4.097104,5078.7092541459,16241.7160999559
172.30.15.199,50905,172.217.166.198,443,15,5181,7,1165,8,4016,3572.939099,0.403042,23124.1409083966,79713.7767280007
172.30.15.199,50906,172.217.166.198,443,34,8141,16,2629,18,5512,3572.939606,4.211788,4993.6036666612,10469.6627655521
172.30.15.199,50907,104.244.43.80,443,8,480,5,294,3,186,3572.943698,4.278167,549.7681600555,347.8125094228
172.30.15.199,50908,52.84.110.44,443,21,7817,12,1738,9,6079,3572.944506,4.054541,3429.2414357137,11994.4526396454
172.30.15.199,50909,152.195.61.116,443,37,12205,19,2369,18,9836,3572.960366,4.052525,4676.5905207247,19417.0301231945
172.30.15.199,50910,104.244.43.80,443,18,2507,10,1526,8,981,3573.001142,4.213686,2897.225849292,1862.5023316877
172.30.15.199,50912,172.217.166.198,443,6,348,4,228,2,120,3573.04142,4.078388,447.2355254086,235.3871186361
172.30.15.199,50913,52.229.207.60,443,33,12561,19,3205,14,9356,3573.173214,5.691834,4504.6991883458,13150.0672718139
172.30.15.199,50914,152.195.61.100,443,27,7941,14,1915,13,6026,3573.655461,3.357084,4563.4842619366,14360.0815469607
172.30.15.199,50915,54.201.247.66,443,45,12582,26,7182,19,5400,3573.72705,13.777529,4170.2688486448,3135.5404877029
172.30.15.199,50916,54.201.247.66,443,14,4951,7,1033,7,3918,3573.727343,1.092618,7563.4851338702,28687.0617178156
172.30.15.199,50917,54.201.247.66,443,18,5317,10,1333,8,3984,3573.728973,3.243198,3288.1125358369,9827.3370913534
172.30.15.199,50918,54.201.247.66,443,17,5125,10,1207,7,3918,3573.765628,3.206909,3010.9990648316,9773.8975443332
172.30.15.199,50919,157.240.16.39,443,27,4526,14,2940,13,1586,3573.86996,3.246896,7243.8415027766,3907.7321848312
172.30.15.199,50920,104.244.42.195,443,24,3762,12,2040,12,1722,3573.878833,3.335858,4892.2945760882,4129.6721862862
172.30.15.199,50921,104.244.42.133,443,23,3446,12,1854,11,1592,3573.880405,3.341578,4438.6215135484,3811.3729501451
172.30.15.199,50922,54.201.247.66,443,6,348,4,228,2,120,3573.946832,3.367579,541.6354003871,285.0712633616
172.30.15.199,50923,161.202.1.35,443,17,5795,9,1626,8,4169,3573.952843,3.225059,4033.4145824931,10341.5162327267
172.30.15.199,50924,161.202.1.35,443,17,5746,9,1577,8,4169,3573.953174,3.224808,3912.1708951355,10342.3211552442
172.30.15.199,50925,161.202.1.35,443,20,7367,11,3279,9,4088,3573.953428,3.225223,8133.3910864449,10140.0740351896
172.30.15.199,50926,161.202.1.35,443,19,7305,10,3217,9,4088,3573.953672,3.22506,7980.0065735217,10140.5865317242
172.30.15.199,50927,161.202.1.35,443,19,6622,10,2582,9,4040,3573.953942,3.223841,6407.2638818106,10025.3083201064
172.30.15.199,50928,161.202.1.35,443,18,5924,10,1938,8,3986,3573.954245,3.223806,4809.2223911737,9891.4140615162
172.30.15.199,50929,54.171.197.251,443,17,5556,9,1909,8,3647,3573.957421,3.265079,4677.3753406889,8935.7715387597
172.30.15.199,50930,103.254.155.35,443,19,8643,10,1699,9,6944,3574.006229,3.164,4295.8280657399,17557.5221238951
172.30.15.199,50931,54.171.197.251,443,6,348,4,228,2,120,3574.101321,3.121303,584.3713346638,307.5638603494
172.30.15.199,50932,103.254.155.35,443,6,348,4,228,2,120,3574.177846,3.000688,607.860597303,319.9266301595
172.30.15.199,50933,104.244.42.195,443,11,1376,7,958,4,418,3574.179751,2.793675,2743.3398659473,1196.989628357
172.30.15.199,50934,104.244.42.133,443,11,1376,7,958,4,418,3574.180184,2.796047,2741.0125795451,1195.9741735385
172.30.15.199,50935,184.29.25.7,443,876,807674,321,79500,555,728174,3574.562618,32.475092,19584.240130867,179380.307837156
172.30.15.199,50936,184.29.25.7,443,224,190027,89,19234,135,170793,3574.563296,2.502534,61486.4773065972,545984.190424543
172.30.15.199,50937,184.29.25.7,443,377,332367,145,33098,232,299269,3574.563915,12.935489,20469.5779185465,185083.996438017
172.30.15.199,50938,184.29.25.7,443,1027,941842,380,86169,647,855673,3574.56463,32.47271,21228.6563086358,210804.210674132
172.30.15.199,50939,184.29.25.7,443,1087,982430,403,106806,684,875624,3574.565289,32.472151,26313.2553183804,215723.066821167
172.30.15.199,50940,202.79.210.118,443,11,630,6,348,5,282,3574.656737,12.859683,216.4905620146,175.4320071498
172.30.15.199,50941,202.79.210.118,443,20,8331,10,1920,10,6411,3574.760435,2.409693,6374.2559736861,21284.0390871363
172.30.15.199,50942,152.195.60.249,443,6,348,4,228,2,120,3574.820568,2.18807,833.6113561267,438.7428190141
172.30.15.199,50943,152.195.60.249,443,201,164347,79,5395,122,158952,3575.061475,1.951011,22121.8639976902,651772.850076155
172.30.15.199,50944,184.29.25.7,443,62,47909,25,4305,37,43604,3575.537449,1.529169,22522.0364786378,228118.670990597
172.30.15.199,50945,184.29.25.7,443,343,310190,127,23078,216,287112,3575.550533,11.948656,15451.4449156457,192230.490190695
172.30.15.199,50946,184.29.25.7,443,45,32996,19,3967,26,29029,3575.551267,1.516233,20930.819999297,153163.794746557
172.30.15.199,50947,184.29.25.7,443,85,72539,32,7014,53,65525,3575.55192,1.514013,37061.7689544283,346232.165774011
172.30.15.199,50948,184.29.25.7,443,683,622879,248,59782,435,563097,3575.552473,21.827145,21911.0653271422,206384.114825831
172.30.15.199,50949,184.29.25.7,443,752,694221,271,62904,481,631317,3575.557535,31.480068,15985.7342112474,160435.993975615
172.30.15.199,50950,184.29.25.7,443,1065,987363,386,97643,679,889720,3575.558289,31.486308,24809.0058701071,226058.895187076
172.30.15.199,50951,184.29.25.7,443,278,249362,103,25038,175,224324,3575.997049,11.501813,17414.9936188323,156026.880284006
172.30.15.199,50952,184.29.25.7,443,12,1423,6,904,6,519,3576.421581,0.644071,11228.5757315626,6446.4942529657
172.30.15.199,50953,184.29.25.7,443,785,729508,284,66241,501,663267,3576.998961,20.382203,25999.54479896,260331.819872463
172.30.15.199,50954,184.29.25.7,443,702,627794,263,65143,439,562651,3577.135433,29.902099,17428.3417361437,150531.506166173
172.30.15.199,50955,184.29.25.7,443,1094,1000312,404,98053,690,902259,3577.140025,29.896864,26237.6682718296,241432.412442992
172.30.15.199,50956,184.29.25.7,443,15,2114,8,1529,7,585,3577.210981,10.288368,1188.9154820279,454.8826402788
172.30.15.199,50957,184.29.25.7,443,37,19786,16,4322,21,15464,3577.213753,10.291048,3359.8133057002,12021.3218323342
172.30.15.199,50958,184.29.25.7,443,13,1477,6,904,7,573,3577.473115,10.031688,720.9155627647,456.9520104692
172.30.15.199,50960,184.29.25.7,443,180,148787,74,12007,106,136780,3578.790924,8.70815,11030.586289855,125656.999477502
172.30.15.199,50961,184.29.25.7,443,15,1749,7,970,8,779,3579.114397,8.389991,924.9116000244,742.7898313598
172.30.15.199,50962,103.254.155.35,443,30,12639,15,4547,15,8092,3579.124107,8.375457,4343.1659908229,7729.2498785439
172.30.15.199,50963,103.254.155.35,443,20,9230,10,3404,10,5826,3579.128627,8.370844,3253.1964518751,5567.8973350835
172.30.15.199,50964,184.29.25.7,443,63,48485,24,4223,39,44262,3580.138569,7.360443,4589.9411217504,48107.9739358077
172.30.15.199,50965,184.29.25.7,443,390,360948,137,35313,253,325635,3580.720245,16.659755,16957.2721807732,156369.646492399
172.30.15.199,50966,184.29.25.7,443,73,27787,33,5501,40,22286,3582.673709,4.825524,9119.8385916227,36946.8683608257
172.30.15.199,50967,184.29.25.7,443,8,480,5,294,3,186,3582.924643,4.574492,514.155451578,325.2820203861
172.30.15.199,50968,184.29.25.7,443,42,25303,19,5456,23,19847,3587.346888,19.698204,2215.8365300715,8060.4302808521
172.30.15.199,50969,184.29.25.7,443,16,1765,8,1114,8,651,3587.426416,9.953099,895.3995132571,523.2541141206
172.30.15.199,50970,184.29.25.7,443,285,240657,112,32795,173,207862,3587.458344,19.578888,13400.148159589,84933.117754185
172.30.15.199,50971,184.29.25.7,443,83,58501,36,5121,47,53380,3587.459162,9.922285,4128.8876503749,43038.4734967798
172.30.15.199,50972,184.29.25.7,443,15,1648,8,1063,7,585,3587.496159,9.885067,860.2875428158,473.4414040896
172.30.15.199,50973,184.29.25.7,443,252,223161,93,21464,159,201697,3587.528129,19.516584,8798.2610071517,82677.173423382
172.30.15.199,50974,184.29.25.7,443,16,2332,8,1541,8,791,3587.669015,9.712527,1269.2886207678,651.5297203292
172.30.15.199,50975,184.29.25.7,443,244,223668,86,19405,158,204263,3588.559859,8.821261,17598.3909783419,185246.077629943
172.30.15.199,50976,184.29.25.7,443,12,1423,6,904,6,519,3590.844804,6.53532,1106.6022780828,635.3170158462
172.30.15.199,50977,184.29.25.7,443,12,1423,6,904,6,519,3590.878299,6.479928,1116.0617834025,640.7478601614
172.30.15.199,50978,103.254.155.35,443,19,8786,10,2449,9,6337,3591.143001,6.310872,3104.4838177672,8033.1212548757
172.30.15.199,50979,103.254.155.35,443,21,9523,11,3550,10,5973,3591.153757,6.300007,4507.9314991239,7584.7534772583
172.30.15.199,50980,103.254.155.35,443,6,348,4,228,2,120,3591.394056,6.059894,300.9953639453,158.4186126028
172.30.15.199,50981,172.25.10.224,7680,3,198,3,198,0,0,3593.591966,9.011172,175.781796197,0
172.30.15.199,50982,52.175.23.79,443,26,9971,13,2121,13,7850,3593.625455,125.688833,135.0000600292,499.6466153839
172.30.15.199,50983,157.240.16.39,443,23,3171,13,1902,10,1269,3595.491562,1.889479,8053.0135555889,5372.9096751011
172.30.15.199,50984,161.202.1.35,443,27,10438,15,8149,12,2289,3596.580073,20.54929,3172.469705766,891.1256787947
172.30.15.199,50985,54.201.247.66,443,43,9406,23,7294,20,2112,3596.618718,20.836844,2800.4240949349,810.8713584456
172.30.15.199,50986,162.247.242.19,443,23,5952,11,2126,12,3826,3596.711052,10.526377,1615.7506044103,2907.743091474
172.30.15.199,50987,161.202.1.35,443,6,348,4,228,2,120,3596.831258,10.268003,177.6392157268,93.4943240667
172.30.15.199,50988,54.201.247.66,443,6,348,4,228,2,120,3596.869943,10.477494,174.087429685,91.6249629921
172.30.15.199,50989,162.247.242.19,443,7,398,4,228,3,170,3596.955637,10.279054,177.4482359953,132.3078952596
172.30.15.199,50990,184.29.25.7,443,12,1423,6,904,6,519,3597.106094,9.929693,728.3206036682,418.1398156016
172.30.15.199,50991,184.29.25.7,443,32,19236,15,6162,17,13074,3597.151374,9.885697,4986.5983147166,10580.1341068817
172.30.15.199,50992,184.29.25.7,443,12,1423,6,904,6,519,3597.194595,9.843206,734.7199682705,421.8137870934
172.30.15.199,50993,157.240.16.39,443,283,241936,100,8413,183,233523,3606.914841,10.213733,6589.5593707021,182909.030420121
172.30.15.199,50994,184.29.25.7,443,91,52069,36,3960,55,48109,3606.990416,10.136281,3125.4066456918,37969.7445246435
172.30.15.199,50995,184.29.25.7,443,37,27317,15,4027,22,23290,3607.742974,9.385781,3432.4261348095,19851.3048621092
172.30.15.199,50996,184.29.25.7,443,69,55591,28,7385,41,48206,3607.744023,9.384831,6295.2651997677,41092.695222749
172.30.15.199,50997,162.247.242.19,443,23,6378,11,2552,12,3826,3608.265213,9.069083,2251.1647539228,3374.9828951836
172.30.15.199,50998,162.247.242.19,443,7,398,4,228,3,170,3608.517011,8.927403,204.3147374438,152.3399358134
172.30.15.199,50999,184.29.25.7,443,174,141511,73,33067,101,108444,3608.83206,8.297216,31882.5013112835,104559.408842678
172.30.15.199,51000,184.29.25.7,443,119,90744,52,24997,67,65747,3609.454998,7.671292,26068.0990894363,68564.2001373433
172.30.15.199,51001,184.29.25.7,443,86,68706,37,16999,49,51707,3609.470065,7.659112,17755.5831537655,54008.3497930321
172.30.15.199,51002,184.29.25.7,443,133,109630,54,25016,79,84614,3609.471119,7.656577,26138.0509854462,88409.2199425386
172.30.15.199,51003,184.29.25.7,443,73,55956,32,14284,41,41672,3609.548574,7.579467,15076.5218715247,43984.0954515666
172.30.15.199,51004,184.29.25.7,443,142,119939,59,30135,83,89804,3609.549616,7.57887,31809.4913885568,94794.0788006621
172.30.15.199,51005,184.29.25.7,443,127,104472,53,25039,74,79433,3609.559565,7.56856,26466.3291299792,83961.0176836791
172.30.15.199,51006,184.29.25.7,443,133,105335,53,22582,80,82753,3609.560694,7.568231,23870.3073413054,87474.0741925006
172.30.15.199,51007,184.29.25.7,443,91,68738,42,14985,49,53753,3609.561611,7.56678,15842.9345111128,56830.5144328227
172.30.15.199,51008,184.29.25.7,443,75,54519,35,19501,40,35018,3609.576196,7.552484,20656.5151280034,37092.9617328559
172.30.15.199,51009,184.29.25.7,443,7,402,4,228,3,174,3609.707298,7.419204,245.8484764673,187.621205725
172.30.15.199,51010,184.29.25.7,443,26,12405,12,3640,14,8765,3609.721467,7.406241,3931.8191238983,9467.6908299364
172.30.15.199,51011,184.29.25.7,443,94,72407,41,14806,53,57601,3609.722076,7.404218,15997.3679867338,62235.8769015164
172.30.15.199,51012,184.29.25.7,443,86,60647,40,22159,46,38488,3610.148023,6.981068,25393.2492850679,44105.5723852021
172.30.15.199,51013,157.240.16.20,443,144,123840,52,3795,92,120045,3611.506757,5.621463,5400.7293119247,170838.089657445
172.30.15.199,51014,184.29.25.7,443,27,13183,12,3640,15,9543,3611.847515,5.281504,5513.5809799632,14454.9734318102
172.30.15.199,51015,184.29.25.7,443,12,1423,6,904,6,519,3612.073336,5.054559,1430.7875326017,821.4366475888
172.30.15.199,51016,157.240.16.20,443,16,4988,8,1037,8,3951,3613.719844,0.271605,30544.3566944747,116374.882642111
172.30.15.199,51017,157.240.16.20,443,66,27749,34,4597,32,23152,3613.741923,3.386391,10859.9390914989,54694.2157594914
172.30.15.199,51018,111.221.29.13,443,27,7260,16,1929,11,5331,3614.828943,1.293175,11933.4196841127,32979.2951456739
172.30.15.199,51019,103.254.155.35,443,19,7605,10,1995,9,5610,3617.47946,9.602324,1662.0976338645,4673.8685343257
172.30.15.199,51020,184.29.25.7,443,24,5189,12,2125,12,3064,3617.920036,9.161472,1855.5970044988,2675.5525749573
172.30.15.199,51021,184.29.25.7,443,195,157221,82,24995,113,132226,3618.866922,8.213722,24344.6271982423,128785.464129417
172.30.15.199,51022,184.29.25.7,443,200,177979,73,26412,127,151567,3618.867829,8.213449,25725.6117375285,147628.115789111
172.30.15.199,51023,184.29.25.7,443,41,26794,17,6298,24,20496,3618.868723,8.212079,6135.352570281,19966.6856590154
172.30.15.199,51024,184.29.25.7,443,137,111987,53,22004,84,89983,3618.87762,8.202086,21461.8573860363,87765.9658774633
172.30.15.199,51025,184.29.25.7,443,112,91418,44,18839,68,72579,3618.881389,8.199832,18379.888758697,70810.2312340076
172.30.15.199,51026,184.29.25.7,443,107,82113,46,21688,61,60425,3618.882286,8.197277,21166.0530685989,58970.8021334419
172.30.15.199,51027,184.29.25.7,443,115,96279,43,16284,72,79995,3618.882982,8.197943,15890.8155375072,78063.484949821
172.30.15.199,51028,184.29.25.7,443,66,48801,29,9465,37,39336,3618.88491,8.196523,9238.0635057089,38392.8648769746
172.30.15.199,51029,184.29.25.7,443,18,4556,9,3555,9,1001,3618.892276,8.188795,3473.038462924,977.9216600245
172.30.15.199,51030,184.29.25.7,443,141,104211,61,19047,80,85164,3618.90116,8.179847,18628.2212858008,83291.5334479938
172.30.15.199,51031,184.29.25.7,443,80,58524,35,8732,45,49792,3619.377412,7.704169,9067.2984977353,51703.9540539668
172.30.15.199,51032,184.29.25.7,443,102,82891,40,17478,62,65413,3619.379613,7.657361,18260.0768071401,68339.9933736959
172.30.15.199,51033,184.29.25.7,443,38,23126,17,7803,21,15323,3619.400817,7.680826,8127.2508972345,15959.7418298505
172.30.15.199,51034,184.29.25.7,443,44,28054,20,4120,24,23934,3619.45241,7.584458,4345.7291213161,25245.3108712571
172.30.15.199,51035,184.29.25.7,443,74,59951,30,9390,44,50561,3619.506066,7.530118,9975.9392880694,53716.0241048006
172.30.15.199,51036,184.29.25.7,443,83,69422,34,10974,49,58448,3619.520421,7.514967,11682.2868284058,62220.3663702081
172.30.15.199,51037,184.29.25.7,443,78,57866,36,12256,42,45610,3619.631957,7.403794,13242.9400385805,49282.8406625047
172.30.15.199,51038,184.29.25.7,443,12,1423,6,904,6,519,3620.235033,6.801259,1063.3325388726,610.475207605
172.30.15.199,51039,157.240.16.39,443,33,7355,18,4620,15,2735,3622.154284,4.926873,7501.7155912078,4440.9506800765
172.30.15.199,51040,161.202.1.35,443,15,4222,9,3239,6,983,3623.565787,3.515936,7369.872489147,2236.6732500252
172.30.15.199,51041,54.201.247.66,443,26,5745,14,4583,12,1162,3623.584763,3.770792,9723.1563024419,2465.2645916294
172.30.15.199,51042,162.247.242.19,443,24,6217,12,2391,12,3826,3623.727612,3.505229,5456.9901139129,8732.0971040697
172.30.15.199,51043,161.202.1.35,443,6,348,4,228,2,120,3623.816732,3.314612,550.2906524202,289.6266591685
172.30.15.199,51044,54.201.247.66,443,6,348,4,228,2,120,3623.836322,3.545336,514.47874052,270.7782844842
172.30.15.199,51045,162.247.242.19,443,7,398,4,228,3,170,3623.978352,3.311217,550.8548669568,410.7251200994
172.30.15.199,51046,131.253.61.98,443,79,30387,33,7687,46,22700,3625.337252,66.700845,921.9673303989,2722.6041888975
172.30.15.199,51047,13.66.56.243,443,25,12316,15,7165,10,5151,3628.966506,2.402528,23858.202693167,17151.93329693
172.30.15.199,51048,162.247.242.19,443,32,12808,16,8555,16,4253,3631.731094,5.499404,12444.9849474605,6186.8522479894
172.30.15.199,51049,161.202.1.35,443,15,4540,9,3557,6,983,3632.575065,4.512746,6305.6950247146,1742.6196821182
172.30.15.199,51050,54.201.247.66,443,25,4500,14,3442,11,1058,3632.589959,4.71414,5841.1502416135,1795.4494351037
172.30.15.199,51051,184.29.25.7,443,170,151036,62,10730,108,140306,3632.701588,4.325852,19843.4897911443,259474.434169272
172.30.15.199,51052,184.29.25.7,443,534,506716,179,12931,355,493785,3632.702694,4.324872,23919.3206180429,913386.569590932
172.30.15.199,51053,54.201.247.66,443,6,348,4,228,2,120,3632.842358,4.45544,409.3871761262,215.4669348033
172.30.15.199,51054,103.254.155.35,443,15,7010,8,1965,7,5045,3632.943174,0.493831,31832.7525003346,81728.3645619279
172.30.15.199,51055,184.29.25.7,443,55,42144,22,4109,33,38035,3633.816594,3.210485,10238.9514356863,94776.9573755972
172.30.15.199,51057,184.29.25.7,443,18,3611,9,1546,9,2065,3635.669303,1.358667,9103.039964907,12158.9764084948
172.30.15.199,51058,104.122.123.186,443,15,2539,8,1448,7,1091,3635.779212,1.248295,9279.8577259391,6991.9370020716
172.30.15.199,51059,184.29.25.7,443,95,76937,38,18935,57,58002,3637.247944,9.923217,15265.2108686124,46760.642239306
172.30.15.199,51060,184.29.25.7,443,88,67685,37,7441,51,60244,3637.487083,9.691054,6142.5723146317,49731.6390972546
172.30.15.199,51061,184.29.25.7,443,102,81733,42,17670,60,64063,3637.516113,9.654971,14641.1625679664,53081.8787544782
172.30.15.199,51062,103.254.155.35,443,17,6752,9,1598,8,5154,3637.689101,9.487566,1347.4478069507,4345.8986214166
172.30.15.199,51063,184.29.25.7,443,18,6798,9,1829,9,4969,3637.739404,9.431447,1551.405632667,4214.8357510783
172.30.15.199,51064,184.29.25.7,443,112,69386,44,4672,68,64714,3637.741523,9.436872,3960.6344136066,54860.5512504581
172.30.15.199,51065,184.29.25.7,443,6,348,4,228,2,120,3637.755463,9.413402,193.7662919314,101.9822589113
172.30.15.199,51066,184.29.25.7,443,35,20130,16,6272,19,13858,3638.200943,8.96757,5595.2727438981,12362.7694012979
172.30.15.199,51067,184.29.25.7,443,33,22881,14,6140,19,16741,3638.209494,8.961924,5480.9659175866,14944.112447283
172.30.15.199,51068,184.29.25.7,443,32,20561,14,6140,18,14421,3638.213106,8.95846,5483.0852624224,12878.1062816603
172.30.15.199,51069,184.29.25.7,443,46,31230,20,8866,26,22364,3638.240309,8.928387,7944.1000933312,20038.5579164515
172.30.15.199,51070,184.29.25.7,443,13,1477,6,904,7,573,3638.242185,8.934142,809.4789628372,513.0878824178
172.30.15.199,51071,184.29.25.7,443,38,25746,17,6294,21,19452,3638.244763,8.92385,5642.4077051947,17438.2133272081
172.30.15.199,51072,184.29.25.7,443,30,16707,13,3684,17,13023,3638.248343,8.922989,3302.9290969653,11675.9081514057
172.30.15.199,51073,184.29.25.7,443,30,18091,13,3684,17,14407,3638.451624,8.719643,3379.9548903549,13217.9723412983
172.30.15.199,51074,157.240.16.39,443,282,242614,102,9606,180,233008,3638.572712,8.596274,8939.6871249102,216845.577514165
172.30.15.199,51075,184.29.25.7,443,26,14170,14,7621,12,6549,3638.771688,8.397357,7260.3796646966,6239.1059472639
172.30.15.199,51076,157.240.16.39,443,17,5552,9,1091,8,4461,3638.823981,8.167962,1068.5652063514,4369.2661645586
172.30.15.199,51077,184.29.25.7,443,13,1477,6,904,7,573,3638.841845,8.334587,867.7094617885,549.9972584124
172.30.15.199,51078,157.240.16.20,443,32,6992,16,2067,16,4925,3640.734606,6.515635,2537.8953854842,6046.9931173245
172.30.15.199,51079,162.247.242.19,443,29,8794,14,4631,15,4163,3640.901479,6.355953,5828.8662612831,5239.812188668
172.30.15.199,51080,184.29.25.7,443,28,17252,13,3902,15,13350,3640.907278,6.261839,4985.1169919893,17055.6924251811
172.30.15.199,51081,35.201.87.190,443,30,7428,15,2037,15,5391,3641.213244,5.957519,2735.3668532152,7239.2551328833
172.30.15.199,51082,184.29.24.149,443,37,22375,18,4368,19,18007,3641.244676,5.92261,5900.1014755318,24323.0602724134
172.30.15.199,51083,180.149.59.203,443,6853,6897334,2114,130478,4739,6766856,3641.408341,17.143038,60889.0909534232,3157832.81819707
172.30.15.199,51084,35.201.87.190,443,48,16791,22,4618,26,12173,3641.638316,5.530962,6679.4890292143,17607.0636536652
172.30.15.199,51085,52.84.108.56,443,26,8252,14,1877,12,6375,3641.65464,5.512554,2723.9642459739,9251.6100522554
172.30.15.199,51086,184.29.25.7,443,21,8671,10,3694,11,4977,3641.698229,5.473269,5399.3326474543,7274.6287456362
172.30.15.199,51087,52.84.101.37,443,18,2687,10,1578,8,1109,3641.758408,5.408825,2333.9634763558,1640.2823163996
172.30.15.199,51088,161.202.1.35,443,16,4041,9,2426,7,1615,3641.803919,5.372875,3612.2187841705,2404.6716143592
172.30.15.199,51089,161.202.1.35,443,15,4640,9,3657,6,983,3641.824449,5.352411,5465.9479625165,1469.2444208788
172.30.15.199,51090,161.202.1.35,443,16,4702,9,3665,7,1037,3641.845718,5.772686,5079.0914316145,1437.1126369943
172.30.15.199,51091,161.202.1.35,443,19,5903,11,4186,8,1717,3641.863774,5.312952,6303.0872479177,2585.3800297837
172.30.15.199,51092,161.202.1.35,443,17,4996,10,3959,7,1037,3641.870951,5.305653,5969.4819845923,1563.6152609301
172.30.15.199,51093,161.202.1.35,443,30,12760,18,10016,12,2744,3641.871633,5.305372,15103.1822085243,4137.692889396
172.30.15.199,51094,104.244.43.112,443,18,2551,10,1570,8,981,3642.114115,5.064873,2479.825259192,1549.4959103614
172.30.15.199,51095,13.107.21.200,443,30,10576,14,2526,16,8050,3642.254349,4.912795,4113.3407764825,13108.6275735091
172.30.15.199,51096,172.217.194.156,443,28,6686,14,2292,14,4394,3642.279667,4.896865,3744.4364915103,7178.4703070227
172.30.15.199,51097,54.171.197.251,443,15,3073,8,1937,7,1136,3642.337109,4.852273,3193.5548556316,1872.9366628795
172.30.15.199,51098,52.37.171.77,443,58,19545,31,13145,27,6400,3642.806308,4.628411,22720.5405915782,11062.1118133207
172.30.15.199,51099,52.37.171.77,443,16,5071,9,1153,7,3918,3643.052,3.935245,2343.9455484985,7964.942462287
172.30.15.199,51100,52.37.171.77,443,16,5071,9,1153,7,3918,3643.11195,3.875837,2379.8730441966,8087.0273956308
172.30.15.199,51101,52.37.171.77,443,15,5005,8,1087,7,3918,3643.127922,3.859627,2253.0674596277,8120.9920025955
172.30.15.199,51102,52.37.171.77,443,15,5005,8,1087,7,3918,3643.147406,3.840626,2264.2142192444,8161.1695593371
172.30.15.199,51103,52.37.171.77,443,15,5005,8,1087,7,3918,3643.15734,3.830893,2269.9668197468,8181.9043236137
172.30.15.199,51104,104.244.42.133,443,23,3491,12,1898,11,1593,3643.23598,3.951913,3842.1898457786,3224.7673468521
172.30.15.199,51105,104.244.42.195,443,23,3852,12,2184,11,1668,3643.253979,3.924923,4451.5522979686,3399.8119198771
172.30.15.199,51106,104.244.42.195,443,11,1376,7,958,4,418,3643.535683,3.453025,2219.5031892328,968.4262349679
172.30.15.199,51107,104.244.42.133,443,11,1376,7,958,4,418,3643.53607,3.455654,2217.8146307473,967.6894735411
172.30.15.199,51108,184.29.24.149,443,17,3375,9,2310,8,1065,3648.841904,8.226249,2246.4673753493,1035.7089847389
172.30.15.199,51109,184.29.24.149,443,8,480,5,294,3,186,3649.093889,7.974407,294.9435613206,186.5969469579
172.30.15.199,51110,103.254.155.35,443,20,7895,11,2743,9,5152,3653.74902,3.545286,6189.6275787067,11625.5783031341
172.30.15.199,51111,180.149.59.203,443,3445,3213424,1254,81720,2191,3131704,3657.928032,5.566838,117438.301599576,4500513.9362775
172.30.15.199,51112,180.149.59.203,443,10250,10169040,3300,226576,6950,9942464,3663.185751,23.870956,75933.6157295076,3332070.65523473
172.30.15.199,51113,52.37.171.77,443,36,5533,19,4120,17,1413,3672.787186,14.587789,2259.4239606838,774.8946738947
172.30.15.199,51114,52.37.171.77,443,13,810,8,492,5,318,3673.038058,4.696316,838.1037391862,541.7011972789
172.30.15.199,51115,180.149.59.203,443,15192,16014789,4163,240736,11029,15774053,3687.188703,50.378048,38228.7142209241,2504908.96352316
172.30.15.199,51116,162.247.242.19,443,43,20755,23,13583,20,7172,3700.916915,6.496959,16725.3633584572,8831.2085700402
172.30.15.199,51117,157.240.16.39,443,26,7667,14,5413,12,2254,3701.079186,6.295175,6878.919172223,2864.4160011437
172.30.15.199,51118,157.240.16.39,443,6,348,4,228,2,120,3701.095865,6.282487,290.3308832951,152.80572805
172.30.15.199,51119,162.247.242.19,443,7,398,4,228,3,170,3701.166716,6.247269,291.967578153,217.6951240614
172.30.15.199,51120,23.8.190.108,80,18,7196,9,735,9,6461,3712.23167,62.529856,94.0350798185,826.6131302142
172.30.15.199,51121,35.201.87.190,443,27,5173,15,3699,12,1474,3737.360929,9.763164,3030.9846275245,1207.805174634
172.30.15.199,51122,180.149.59.203,443,995,1011316,298,17174,697,994142,3737.568397,6.001116,22894.408306722,1325276.16529994
172.30.15.199,51123,161.202.1.35,443,11,1343,6,905,5,438,3743.325984,3.799453,1905.5374549968,922.2380168935
172.30.15.199,51124,184.29.24.149,443,12,1433,6,914,6,519,3743.356134,3.762185,1943.5514202518,1103.6139902743
172.30.15.199,51125,184.29.24.149,443,12,1433,6,914,6,519,3743.356661,3.73071,1959.9486424835,1112.9248856115
172.30.15.199,51126,162.247.242.19,443,24,7207,12,3381,12,3826,3743.387526,3.890034,6953.1525945531,7868.311690849
172.30.15.199,51127,54.218.8.216,443,15,5005,8,1087,7,3918,3743.440195,3.568481,2436.8912150578,8783.5692553784
172.30.15.199,51128,54.218.8.216,443,6,348,4,228,2,120,3743.602997,4.205366,433.7315705696,228.279773984
172.30.15.199,51129,162.247.242.19,443,7,398,4,228,3,170,3743.638901,3.665021,497.6779123503,371.0756364015
172.30.15.199,51130,172.25.10.63,7680,3,198,3,198,0,0,3744.872885,9.000619,175.9878959436,0
172.30.15.199,51131,157.240.16.52,443,25,6537,13,1690,12,4847,3748.201435,8.841797,1529.1009282389,4385.5338456651
172.30.15.199,51132,158.85.224.180,443,27,7583,13,2861,14,4722,3757.807963,1.568651,14590.8809544035,24081.8384714062
172.30.15.199,51133,158.85.224.180,443,7,402,4,228,3,174,3758.05677,9.245257,197.2903511498,150.5636890354
172.30.15.199,51134,52.229.175.79,443,28,10060,15,2210,13,7850,3797.816266,109.553904,161.3817431828,573.2337936583
172.30.15.199,51135,157.240.16.52,443,29,9917,15,1798,14,8119,3844.45383,2.654553,5418.6147347598,24468.1496282062
172.30.15.199,51136,52.6.46.142,443,17,6976,9,1165,8,5811,3860.854424,0.738235,12624.7062249859,62971.8179170756
172.30.15.199,51137,52.6.46.142,443,96,63893,44,4076,52,59817,3860.855529,6.470453,5039.5235078596,73957.1093399499
172.30.15.199,51138,52.6.46.142,443,6,348,4,228,2,120,3861.044722,6.280841,290.4069693852,152.8457733606
172.30.15.199,51139,104.16.124.127,443,30,9016,16,2262,14,6754,3861.704904,5.469152,3308.7396364192,9879.4109214744
172.30.15.199,51140,104.16.120.145,443,15,5566,8,1066,7,4500,3864.05218,0.142858,59695.6418262721,251998.488009591
172.30.15.199,51141,104.16.121.145,443,587,522338,212,13831,375,508507,3864.064781,3.110281,35574.9207225998,1307938.41456779
172.30.15.199,51142,104.16.121.145,443,16,5620,9,1120,7,4500,3864.107186,2.983485,3003.1992786962,12066.4256733327
172.30.15.199,51143,104.16.121.145,443,202,119443,90,7856,112,111587,3864.634834,2.541429,24729.3943682877,351257.501193243
172.30.15.199,51144,52.84.108.83,443,36,24025,16,1957,20,22068,3864.660009,2.481801,6308.3220612775,71135.4375310538
172.30.15.199,51145,104.16.90.50,443,30,9572,16,2029,14,7543,3864.707789,2.467668,6577.8702807677,24453.8568397392
172.30.15.199,51146,104.16.118.145,443,15,5566,8,1066,7,4500,3864.71594,0.124095,68721.5439783345,290100.326362575
172.30.15.199,51147,104.16.118.145,443,14,5500,7,1000,7,4500,3864.721154,0.131249,60952.8453550005,274287.804097502
172.30.15.199,51148,104.16.118.145,443,16,5620,8,1066,8,4554,3864.766881,0.172351,49480.4207691975,211382.585537454
172.30.15.199,51149,104.16.118.145,443,16,5620,8,1066,8,4554,3864.767967,0.165963,51384.9472473029,219518.808409209
172.30.15.199,51150,35.161.208.104,443,20,8092,9,2124,11,5968,3867.154309,10.265552,1655.244647341,4650.8945646567
172.30.15.199,51151,35.161.208.104,443,6,340,4,228,2,112,3867.224935,10.195014,178.9109853111,87.8860980475
172.30.15.199,51152,104.16.120.145,443,784,675729,296,19306,488,656423,3868.023142,9.16892,16844.7319858826,572737.46526308
172.30.15.199,51153,104.16.124.127,443,45,11194,23,2919,22,8275,3868.446917,8.738659,2672.2635589741,7575.5330423126
172.30.15.199,51154,104.16.124.127,443,84,31740,40,4481,44,27259,3868.888934,8.296986,4320.6050968389,26283.2792534547
172.30.15.199,51155,34.234.132.222,443,84,32290,46,17670,38,14620,3869.67324,7.674258,18420.0218444571,15240.5613676267
172.30.15.199,51156,34.234.132.222,443,6,348,4,228,2,120,3869.816029,7.531858,242.1713208082,127.4585898991
172.30.15.199,51157,52.6.46.142,443,60,35123,35,32848,25,2275,3872.872192,4.474971,58723.062115932,4067.0654625471
172.30.15.199,51158,35.161.208.104,443,15,2806,8,1990,7,816,3877.223938,10.227457,1556.5941758543,638.2818329131
172.30.15.199,51159,35.161.208.104,443,6,340,4,228,2,112,3877.477557,9.958052,183.1683546139,89.9774373542
172.30.15.199,51160,52.6.46.142,443,22,4193,12,2728,10,1465,3880.707644,6.655895,3278.8978792485,1760.8450854469
172.30.15.199,51161,52.6.46.142,443,22,4349,12,2884,10,1465,3887.222347,10.190451,2264.0803630772,1150.096300939
172.30.15.199,51162,35.161.208.104,443,15,2805,8,1989,7,816,3887.7307,9.766844,1629.1854359505,668.3837685951
172.30.15.199,51163,35.161.208.104,443,6,340,4,228,2,112,3887.99411,9.491498,192.1719838112,94.4002727494
172.30.15.199,51164,35.161.208.104,443,15,2813,8,1989,7,824,3898.237997,9.245221,1721.1054230073,713.0170279326
172.30.15.199,51165,52.6.46.142,443,37,9436,20,4473,17,4963,3898.333857,19.096084,1873.8920503283,2079.1697397226
172.30.15.199,51166,35.161.208.104,443,8,448,5,282,3,166,3898.503662,10.006667,225.4496926899,132.7115212288
172.30.15.199,51167,172.25.10.224,7680,3,198,3,198,0,0,3907.075856,9.033821,175.3410876749,0
172.30.15.199,51168,104.16.90.50,443,153,122712,63,5003,90,117709,3907.335927,9.857832,4060.1219416198,95525.2635670835
172.30.15.199,51169,104.31.84.161,443,6,348,4,228,2,120,3908.447527,8.832221,206.5165715396,108.6929323893
172.30.15.199,51170,104.31.84.161,443,121,61774,59,5423,62,56351,3908.550902,8.7354,4966.4583190237,51607.0242919613
172.30.15.199,51171,35.161.208.104,443,15,2805,8,1989,7,816,3908.742515,8.768903,1814.5941402248,744.4488780409
172.30.15.199,51172,35.161.208.104,443,6,348,4,228,2,120,3908.994127,8.502063,214.5361661046,112.913771634
172.30.15.199,51173,35.161.208.104,443,15,2813,8,1989,7,824,3919.248414,8.253589,1927.8885827729,798.6828517873
172.30.15.199,51174,35.161.208.104,443,6,348,4,228,2,120,3919.511266,7.991016,228.2563318607,120.1349115056
172.30.15.199,51175,52.6.46.142,443,23,4414,13,2949,10,1465,3923.328729,4.122135,5723.2477830056,2843.1868437108
172.30.15.199,51176,52.6.46.142,443,6,348,4,228,2,120,3923.590273,3.85216,473.5005814919,249.2108323642
172.30.15.199,51177,54.201.241.25,443,21,8165,11,2238,10,5927,3929.874909,7.67783,2331.9088857138,6175.7032911642
172.30.15.199,51178,54.201.241.25,443,6,348,4,228,2,120,3930.019467,7.530508,242.2147350484,127.4814394992
172.30.15.199,51179,52.6.46.142,443,23,4419,14,3008,9,1411,3937.620737,9.84223,2444.9743604855,1146.8945554006
172.30.15.199,51180,52.6.46.142,443,7,402,4,228,3,174,3937.885313,9.591916,190.1601306767,145.1222049901
172.30.15.199,51181,184.29.26.80,80,13,2851,8,878,5,1973,3943.048782,60.772861,115.5779057366,259.7211936427
172.30.15.199,51182,54.201.241.25,443,15,2813,8,1989,7,824,3950.786759,6.845428,2324.4711652799,962.9785018555
172.30.15.199,51183,54.201.241.25,443,6,348,4,228,2,120,3951.049166,6.590864,276.7467209155,145.6561689029
172.30.15.199,51184,52.6.46.142,443,25,5004,14,3473,11,1531,3953.626207,3.894275,7134.5757554357,3145.1297096378
172.30.15.199,51185,52.6.46.142,443,6,348,4,228,2,120,3953.877853,3.612062,504.9747208104,265.7761688476
172.30.15.199,51186,54.201.241.25,443,15,2805,8,1989,7,816,3961.608915,5.955872,2671.6490884962,1096.0611645113
172.30.15.199,51187,54.201.241.25,443,6,348,4,228,2,120,3961.872846,5.682672,320.9757663296,168.9346138577
172.30.15.199,51188,54.86.233.56,443,6,348,4,228,2,120,3965.294194,2.166527,841.9004240428,443.1054863383
172.30.15.199,51189,54.86.233.56,443,75,28578,37,4563,38,24015,3965.294979,12.176908,2997.8053541999,15777.4042474489
172.30.15.199,51190,54.86.233.56,443,16,4806,9,1153,7,3653,3965.376495,1.819419,5069.7502884165,16062.2704280879
172.30.15.199,51191,52.84.108.203,443,1738,1529241,688,45348,1050,1483893,3967.450168,19.803295,18319.3756392558,599452.969821431
172.30.15.199,51192,52.84.108.203,443,18,6927,10,1219,8,5708,3967.450608,0.409439,23817.9557882847,111528.212993871
172.30.15.199,51193,52.84.108.203,443,20,7844,11,1285,9,6559,3967.451001,0.407928,25200.5255829408,128630.542644754
172.30.15.199,51194,52.84.110.171,443,8,480,5,294,3,186,3967.463273,9.828357,239.3075465207,151.3986518805
172.30.15.199,51195,52.84.110.171,443,68,48055,28,2603,40,45452,3967.543899,9.748107,2136.2096251097,37301.1908876243
172.30.15.199,51196,52.84.108.203,443,8,480,5,294,3,186,3967.675049,9.616464,244.5805443664,154.7346301094
172.30.15.199,51197,52.26.114.97,443,70,56872,28,2919,42,53953,3967.715062,5.821631,4011.2470199504,74141.4218798847
172.30.15.199,51198,52.26.114.97,443,7,402,4,228,3,174,3967.776649,3.835538,475.5525821931,362.9217074632
172.30.15.199,51199,52.6.46.142,443,24,4968,13,3437,11,1531,3968.590307,8.881457,3095.8884336208,1379.0530089827
172.30.15.199,51200,52.6.46.142,443,6,348,4,228,2,120,3968.841296,8.630935,211.3328393737,111.2278101967
172.30.15.199,51201,52.26.114.97,443,141,109635,63,4922,78,104713,3971.232658,5.490779,7171.2957305327,152565.601347271
172.30.15.199,51202,23.57.208.237,443,51,36318,21,2222,30,34096,3974.677766,2.668393,6661.6873901249,102221.824146579
172.30.15.199,51203,23.57.208.237,443,9,546,6,360,3,186,3974.683063,12.588179,228.7860698517,118.2061360901
172.30.15.199,51204,52.84.108.203,443,111,90581,41,3651,70,86930,3976.724288,10.529585,2773.8984964744,66046.2876742042
172.30.15.199,51205,52.84.108.203,443,17,6849,8,1087,9,5762,3976.976389,0.31461,27640.5708655246,146517.911064538
172.30.15.199,51206,52.218.208.200,443,33,7695,16,1965,17,5730,3977.620528,7.958359,1975.2815875735,5759.9814233058
172.30.15.199,51207,52.218.208.200,443,7,409,4,228,3,181,3977.839214,9.722768,187.6008971931,148.9287824208
172.30.15.199,51208,104.113.220.53,443,28,9497,15,1876,13,7621,3982.714391,4.538665,3306.6992166198,13433.0249093069
172.30.15.199,51209,54.86.233.56,443,18,2911,10,1971,8,940,3983.610528,3.878388,4065.6066386348,1938.9498936158
172.30.15.199,51210,23.57.219.27,80,12,3028,7,637,5,2391,3983.706276,117.737143,43.282857645,162.463599104
172.30.15.199,51211,52.204.146.6,443,6,348,4,228,2,120,3983.851887,3.633661,501.9730789416,264.1963573377
172.30.15.199,51212,52.204.146.6,443,26,6455,14,1940,12,4515,3983.852438,3.616292,4291.6888348616,9988.1314893815
172.30.15.199,51213,54.86.233.56,443,6,348,4,228,2,120,3983.861385,3.606054,505.8160526714,266.2189750902
172.30.15.199,51214,52.204.146.6,443,16,4806,8,1099,8,3707,3983.871256,0.899085,9778.8307001005,32984.645500703
172.30.15.199,51215,184.29.26.86,443,15,2697,8,1797,7,900,3984.828643,2.397571,5996.0685210157,3003.0393260513
172.30.15.199,51216,205.185.216.42,443,26,8805,12,1682,14,7123,3984.829154,2.567346,5241.2101835908,22195.6837917461
172.30.15.199,51217,52.204.146.6,443,29,7814,16,3516,13,4298,3984.835291,2.63318,10682.1409854234,13057.9755276876
172.30.15.199,51218,157.240.16.39,443,24,3316,13,1777,11,1539,3984.846028,2.423105,5866.8526539299,5081.0839810907
172.30.15.199,51219,151.101.2.2,443,44,15773,21,3091,23,12682,3984.915637,2.363637,10461.8433371964,42923.6807513181
172.30.15.199,51220,52.86.72.168,443,22,7929,11,2023,11,5906,3984.931731,2.517801,6427.8312702236,18765.5815531095
172.30.15.199,51221,34.255.159.221,443,18,5698,9,1507,9,4191,3984.936099,2.443274,4934.3626625581,13722.5706163112
172.30.15.199,51222,204.79.197.200,443,31,11775,14,2290,17,9485,3984.937436,2.315175,7913.0087358416,32775.0602006367
172.30.15.199,51223,34.255.159.221,443,6,348,4,228,2,120,3985.063432,2.385943,764.4776090627,402.3566363488
172.30.15.199,51224,52.86.72.168,443,6,340,4,228,2,112,3985.119959,2.348676,776.6077568809,381.4915296959
172.30.15.199,51225,52.204.146.6,443,16,4806,9,1153,7,3653,3985.138275,2.059513,4478.7287091654,14189.7623370175
172.30.15.199,51226,64.74.232.52,443,19,6870,11,2082,8,4788,3985.151948,2.35412,7075.2552970963,16271.0482048496
172.30.15.199,51227,13.56.57.63,443,23,9526,12,2143,11,7383,3985.18248,2.354687,7280.79783003,25083.5886043452
172.30.15.199,51228,64.74.232.52,443,7,402,4,228,3,174,3985.306781,2.228616,818.445169558,624.6028925574
172.30.15.199,51229,13.56.57.63,443,6,348,4,228,2,120,3985.318953,2.216936,822.7571747672,433.0300919828
172.30.15.199,51230,205.185.216.42,443,115,94587,42,3334,73,91253,3985.591634,1.793889,14868.2555052177,406950.485788132
172.30.15.199,51231,205.185.216.10,443,25,8417,11,1744,14,6673,3985.624088,1.772847,7869.8274583191,30112.0175627082
172.30.15.199,51232,18.207.56.96,443,39,13419,21,3886,18,9533,3986.823517,9.574473,3246.9672221123,7965.3470222329
172.30.15.199,51233,35.189.139.118,443,28,13466,15,2072,13,11394,3986.823929,10.552745,1570.7761345508,8637.7525468492
172.30.15.199,51234,54.169.69.65,443,27,8448,15,2399,12,6049,3987.707229,9.597202,1999.7495103261,5042.3029545487
172.30.15.199,51235,144.2.1.5,443,30,7115,15,2714,15,4401,3991.507341,5.729542,3789.4826497476,6144.9937883342
172.30.15.199,51236,52.84.108.203,443,72,44034,30,3186,42,40848,3991.509713,5.704231,4468.2622425353,57288.0025370625
172.30.15.199,51237,34.201.201.2,443,19,5522,11,1790,8,3732,3991.665176,5.535711,2586.8402450923,5393.3451366952
172.30.15.199,51238,34.201.201.2,443,19,5522,11,1790,8,3732,3991.665708,5.534409,2587.4488134145,5394.6139506496
172.30.15.199,51239,34.201.201.2,443,11,1407,7,964,4,443,3991.666173,5.534355,1393.4776500605,640.3636918846
172.30.15.199,51240,34.201.201.2,443,16,4819,9,1153,7,3666,3991.666642,5.532969,1667.0977191451,5300.5899725809
172.30.15.199,51241,34.201.201.2,443,11,1407,7,964,4,443,3991.667088,5.533256,1393.7544187365,640.4908791497
172.30.15.199,51242,34.201.201.2,443,70,15783,40,7245,30,8538,3991.667547,5.775856,10034.8762157502,11825.7795900725
172.30.15.199,51243,34.201.201.2,443,36,8918,22,2985,14,5933,3991.667981,5.784894,4127.9926650342,8204.8175817916
172.30.15.199,51244,34.201.201.2,443,11,1403,7,960,4,443,3991.668401,5.531482,1388.4163412264,640.6962907951
172.30.15.199,51245,34.201.201.2,443,19,5522,11,1790,8,3732,3991.668851,5.531848,2588.6466873276,5397.111417378
172.30.15.199,51246,34.201.201.2,443,14,4699,8,1087,6,3612,3991.669269,5.529864,1572.552236366,5225.4449657351
172.30.15.199,51247,34.201.201.2,443,19,5522,11,1790,8,3732,3991.669727,5.531351,2588.8792810291,5397.5963557546
172.30.15.199,51248,34.201.201.2,443,15,4765,9,1153,6,3612,3991.670146,5.528558,1668.4278251219,5226.6793619602
172.30.15.199,51249,52.6.46.142,443,22,4314,12,2849,10,1465,3993.591153,3.863415,5899.4438857846,3033.5855713143
172.30.15.199,51250,52.6.46.142,443,6,348,4,228,2,120,3993.841882,3.61299,504.8450175617,265.7079039798
172.30.15.199,51251,52.6.46.142,443,22,4314,12,2849,10,1465,4026.5918,10.87558,2095.7043210569,1077.643675096
172.30.15.199,51252,52.6.46.142,443,6,348,4,228,2,120,4026.84378,0.670213,2721.5228591513,1432.3804521849
172.30.15.199,51253,52.204.146.6,443,29,7115,16,5768,13,1347,4027.128685,10.332365,4465.9668914136,1042.9364429151
172.30.15.199,51254,52.204.146.6,443,6,348,4,228,2,120,4027.380124,10.087504,180.8177721664,95.1672485086
172.30.15.199,51255,18.215.97.76,443,29,7560,15,2746,14,4814,4027.389696,10.077568,2179.8910213259,3821.5569470731
172.30.15.199,51256,172.217.166.206,443,16,5627,7,1165,9,4462,4027.434768,0.3844,24245.5775234185,92861.6024974193
172.30.15.199,51257,172.217.166.206,443,42,21135,18,2919,24,18216,4027.435994,9.858654,2368.6803492647,14781.7338959252
172.30.15.199,51258,18.215.97.76,443,6,348,4,228,2,120,4027.63286,9.828581,185.581214623,97.6743234858
172.30.15.199,51259,52.86.72.168,443,15,2636,8,1866,7,770,4028.422347,9.038519,1651.5980106919,681.5275821183
172.30.15.199,51260,151.101.130.2,443,19,3004,10,1905,9,1099,4028.431982,8.825552,1726.8041704361,996.1983114484
172.30.15.199,51261,64.74.232.52,443,15,2781,9,1956,6,825,4028.432981,8.786311,1780.9522107742,751.1684938081
172.30.15.199,51262,52.84.108.203,443,40,11337,18,2611,22,8726,4028.530903,8.704743,2399.6113383243,8019.5360161694
172.30.15.199,51263,34.205.118.138,443,25,6328,13,1898,12,4430,4028.583983,8.8775,1710.3914390313,3992.114897212
172.30.15.199,51264,52.86.72.168,443,6,340,4,228,2,112,4028.674284,8.7871,207.577016308,101.9676571338
172.30.15.199,51265,64.74.232.52,443,7,402,4,228,3,174,4028.684093,8.819165,206.8223012042,157.8380719717
172.30.15.199,51266,34.205.118.138,443,6,348,4,228,2,120,4028.704543,8.756447,208.303664717,109.6335077458
172.30.15.199,51267,34.205.118.138,443,25,6841,13,2351,12,4490,4029.621788,7.839736,2399.0603765229,4581.7869377235
172.30.15.199,51268,34.205.118.138,443,6,348,4,228,2,120,4029.873503,7.588059,240.3776776116,126.514567164
172.30.15.199,51269,172.217.166.193,443,16,5642,8,1054,8,4588,4038.651111,3.5689,2362.6327439829,10284.4013561609
172.30.15.199,51270,184.29.26.80,80,12,2524,7,617,5,1907,4050.821717,60.222638,81.9625337568,253.3266643019
172.30.15.199,51271,54.236.156.42,443,24,7055,12,2374,12,4681,4073.166621,4.392125,4324.1027976204,8526.168995645
172.30.15.199,51272,54.236.156.42,443,6,348,4,228,2,120,4073.403525,4.1373,440.8672322529,232.0353853963
172.30.15.199,51273,34.205.118.138,443,38,8194,20,3188,18,5006,4074.017387,3.522139,7241.0543706534,11370.3632934414
172.30.15.199,51274,35.171.73.174,443,49,12733,27,5869,22,6864,4075.60369,6.963838,6742.2590818453,7885.3069241414
172.30.15.199,51275,35.171.73.174,443,16,4819,9,1153,7,3666,4075.706839,1.540999,5985.7274404468,19031.8098843693
172.30.15.199,51276,35.171.73.174,443,15,4753,8,1087,7,3666,4075.850459,1.39764,6221.9169457079,20983.9443633533
172.30.15.199,51277,18.215.97.76,443,69,24348,34,5750,35,18598,4076.273187,6.294318,7308.1785826516,23637.8270052443
172.30.15.199,51278,52.207.90.113,443,16,4806,8,1099,8,3707,4076.366044,1.088169,8079.627337297,27253.1196900455
172.30.15.199,51279,52.26.114.97,443,149,115347,66,5559,83,109788,4076.450569,5.499582,8086.4327507074,159703.773850451
172.30.15.199,51280,13.107.21.200,443,20,10027,9,1120,11,8907,4076.463695,0.783225,11439.8799834001,90977.6884037004
172.30.15.199,51281,52.207.90.113,443,29,7899,15,3482,14,4417,4076.479376,6.088105,4575.4795621953,5804.1048897807
172.30.15.199,51282,157.240.16.39,443,15,4922,8,1025,7,3897,4076.492752,0.756083,10845.3701511641,41233.5682722794
172.30.15.199,51283,104.113.220.53,443,16,7052,9,1141,7,5911,4076.504465,0.744592,12259.0626813072,63508.6060553958
172.30.15.199,51284,18.215.97.76,443,6,348,4,228,2,120,4076.524134,1.034806,1762.6492308701,927.7101215106
172.30.15.199,51285,52.207.90.113,443,6,348,4,228,2,120,4076.531666,1.0272,1775.7009345795,934.5794392523
172.30.15.199,51286,64.74.232.52,443,16,5553,10,1219,6,4334,4076.588012,5.979869,1630.8049557608,5798.1203267164
172.30.15.199,51287,151.101.194.2,443,20,9062,11,1240,9,7822,4076.620192,0.628154,15792.3057084729,99618.8832674798
172.30.15.199,51288,151.101.2.2,443,29,15140,16,1582,13,13558,4076.622469,0.626124,20213.2484939121,173230.861618496
172.30.15.199,51289,52.26.114.97,443,6,348,4,228,2,120,4076.702449,0.934855,1951.1047167743,1026.8972193549
172.30.15.199,51290,35.200.76.2,443,19,7814,10,1219,9,6595,4076.766243,5.650814,1725.7690661912,9336.7079503943
172.30.15.199,51291,35.172.175.129,443,26,13120,14,1483,12,11637,4076.76812,5.480682,2164.6941019385,16986.2071910032
172.30.15.199,51292,52.84.108.203,443,17,6849,9,1141,8,5708,4076.769469,0.47811,19091.8407897758,95509.4016021387
172.30.15.199,51293,52.52.93.212,443,17,6436,8,1087,9,5349,4076.778384,5.789408,1502.0534051151,7391.4293136712
172.30.15.199,51294,64.74.232.52,443,6,348,4,228,2,120,4076.839208,0.797889,2286.0322676464,1203.1748777087
172.30.15.199,51295,52.84.110.163,443,20,7621,11,1285,9,6336,4076.905643,0.341655,30088.8323016156,148360.187908978
172.30.15.199,51296,35.200.76.2,443,6,348,4,228,2,120,4077.019188,5.411737,337.0452037858,177.3922125188
172.30.15.199,51297,35.172.175.129,443,6,348,4,228,2,120,4077.019814,5.547524,328.7953328368,173.0501751773
172.30.15.199,51298,52.52.93.212,443,6,348,4,228,2,120,4077.035844,5.532061,329.7143686594,173.5338782418
172.30.15.199,51299,52.218.248.232,443,26,6008,12,1339,14,4669,4077.201499,5.442089,1968.3617816614,6863.5408204458
172.30.15.199,51300,184.29.26.86,443,16,5516,10,1219,6,4297,4077.23056,5.017372,1943.6469928878,6851.3955114347
172.30.15.199,51301,23.57.208.237,443,23,7902,12,1363,11,6539,4077.232815,5.09364,2140.7088054908,10270.0622737373
172.30.15.199,51302,52.218.248.232,443,7,409,4,228,3,181,4077.453902,5.189998,351.4452221369,278.9981807315
172.30.15.199,51303,151.101.66.2,443,22,9336,12,1294,10,8042,4077.455764,4.792564,2160.0128866301,13424.1295473562
172.30.15.199,51304,205.185.216.10,443,21,6415,10,1195,11,5220,4077.457298,4.973218,1922.2965894517,8396.9775706593
172.30.15.199,51305,205.185.216.42,443,21,6415,10,1195,11,5220,4077.466847,4.963785,1925.9496533392,8412.9348873895
172.30.15.199,51306,34.255.159.221,443,16,4989,8,1087,8,3902,4077.468095,4.981118,1745.7928119753,6266.8661934935
172.30.15.199,51307,54.169.69.65,443,17,6427,9,1153,8,5274,4077.499504,4.749511,1942.0946703777,8883.4408426468
172.30.15.199,51308,52.86.72.168,443,19,6781,9,1141,10,5640,4077.500813,5.066592,1801.6054973443,8905.3943952864
172.30.15.199,51309,151.101.65.2,443,15,5470,9,1120,6,4350,4077.510839,4.736881,1891.5400239103,7346.606342866
172.30.15.199,51310,184.29.26.27,443,16,5710,10,1219,6,4491,4077.54143,4.708017,2071.3604050283,7631.2383748828
172.30.15.199,51311,52.86.72.168,443,6,348,4,228,2,120,4077.751642,4.815812,378.7523267104,199.3433298476
172.30.15.199,51312,52.84.108.11,443,49,32940,23,2497,26,30443,4078.386619,3.924242,5090.4098167238,62061.4121147465
172.30.15.199,51313,104.113.220.53,443,17,7130,10,1219,7,5911,4079.550936,2.699325,3612.755040612,17518.4536874957
172.30.15.199,51314,13.107.21.200,443,21,10081,10,1174,11,8907,4079.55227,2.695913,3483.7919472921,26431.1199953409
172.30.15.199,51315,157.240.16.39,443,16,4988,9,1091,7,3897,4079.553446,2.696666,3236.5891808623,11560.9422894777
172.30.15.199,51316,151.101.194.2,443,20,9062,11,1240,9,7822,4079.554609,2.695087,3680.7717153472,23218.5454495527
172.30.15.199,51317,151.101.2.2,443,26,13574,14,1450,12,12124,4079.555481,2.694371,4305.2719911251,35998.0121520007
172.30.15.199,51318,52.84.108.203,443,35,11353,17,2361,18,8992,4079.55865,3.009199,6276.7533818799,23905.3648495823
172.30.15.199,51319,52.84.110.163,443,19,7543,10,1207,9,6336,4079.559512,2.688968,3590.9687285229,18850.3544854356
172.30.15.199,51320,52.26.114.97,443,138,105860,62,4846,76,101014,4081.567077,5.680959,6824.1999282166,142249.222358413
172.30.15.199,51321,52.26.114.97,443,6,348,4,228,2,120,4081.819156,0.824491,2212.273996927,1164.3547352247
172.30.15.199,51322,52.84.110.163,443,30,8921,15,1935,15,6986,4085.515883,2.13803,7240.3100050044,26139.9512635455
172.30.15.199,51323,52.84.108.203,443,26,8483,13,1828,13,6655,4085.806261,1.668231,8766.1720708961,31914.0454769221
172.30.15.199,51324,104.113.220.53,443,26,9417,13,1864,13,7553,4088.240413,9.319929,1600.0121889341,6483.3111926069
172.30.15.199,51325,52.207.90.113,443,25,6462,12,1893,13,4569,4089.220048,8.396516,1803.6052095894,4353.2341271071
172.30.15.199,51326,52.7.89.176,443,23,6736,12,2586,11,4150,4089.278167,8.338309,2481.0785975909,3981.6226527464
172.30.15.199,51327,34.205.118.138,443,23,6214,12,1867,11,4347,4089.31425,8.302405,1798.9967967113,4188.6658143033
172.30.15.199,51328,52.7.89.176,443,6,348,4,228,2,120,4089.42513,8.167978,223.3110813962,117.5321481032
172.30.15.199,51329,52.84.108.91,443,20,3049,10,1594,10,1455,4089.47653,8.084198,1577.398277479,1439.8459810113
172.30.15.199,51330,34.205.118.138,443,6,348,4,228,2,120,4089.47948,8.113774,224.8029092257,118.3173206451
172.30.15.199,51331,52.207.90.113,443,16,4806,9,1153,7,3653,4089.523932,7.749283,1190.3036706751,3771.1876053565
172.30.15.199,51332,34.196.221.221,443,6,348,4,228,2,120,4089.8702,7.722863,236.1818408536,124.3062320282
172.30.15.199,51333,34.196.221.221,443,26,8961,13,2478,13,6483,4089.875679,7.717744,2568.6262721334,6720.0985158357
172.30.15.199,51334,52.218.248.232,443,32,7862,15,2098,17,5764,4090.051845,7.565098,2218.6097258753,6095.3605624144
172.30.15.199,51335,52.207.90.113,443,30,8458,16,4077,14,4381,4090.22157,7.395122,4410.4749049444,4739.3403381314
172.30.15.199,51336,52.218.248.232,443,7,409,4,228,3,181,4090.304323,7.338638,248.5474825165,197.3118172609
172.30.15.199,51337,205.185.216.10,443,23,7323,11,1753,12,5570,4090.439781,7.153015,1960.5718707427,6229.540969787
172.30.15.199,51338,52.207.90.113,443,16,4806,9,1153,7,3653,4090.472253,6.801785,1356.1146081507,4296.5192225278
172.30.15.199,51339,52.52.93.212,443,22,8442,12,1918,10,6524,4090.515193,7.078652,2167.6443481047,7373.1552278596
172.30.15.199,51340,52.207.90.113,443,6,348,4,228,2,120,4090.537382,7.056141,258.4982357921,136.0517030485
172.30.15.199,51341,184.29.26.86,443,22,8140,12,2095,10,6045,4090.542653,6.81602,2458.9129726733,7095.049603728
172.30.15.199,51342,172.217.166.198,443,27,7322,13,2338,14,4984,4090.559454,7.000812,2671.6900839502,5695.3393406363
172.30.15.199,51343,34.196.221.221,443,19,7120,11,1285,8,5835,4090.575975,7.017175,1464.9770028538,6652.2496588732
172.30.15.199,51344,157.240.16.39,443,44,10164,21,4298,23,5866,4090.57771,6.781151,5070.5256379045,6920.359095381
172.30.15.199,51345,205.185.216.10,443,6,348,4,228,2,120,4090.691115,6.900913,264.3128525168,139.1120276404
172.30.15.199,51346,184.29.26.86,443,6,348,4,228,2,120,4090.692621,6.666184,273.6198100743,144.0104263549
172.30.15.199,51347,144.2.1.5,443,29,8209,14,2133,15,6076,4090.703869,6.65528,2563.9792766045,7303.6746763473
172.30.15.199,51348,34.205.118.138,443,24,6983,13,2659,11,4324,4090.72054,6.896074,3084.6536739601,5016.1874713063
172.30.15.199,51349,34.192.10.179,443,23,9171,11,2821,12,6350,4090.759516,6.833956,3302.3332312941,7433.4689892653
172.30.15.199,51350,52.52.93.212,443,6,348,4,228,2,120,4090.767233,6.826761,267.1838079581,140.6230568201
172.30.15.199,51351,34.192.10.179,443,6,348,4,228,2,120,4090.827195,6.766496,269.563449088,141.87549952
172.30.15.199,51352,151.101.194.2,443,58,19338,29,4466,29,14872,4090.889058,6.70361,5329.6656577575,17748.0491854388
172.30.15.199,51353,64.74.232.52,443,20,7146,11,2275,9,4871,4090.890069,6.704645,2714.5359672288,5812.089976427
172.30.15.199,51354,52.86.72.168,443,21,8067,10,2161,11,5906,4090.894467,6.698737,2580.7850046958,7053.2698925189
172.30.15.199,51355,52.86.72.168,443,21,9025,10,3119,11,5906,4090.895258,6.698039,3725.2694408018,7054.0049109893
172.30.15.199,51356,13.107.21.200,443,30,10494,14,2444,16,8050,4090.902156,6.657993,2936.6206903493,9672.5845160849
172.30.15.199,51357,157.240.16.20,443,49,24884,23,2267,26,22617,4090.96157,6.713436,2701.4482598775,26951.3256698936
172.30.15.199,51358,34.205.118.138,443,6,348,4,228,2,120,4090.971872,6.621512,275.465784854,144.9819920284
172.30.15.199,51359,151.101.2.2,443,27,13659,13,1396,14,12263,4091.023556,0.315315,35418.5497042833,311130.139701738
172.30.15.199,51360,64.74.232.52,443,6,348,4,228,2,120,4091.140818,6.45324,282.6487159938,148.762482102
172.30.15.199,51361,52.86.72.168,443,6,340,4,228,2,112,4091.145635,6.44812,282.8731475221,138.9552303617
172.30.15.199,51362,35.172.175.129,443,27,10939,14,2434,13,8505,4093.292808,4.300755,4527.5771347122,15820.4780323447
172.30.15.199,51363,35.200.76.2,443,20,8864,10,1816,10,7048,4093.294237,4.297751,3380.3726646797,13119.4199012458
172.30.15.199,51364,35.172.175.129,443,6,348,4,228,2,120,4093.543924,4.049421,450.4347658591,237.0709293995
172.30.15.199,51365,54.246.156.84,443,25,6449,13,1992,12,4457,4094.167617,3.426011,4651.4736817839,10407.4388552765
172.30.15.199,51366,54.246.156.84,443,6,348,4,228,2,120,4094.356261,3.23676,563.5264894525,296.5928891855
172.30.15.199,51367,52.69.95.24,443,24,7853,11,1943,13,5910,4094.378667,3.214295,4835.897140742,14709.2908398275
172.30.15.199,51368,52.69.95.24,443,6,340,4,228,2,112,4094.564199,3.028704,602.2377888364,295.8361067969
172.30.15.199,51369,144.2.1.5,443,27,6712,14,2431,13,4281,4095.888919,1.703023,11419.6930986837,20110.1218245434
172.30.15.199,51370,54.236.156.42,443,28,6980,14,2058,14,4922,4103.72266,3.799656,4333.023831632,10363.0433912986
172.30.15.199,51371,157.240.16.39,443,22,3963,11,2640,11,1323,4103.831744,3.499478,6035.1858191426,3024.4510752749
172.30.15.199,51372,52.84.108.91,443,63,41310,30,2777,33,38533,4103.856399,3.454409,6431.2014008765,89237.8406841822
172.30.15.199,51373,54.236.156.42,443,16,4806,9,1153,7,3653,4104.266929,3.030493,3043.7291886179,9643.315460556
172.30.15.199,51374,54.236.156.42,443,37,10822,19,6006,18,4816,4104.555088,2.970614,16174.4339722369,12969.7092924231
172.30.15.199,51375,54.236.156.42,443,16,4806,9,1153,7,3653,4104.821684,2.476118,3725.1859564036,11802.3454455701
172.30.15.199,51376,54.236.156.42,443,6,348,4,228,2,120,4104.867953,2.670441,683.0332518112,359.4911851638
172.30.15.199,51377,157.240.16.39,443,24,4148,13,2825,11,1323,4113.355086,3.987954,5667.0663703741,2653.9924984089
172.30.15.199,51378,54.236.156.42,443,19,2842,10,1679,9,1163,4120.526594,7.072671,1899.141074143,1315.4860448054
172.30.15.199,51379,52.207.90.113,443,41,8639,22,6550,19,2089,4120.530512,7.046217,7436.6145692078,2371.769135126
172.30.15.199,51380,157.240.16.39,443,27,5046,13,3360,14,1686,4120.559106,6.799141,3953.4405890389,1983.780009857
172.30.15.199,51381,52.207.90.113,443,6,348,4,228,2,120,4120.785428,6.79541,268.4164752384,141.2718290729
172.30.15.199,51382,54.236.156.42,443,28,6231,15,3241,13,2990,4121.368247,6.211472,4174.211845437,3850.9390366728
172.30.15.199,51383,54.85.199.48,443,24,5974,13,1819,11,4155,4122.405067,5.194566,2801.388989956,6398.9946417081
172.30.15.199,51384,54.85.199.48,443,30,7091,16,2560,14,4531,4122.405607,5.17441,3957.9391660108,7005.2431098418
172.30.15.199,51385,52.7.89.176,443,24,4652,13,3019,11,1633,4122.430573,5.146043,4693.3148440456,2538.6495993132
172.30.15.199,51386,35.171.73.174,443,43,10404,24,4647,19,5757,4122.447102,5.152478,7215.1690895139,8938.6116738393
172.30.15.199,51387,54.85.199.48,443,6,348,4,228,2,120,4122.585667,4.991128,365.4484517328,192.3412903857
172.30.15.199,51388,54.85.199.48,443,6,348,4,228,2,120,4122.591717,4.98545,365.8646661786,192.5603506203
172.30.15.199,51389,52.7.89.176,443,6,348,4,228,2,120,4122.682342,4.916749,370.9768385573,195.2509676618
172.30.15.199,51390,35.171.73.174,443,6,348,4,228,2,120,4122.698697,4.882422,373.5850772424,196.6237248644
172.30.15.199,51391,34.205.118.138,443,32,5703,17,3377,15,2326,4122.828144,4.769894,5663.8575196849,3901.1349099162
172.30.15.199,51392,34.205.118.138,443,6,348,4,228,2,120,4123.079856,4.496998,405.6039162126,213.475745375
172.30.15.199,51393,151.101.194.2,443,21,3235,10,1991,11,1244,4123.331528,4.037335,3945.1767069119,2464.9923773975
172.30.15.199,51394,64.74.232.52,443,13,2764,8,2024,5,740,4123.334783,4.313092,3754.1513141853,1372.5652038029
172.30.15.199,51395,52.86.72.168,443,15,2758,8,1988,7,770,4123.33573,4.263442,3730.3193053872,1444.841984481
172.30.15.199,51396,52.84.108.91,443,22,3663,11,2170,11,1493,4123.361408,3.9855,4355.7897377988,2996.8636306606
172.30.15.199,51397,64.74.232.52,443,6,348,4,228,2,120,4123.58668,4.060917,449.1596356193,236.3998082207
172.30.15.199,51398,52.86.72.168,443,7,394,4,228,3,166,4123.58725,4.011732,454.6664632632,331.0290916741
172.30.15.199,51399,52.229.168.53,443,29,10122,16,2272,13,7850,4127.908271,82.440898,220.4730957686,761.7578352919
172.30.15.199,51400,35.171.73.174,443,18,2492,10,1560,8,932,4129.968009,7.579487,1646.5494300604,983.7077364207
172.30.15.199,51401,157.240.16.39,443,37,6811,18,4654,19,2157,4140.909819,6.965605,5345.1207755828,2477.3153229334
172.30.15.199,51402,52.84.108.91,443,32,6966,17,2404,15,4562,4140.927226,6.450041,2981.6864730007,5658.2586064181
172.30.15.199,51403,54.236.156.42,443,19,2847,10,1684,9,1163,4140.948592,6.74833,1996.3457625812,1378.7114738016
172.30.15.199,51404,52.204.146.6,443,29,8638,16,4311,13,4327,4141.036891,6.662043,5176.790362956,5196.0036883579
172.30.15.199,51405,54.236.156.42,443,6,348,4,228,2,120,4141.171897,6.526693,279.4677181844,147.0882727286
172.30.15.199,51406,52.204.146.6,443,6,348,4,228,2,120,4141.175359,6.515587,279.9440787146,147.3389887972
172.30.15.199,51407,54.236.156.42,443,22,3707,12,2673,10,1034,4141.758391,5.940158,3599.9042449716,1392.5555515528
172.30.15.199,51408,54.236.156.42,443,6,348,4,228,2,120,4142.009917,5.667822,321.816740187,169.3772316774
172.30.15.199,51409,52.7.89.176,443,24,4744,13,3090,11,1654,4144.842329,2.856303,8654.5440032111,4632.5617415246
172.30.15.199,51410,52.7.89.176,443,6,348,4,228,2,120,4145.095054,2.59982,701.5870329486,369.2563331308
172.30.15.199,51411,34.196.221.221,443,18,2503,9,1640,9,863,4146.074291,1.556593,8428.6643971789,4435.3276675399
172.30.15.199,51412,64.74.232.52,443,8,468,5,294,3,174,4146.107365,11.613869,202.5164912744,119.8566989175
172.30.15.199,51413,34.205.118.138,443,20,3782,11,2543,9,1239,4146.127088,1.571411,12946.3265816526,6307.7068952684
172.30.15.199,51414,151.101.66.2,443,20,3192,10,2002,10,1190,4146.22526,1.170611,13681.74397815,8132.5051618374
172.30.15.199,51415,52.86.72.168,443,16,2836,8,2004,8,832,4146.228337,1.469965,10906.3821247428,4527.9989659611
172.30.15.199,51416,52.30.52.254,443,22,7990,11,1828,11,6162,4146.269085,11.364068,1286.8631197913,4337.8832298435
172.30.15.199,51417,34.196.221.221,443,6,348,4,228,2,120,4146.325469,1.370895,1330.517654525,700.27244975
172.30.15.199,51418,64.74.232.52,443,14,2864,9,2093,5,771,4146.356419,10.968665,1526.5303480414,562.3291439751
172.30.15.199,51419,52.86.72.168,443,6,340,4,228,2,112,4146.357088,1.341338,1359.8362232336,667.9897236937
172.30.15.199,51420,34.205.118.138,443,6,348,4,228,2,120,4146.378205,1.31768,1384.2511080079,728.553214741
172.30.15.199,51421,52.30.52.254,443,6,348,4,228,2,120,4146.440366,1.179748,1546.0928944141,813.7331023232
172.30.15.199,51422,52.7.89.176,443,18,3786,10,2359,8,1427,4177.843414,9.787177,1928.2373252266,1166.4241895288
172.30.15.199,51423,54.71.19.12,443,21,6680,12,1315,9,5365,4177.993764,9.355327,1124.4930294793,4587.7605347199
172.30.15.199,51424,157.240.16.39,443,12,1688,7,971,5,717,4178.00307,9.351637,830.6567074833,613.3685471324
172.30.15.199,51425,151.101.66.2,443,13,1479,6,904,7,575,4178.034147,9.595148,753.7142730889,479.4089679492
172.30.15.199,51426,151.101.66.2,443,20,9062,11,1240,9,7822,4178.04421,9.310067,1065.5132771869,6721.3264952871
172.30.15.199,51427,64.74.232.52,443,12,1412,7,958,5,454,4178.04529,9.303619,823.7654615908,390.3857197935
172.30.15.199,51428,52.7.89.176,443,6,348,4,228,2,120,4178.063324,9.566798,190.6594034911,100.347054469
172.30.15.199,51429,204.79.197.200,443,21,10081,10,1174,11,8907,4178.088444,9.261048,1014.1400843619,7694.1616110831
172.30.15.199,51430,35.200.76.2,443,11,1323,6,904,5,419,4178.091037,9.538612,758.181588684,351.4138115692
172.30.15.199,51431,104.113.220.53,443,17,7130,10,1219,7,5911,4178.125279,9.222682,1057.3930663553,5127.3588311944
172.30.15.199,51432,104.113.220.53,443,13,1517,6,904,7,613,4178.126305,9.495138,761.6529638642,516.4748527088
172.30.15.199,51433,34.192.10.179,443,12,1416,6,904,6,512,4178.173098,9.456785,764.7419286788,433.1281719951
172.30.15.199,51434,54.165.220.76,443,23,8823,11,1249,12,7574,4178.221533,9.131177,1094.2729507926,6635.7272452389
172.30.15.199,51435,54.71.19.12,443,7,402,4,228,3,174,4178.24466,3.924197,464.8084690958,354.722252731
172.30.15.199,51436,13.56.57.63,443,19,6556,10,1207,9,5349,4178.284351,9.387436,1028.6088768009,4558.4332079601
172.30.15.199,51437,64.74.232.52,443,7,402,4,228,3,174,4178.296553,9.3756,194.5475489569,148.4704978881
172.30.15.199,51438,157.240.16.20,443,12,1688,7,971,5,717,4178.304644,9.046024,858.7198088353,634.0907342275
172.30.15.199,51439,52.84.108.238,443,11,1407,7,960,4,447,4178.309226,9.043283,849.2491056622,395.431614824
172.30.15.199,51440,34.192.10.179,443,6,348,4,228,2,120,4178.425093,9.204925,198.1547921357,104.2919958609
172.30.15.199,51441,52.218.208.184,443,27,6062,13,1393,14,4669,4178.4321,9.239566,1206.1172570227,4042.6141227845
172.30.15.199,51442,52.84.110.163,443,11,1405,7,958,4,447,4178.438866,8.911444,860.0177479655,401.2817675789
172.30.15.199,51443,144.2.1.5,443,12,1482,7,962,5,520,4178.493347,8.858916,868.7293118029,469.5834117854
172.30.15.199,51444,13.56.57.63,443,6,348,4,228,2,120,4178.53593,9.135962,199.6505677235,105.0792461702
172.30.15.199,51445,184.29.26.86,443,14,1562,6,904,8,658,4178.561074,9.150494,790.3398439473,575.2694881829
172.30.15.199,51446,205.185.216.10,443,12,1423,6,904,6,519,4178.563531,9.06597,797.7083533256,457.9763665664
172.30.15.199,51447,52.86.72.168,443,19,6781,9,1141,10,5640,4178.564827,9.065126,1006.9358109309,4977.3163660387
172.30.15.199,51448,54.229.135.68,443,15,5019,8,1087,7,3932,4178.574739,8.778326,990.6216743374,3583.3711347697
172.30.15.199,51449,54.250.131.33,443,19,6682,9,1141,10,5541,4178.578816,9.050908,1008.5175984553,4897.6301604214
172.30.15.199,51450,151.101.129.2,443,14,5404,8,1054,6,4350,4178.596497,8.75178,963.4611473324,3976.3339572066
172.30.15.199,51451,184.29.26.86,443,16,5516,10,1219,6,4297,4178.604278,8.744409,1115.2268838294,3931.197637256
172.30.15.199,51452,34.197.5.59,443,18,7030,9,1141,9,5889,4178.608658,9.02115,1011.8443879107,5222.3940406713
172.30.15.199,51453,151.101.130.2,443,26,13574,14,1450,12,12124,4178.624891,8.724946,1329.5211225377,11116.6304066532
172.30.15.199,51454,205.185.216.10,443,21,6415,10,1195,11,5220,4178.63728,8.992297,1063.1321452128,4643.9747263687
172.30.15.199,51455,52.218.208.184,443,7,409,4,228,3,181,4178.68447,8.999147,202.6858767837,160.9041390256
172.30.15.199,51456,184.29.26.27,443,16,5710,10,1219,6,4491,4178.813848,8.539771,1141.9509961098,4207.1385754954
172.30.15.199,51457,23.57.208.237,443,25,8010,12,1363,13,6647,4178.856445,8.772724,1242.9434688702,6061.5152146589
172.30.15.199,51458,52.20.111.213,443,15,4740,8,1087,7,3653,4178.924971,8.424311,1032.2505899889,3469.0077325019
172.30.15.199,51459,52.6.46.142,443,148,102448,75,38671,73,63777,4178.980995,18.64774,16590.106897672,27360.7418378844
172.30.15.199,51460,104.16.123.127,443,41,11690,21,2825,20,8865,4179.023729,8.695501,2599.0451844005,8155.9417910479
172.30.15.199,51461,52.20.111.213,443,6,348,4,228,2,120,4179.175065,8.455007,215.730158473,113.54218867
172.30.15.199,51462,104.16.120.145,443,65,22279,32,3494,33,18785,4181.846591,5.782063,4834.2607128289,25990.7233802207
172.30.15.199,51463,52.229.170.171,443,30,10152,17,2303,13,7849,4182.472821,79.334533,232.2317823438,791.4838296206
172.30.15.199,51464,104.16.120.145,443,90,24333,47,7066,43,17267,4182.986272,14.446115,3913.0243667589,9562.1556383846
172.30.15.199,51465,52.42.237.125,443,20,8138,10,2211,10,5927,4184.825191,2.834442,6240.3817047582,16728.5130547723
172.30.15.199,51466,52.42.237.125,443,6,348,4,228,2,120,4185.029693,2.656818,686.5355474106,361.3344986372
172.30.15.199,51467,104.16.123.127,443,49,11403,26,3093,23,8310,4188.606732,8.835878,2800.4008203826,7523.8702933654
172.30.15.199,51468,34.234.132.222,443,87,33311,47,18377,40,14934,4188.906622,8.717947,16863.6033231234,13704.1438769943
172.30.15.199,51469,34.234.132.222,443,6,348,4,228,2,120,4188.982059,8.604398,211.9846153095,111.5708501629
172.30.15.199,51470,104.16.123.127,443,98,35444,48,4993,50,30451,4189.210247,8.251979,4840.5358278301,29521.1609239444
172.30.15.199,51471,52.42.237.125,443,15,2798,8,1974,7,824,4195.268915,2.417959,6531.1281125932,2726.2662435546
172.30.15.199,51472,52.42.237.125,443,6,348,4,228,2,120,4195.532963,2.142143,851.4837711581,448.1493532411
172.30.15.199,51473,13.107.21.200,443,167,99635,66,11433,101,88202,4227.846618,9.592734,9534.7165886173,73557.3403786601
172.30.15.199,51474,104.24.0.12,443,27,8246,14,1888,13,6358,4227.994014,9.519944,1586.5639545779,5342.8885716136
172.30.15.199,51475,104.24.0.12,443,6,348,4,228,2,120,4228.067631,9.429699,193.431412816,101.8060067453
172.30.15.199,51476,162.125.82.3,443,6,348,4,228,2,120,4235.097933,0.272391,6696.2564842346,3524.3455180182
172.30.15.199,51477,162.125.248.4,443,6,348,4,228,2,120,4235.245142,0.171254,10650.8461116322,5605.7084798064
172.30.15.199,51478,13.107.21.200,443,50,16109,24,4470,26,11639,4242.176061,5.282728,6769.2298373112,17625.7418515581
172.30.15.199,51479,31.24.224.56,443,592,487172,242,17790,350,469382,4244.21561,14.146638,10060.3408385793,265438.049662397
172.30.15.199,51480,31.24.224.56,443,22,8235,11,1252,11,6983,4244.216545,0.958495,10449.7154393101,58283.0374702094
172.30.15.199,51481,104.19.198.151,443,32,12945,15,1810,17,11135,4245.545614,1.948986,7429.5043679111,45705.8183075634
172.30.15.199,51482,52.84.108.186,443,127,102997,49,3868,78,99129,4245.573631,1.901568,16272.8863758731,417041.094507221
172.30.15.199,51483,52.84.108.186,443,18,6927,9,1165,9,5762,4245.574163,0.277337,33605.3249296548,166209.34098255
172.30.15.199,51484,52.84.108.186,443,17,6861,8,1099,9,5762,4245.574628,0.252531,34815.5275985795,182536.00548045
172.30.15.199,51485,52.84.108.186,443,43,12317,21,2435,22,9882,4248.358402,9.79266,1989.2450059534,8072.9852767276
172.30.15.199,51486,104.19.198.151,443,261,184398,106,10661,155,173737,4248.99143,9.159964,9310.9536238348,151735.967521263
172.30.15.199,51487,77.88.21.119,443,141,114031,54,6614,87,107417,4250.981144,17.314448,3055.9449541793,49631.1519720407
172.30.15.199,51488,77.88.21.119,443,6,348,4,228,2,120,4251.091923,7.270424,250.8794535229,132.0418176436
172.30.15.199,51489,172.217.166.202,443,19,4908,10,1351,9,3557,4255.380926,2.769904,3901.9402838513,10273.2802292074
172.30.15.199,51490,172.217.166.202,443,8,480,5,294,3,186,4255.633657,2.517309,934.3310654354,591.1074087449
172.30.15.199,51491,77.88.21.119,443,14,3595,8,2330,6,1265,4261.685669,6.604143,2822.4706824188,1532.3714219999
172.30.15.199,51492,31.24.224.56,443,21,3925,12,1763,9,2162,4261.691304,6.442087,2189.3526119718,2684.8442127527
172.30.15.199,51493,77.88.21.119,443,11,1342,6,904,5,438,4261.921073,6.360266,1137.0593619827,550.920354589
172.30.15.199,51494,31.24.224.56,443,7,402,4,228,3,174,4261.943333,6.305151,289.2872827312,220.7718736633
172.30.15.199,51495,77.88.21.119,443,387,278952,196,266646,191,12306,4271.592888,6.130802,347942.732451662,16057.9317355226
172.30.15.199,51496,180.149.59.77,443,22,7678,11,1922,11,5756,4274.141378,3.43725,4473.3435158921,13396.7561277186
172.30.15.199,51497,180.149.59.77,443,26,9310,14,2120,12,7190,4274.141769,3.436961,4934.5919258317,16735.7150692121
172.30.15.199,51498,180.149.59.77,443,6,348,4,228,2,120,4274.39337,3.185446,572.6042758219,301.3706714852
172.30.15.199,51499,77.88.21.119,443,31,12757,17,8875,14,3882,4277.669911,10.171882,6980.0259185078,3053.1223228898
172.30.15.199,51500,77.88.21.119,443,17,3504,9,2378,8,1126,4277.920851,9.920512,1917.6429603634,908.0176507019
172.30.15.199,51501,31.24.224.56,443,18,7708,8,1066,10,6642,4282.253143,1.162679,7334.7845794065,45701.3500716869
172.30.15.199,51502,77.88.21.119,443,33,16654,18,7165,15,9489,4282.280055,5.561397,10306.7628511335,13649.8077731201
172.30.15.199,51503,31.24.224.56,443,56,29256,26,3137,30,26119,4282.504925,5.317451,4719.5545384434,39295.5196014038
172.30.15.199,51504,31.24.224.56,443,19,7774,10,1186,9,6588,4282.612086,0.792452,11972.9649240633,66507.498245977
172.30.15.199,51505,31.24.224.56,443,6,348,4,228,2,120,4282.642711,5.198313,350.8830653329,184.6752975437
172.30.15.199,51506,77.88.21.119,443,16,7859,8,1087,8,6772,4282.777295,4.638011,1874.9416506343,11680.8692346784
172.30.15.199,51507,77.88.21.119,443,16,7860,8,1087,8,6773,4282.786511,4.628486,1878.8001087182,11706.6358200078
172.30.15.199,51508,52.84.108.186,443,30,10778,15,1889,15,8889,4286.878429,10.612378,1423.9975244003,6700.8544173607
172.30.15.199,51509,52.84.108.186,443,6,348,4,228,2,120,4287.129241,0.511187,3568.1658571125,1877.9820300592
172.30.15.199,51510,52.114.6.46,443,29,11951,16,6964,13,4987,4290.31646,2.192661,25408.3964643868,18195.2431315188
172.30.15.199,51511,77.88.21.119,443,74,41037,38,36061,36,4976,4290.538984,7.124299,40493.5278544594,5587.6374644017
172.30.15.199,51512,77.88.21.119,443,102,57525,57,46673,45,10852,4299.155813,19.801295,18856.5444835812,4384.359709807
172.30.15.199,51513,77.88.21.119,443,73,32326,39,24734,34,7592,4299.258593,19.699657,10044.4388447981,3083.0993656387
172.30.15.199,51514,77.88.21.119,443,6,348,4,228,2,120,4299.406894,8.269939,220.5578541752,116.0830811448
172.30.15.199,51515,77.88.21.119,443,11,1342,6,904,5,438,4311.281338,7.235617,999.5001117389,484.2710718381
172.30.15.199,51516,77.88.21.119,443,11,1342,6,904,5,438,4311.912659,6.604711,1094.9759951647,530.5304047369
172.30.15.199,51517,77.88.21.119,443,11,1342,6,904,5,438,4312.129589,6.387553,1132.2019558978,548.566876862
172.30.15.199,51520,111.221.29.253,443,32,8420,18,2184,14,6236,4405.057024,2.291691,7624.0645008412,21769.0779428781
172.30.15.199,51522,104.24.0.12,443,27,9585,15,1939,12,7646,4432.726231,4.963033,3125.5081318218,12324.7215966527
172.30.15.199,51523,13.107.21.200,443,121,91993,46,3947,75,88046,4432.810291,5.360387,5890.6194646014,131402.452845274
172.30.15.199,51524,104.24.0.12,443,6,348,4,228,2,120,4432.976309,6.866214,265.6485801345,139.8150421761
172.30.15.199,51525,52.175.23.79,443,28,10082,15,2233,13,7849,4438.537806,70.632136,252.9160381048,889.0004402529
172.30.15.199,51526,13.107.21.200,443,28,10527,15,1492,13,9035,4438.554584,8.934262,1335.980520831,8090.2037571768
172.30.15.199,51527,13.107.21.200,443,31,14854,15,1504,16,13350,4438.805747,8.682353,1385.7994486058,12300.8129247923
172.30.15.199,51528,13.107.21.200,443,25,13006,13,1372,12,11634,4438.861765,8.626845,1272.3075469652,10788.6486890622
172.30.15.199,51529,13.107.21.200,443,26,10443,14,1470,12,8973,4438.95327,8.535813,1377.7246525902,8409.7437467288
172.30.15.199,51530,13.107.21.200,443,25,11614,12,1306,13,10308,4438.953916,8.534446,1224.2153737923,9662.490101877
172.30.15.199,51531,13.107.21.200,443,142,68024,72,14826,70,53198,4438.967824,8.623025,13754.801824186,49354.3739001112
172.30.15.199,51532,104.121.244.70,443,408,341053,172,20725,236,320328,4442.213665,15.60783,10622.8732629713,164188.359304273
172.30.15.199,51533,104.121.244.70,443,447,385248,185,18802,262,366446,4442.214829,15.605891,9638.4115459988,187850.088149403
172.30.15.199,51534,104.121.244.70,443,153,115281,68,13266,85,102015,4442.268101,15.553715,6823.3216308773,52471.0655942969
172.30.15.199,51535,104.121.244.70,443,147,119236,62,13228,85,106008,4443.55098,14.270644,7415.5027621738,59427.1709111368
172.30.15.199,51536,104.121.244.70,443,107,85171,42,6769,65,78402,4443.552403,14.268483,3795.2177537021,43958.1418711413
172.30.15.199,51537,104.121.244.70,443,697,592094,292,50301,405,541793,4443.553296,24.482115,16436.8152016279,177041.240105278
172.30.15.199,51538,184.29.25.145,443,22,8958,12,2228,10,6730,4444.840264,2.751407,6478.1400934146,19568.170030826
172.30.15.199,51539,184.29.25.145,443,6,348,4,228,2,120,4445.055295,2.535976,719.2497089877,378.5524784146
172.30.15.199,51541,52.220.171.90,443,24,8020,13,3208,11,4812,4449.300618,8.749855,2933.0771767075,4399.6157650612
172.30.15.199,51542,52.220.171.90,443,9,510,5,282,4,228,4449.356023,8.849424,254.9318464117,206.1151098648
172.30.15.199,51543,117.18.237.29,80,15,3128,9,1204,6,1924,4450.205434,91.235024,105.5734911628,168.7071403631
172.30.15.199,51545,184.29.25.145,443,25,11670,11,2316,14,9354,4457.300022,10.371738,1786.3929844738,7214.9913543903
172.30.15.199,51546,184.29.25.145,443,6,348,4,228,2,120,4457.550769,10.120899,180.2211443865,94.8532338876
172.30.15.199,51547,104.121.244.70,443,222,180797,89,19438,133,161359,4457.919067,10.496528,14814.8035236024,122980.856145949
172.30.15.199,51548,104.121.244.70,443,240,182356,107,21084,133,161272,4457.924394,10.20062,16535.4654913124,126480.155127819
172.30.15.199,51549,104.121.244.70,443,301,222961,143,26689,158,196272,4457.925738,10.73325,19892.5768057201,146290.825239323
172.30.15.199,51550,104.121.244.70,443,77,54218,36,11160,41,43058,4457.928717,10.286181,8679.60616287,33488.0360359191
172.30.15.199,51551,104.121.244.70,443,339,258282,160,29246,179,229036,4457.930046,10.367126,22568.260480293,176740.207459632
172.30.15.199,51552,87.250.251.119,443,14,3021,8,1921,6,1100,4459.172924,8.579188,1791.311718545,1025.7381001559
172.30.15.199,51553,87.250.251.119,443,6,348,4,228,2,120,4459.351809,8.399891,217.1456748665,114.2871972982
172.30.15.199,51554,52.220.171.90,443,19,4974,10,3557,9,1417,4462.403592,15.347697,1854.0892486996,738.6124445902
172.30.15.199,51555,52.220.171.90,443,6,348,4,228,2,120,4462.655324,5.016546,363.5967855174,191.3667292197
172.30.15.199,51556,192.168.1.44,7680,2,132,2,132,0,0,4463.398528,3.001114,351.8693391853,0
172.30.15.199,51557,52.220.171.90,443,19,5271,10,3842,9,1429,4467.81949,9.912995,3100.5765664159,1153.2337098929
172.30.15.199,51558,184.29.25.145,443,80,59956,31,8263,49,51693,4467.820517,9.838751,6718.7389944108,42032.1644485149
172.30.15.199,51559,184.29.25.145,443,63,42355,28,5194,35,37161,4468.137704,9.527373,4361.3281436552,31203.5647182075
172.30.15.199,51560,184.29.25.145,443,126,91288,58,8437,68,82851,4468.145411,9.441622,7148.77168351,70200.649845974
172.30.15.199,51561,104.121.244.70,443,13,2006,7,1475,6,531,4468.148438,9.58339,1231.297067113,443.2669441607
172.30.15.199,51562,104.121.244.70,443,94,83257,33,7869,61,75388,4468.149779,9.582584,6569.41801919,62937.5124705418
172.30.15.199,51563,104.121.244.70,443,188,154148,78,9073,110,145075,4468.150884,9.580842,7575.9520927282,121137.57851345
172.30.15.199,51564,104.121.244.70,443,26,12981,14,6195,12,6786,4468.153314,9.565026,5181.3764019041,5675.6772015046
172.30.15.199,51565,104.121.244.70,443,115,82739,55,7627,60,75112,4468.154465,9.577454,6370.7954118076,62740.6824402379
172.30.15.199,51566,184.29.25.145,443,80,57299,35,4287,45,53012,4468.15533,9.538538,3595.5195649477,44461.3210116654
172.30.15.199,51567,184.29.25.145,443,63,52109,22,2945,41,49164,4469.371312,8.258292,2852.8901617915,47626.3130439106
172.30.15.199,51568,184.29.25.145,443,42,30135,16,2609,26,27526,4469.372275,8.325855,2506.8896828013,26448.6950589457
172.30.15.199,51569,192.168.45.1,7680,3,198,3,198,0,0,4473.439529,9.000964,175.9811504634,0
172.30.15.199,51570,52.220.171.90,443,37,16045,21,11278,16,4767,4478.975529,8.657898,10421.005190868,4404.7642972928
172.30.15.199,51571,104.121.244.70,443,96,81021,37,6668,59,74353,4486.371457,1.206104,44228.3584168578,493178.034398414
172.30.15.199,51572,104.121.244.70,443,43,25943,20,11247,23,14696,4486.376987,1.198818,75053.9281191501,98069.9322165048
172.30.15.199,51573,184.29.25.145,443,12,1423,6,904,6,519,4486.378191,1.182289,6116.9477175192,3511.831709505
172.30.15.199,51574,104.121.244.70,443,16,4057,9,3088,7,969,4486.764523,0.844992,29235.7797470177,9174.0513519625
172.30.15.199,51575,104.121.244.70,443,87,76878,30,4225,57,72653,4486.765633,0.81066,41694.4218291218,716976.290923358
172.30.15.199,51576,104.121.244.70,443,31,18723,14,3350,17,15373,4486.767124,0.808553,33145.6317644051,152103.82003409
172.30.15.199,51577,104.121.244.70,443,48,35853,19,3623,29,32230,4486.768759,0.80776,35881.9451321909,319203.723878143
172.30.15.199,51578,104.121.244.70,443,267,220685,114,19364,153,201321,4487.527781,20.053779,7724.8283228813,80312.4438540991
172.30.15.199,51579,104.121.244.70,443,215,176191,92,21142,123,155049,4487.731662,22.954336,7368.3682246353,54037.3722855678
172.30.15.199,51580,104.121.244.70,443,147,111958,67,12164,80,99794,4487.736156,29.843182,3260.7782910013,26751.5709283283
172.30.15.199,51581,104.121.244.70,443,237,209955,90,17578,147,192377,4487.743252,20.940974,6715.2559379521,73493.0476490727
172.30.15.199,51582,104.121.244.70,443,365,316365,143,23588,222,292777,4487.747472,19.836025,9513.196318315,118078.899376263
172.30.15.199,51583,104.121.244.70,443,244,193563,108,23020,136,170543,4487.748431,20.569519,8953.0533018299,66328.4348068626
172.30.15.199,51584,52.220.171.90,443,54,29357,28,20251,26,9106,4488.295892,19.333249,8379.760691025,3768.0164363475
172.30.15.199,51586,52.220.171.90,443,16,4298,9,2989,7,1309,4508.423066,9.203564,2598.1239441592,1137.8200879573
172.30.15.199,51587,146.185.29.13,443,28,11364,14,2069,14,9295,4527.45691,10.416228,1589.0589184492,7138.8606316989
172.30.15.199,51588,52.84.108.223,443,20,3626,11,1589,9,2037,4527.483239,10.254395,1239.6635783974,1589.172252483
172.30.15.199,51589,146.185.29.13,443,6,348,4,228,2,120,4527.616296,10.256981,177.8301041993,93.5947916838
172.30.15.199,51591,87.250.251.119,443,20,5968,12,4580,8,1388,4532.008697,5.905625,6204.2544184576,1880.2412953754
172.30.15.199,51592,13.107.21.200,443,55,17885,26,8636,29,9249,4536.810096,10.745686,6429.370819136,6885.7400076643
172.30.15.199,51593,146.185.29.13,443,108,83660,45,4589,63,79071,4537.856294,19.856059,1848.9066737765,31857.6813253833
172.30.15.199,51594,52.84.108.223,443,11,1408,7,961,4,447,4537.864497,9.643868,797.1905048887,370.8055730336
172.30.15.199,51595,104.19.199.151,443,17,7057,9,1091,8,5966,4537.941557,9.566407,912.3592588105,4989.1249661444
172.30.15.199,51596,87.250.251.119,443,11,1342,6,904,5,438,4538.026079,9.707764,744.9707265237,360.9482059927
172.30.15.199,51597,87.250.251.119,443,6,348,4,228,2,120,4538.278356,9.473402,192.5390688583,101.3363520307
172.30.15.199,51598,104.121.241.30,443,22,9010,11,1074,11,7936,4541.727779,60.500112,142.0162660195,1049.3864870862
172.30.15.199,51599,87.250.251.119,443,476,345315,243,329488,233,15827,4560.415687,17.340802,152005.887616957,7301.6230737192
172.30.15.199,51600,146.185.29.13,443,40,18929,20,2344,20,16585,4560.509135,8.590696,2182.8266301123,15444.6158960807
172.30.15.199,51601,104.19.199.151,443,65,28318,33,3167,32,25151,4560.930195,8.028462,3155.7725502094,25061.8362520735
172.30.15.199,51602,87.250.251.119,443,15,1582,8,1012,7,570,4566.534178,3.028961,2672.8637311606,1505.466726049
172.30.15.199,51605,162.125.34.137,443,26,8297,12,3242,14,5055,4639.597024,65.642512,395.1098032324,616.0641749968
172.30.15.199,51606,172.30.30.101,7680,3,198,3,198,0,0,4648.756897,9.006477,175.8734297551,0
172.30.15.199,51609,52.6.78.241,443,52,32886,30,28217,22,4669,4726.838545,1.990519,113405.599243215,18764.9552704601
172.30.15.199,51612,13.107.5.88,443,40,10461,20,2878,20,7583,4796.198933,126.795109,181.5842912363,478.4411676321
172.30.15.199,51613,52.175.39.99,443,24,5843,14,1353,10,4490,4798.363551,127.494194,84.8979836682,281.7383197858
172.30.15.199,51614,104.121.255.145,443,19,2594,10,1458,9,1136,4801.18793,109.982479,106.0532559918,82.6313434888
172.30.15.199,51615,40.77.224.11,443,27,11950,16,1905,11,10045,4801.917246,109.448377,139.2437276617,734.2274248617
172.30.15.199,51617,52.175.39.99,443,22,6331,12,1832,10,4499,4834.652281,0.809014,18115.8793296444,44488.723310082
172.30.15.199,51619,52.229.175.79,443,31,10258,17,2354,14,7904,4891.598648,115.778697,162.6551385355,546.1453759494
172.30.15.199,51621,162.125.82.3,443,6,348,4,228,2,120,4917.605024,0.33203,5493.479504871,2891.3050025637
172.30.15.199,51622,74.125.68.188,5228,40,7282,20,1930,20,5352,4920.613133,542.285874,28.4720674837,78.9546658927
172.30.15.199,51623,172.217.166.196,443,18,3297,9,1424,9,1873,4923.37695,1.162985,9795.4831747621,12884.0870690515
172.30.15.199,51624,172.217.166.196,443,19,3127,10,1478,9,1649,4923.377452,1.20651,9800.1674250526,10934.0162949335
172.30.15.199,51625,172.217.166.196,443,19,3287,10,1478,9,1809,4923.377827,1.169386,10111.2891722701,12375.7253806743
172.30.15.199,51626,172.217.166.196,443,19,3207,10,1478,9,1729,4923.378194,1.231639,9600.2156476003,11230.5635011508
172.30.15.199,51627,172.217.166.196,443,19,3223,10,1478,9,1745,4923.378657,1.311881,9013.0126131893,10641.209073082
172.30.15.199,51628,172.217.166.196,443,18,3185,9,1424,9,1761,4923.379013,1.173232,9709.92949391,12007.8552238592
172.30.15.199,51629,172.217.166.196,443,16,3125,8,1370,8,1755,4925.465208,0.198568,55195.1976147269,70706.2567984275
172.30.15.199,51631,34.192.34.151,443,45,27526,27,23081,18,4445,4962.887623,1.91817,96262.5836082935,18538.5028438484
172.30.15.199,51632,172.25.10.63,7680,3,198,3,198,0,0,4976.331873,9.001899,175.962871834,0
172.30.15.199,51633,192.168.1.44,7680,3,198,3,198,0,0,4976.350603,9.002438,175.9523364671,0
172.30.15.199,51634,184.29.26.80,80,16,2884,9,958,7,1926,4994.697643,60.369864,126.9507580802,255.2266806498
172.30.15.199,51635,87.250.251.119,443,17,5071,10,3309,7,1762,4998.476563,9.291099,2849.1785525049,1517.1509850449
172.30.15.199,51636,87.250.251.119,443,6,348,4,228,2,120,4998.61624,9.164141,199.0366582094,104.7561358997
172.30.15.199,51637,87.250.251.119,443,22,7946,13,5468,9,2478,4998.666478,9.097555,4808.3248741006,2179.047007685
172.30.15.199,51638,87.250.251.119,443,43,25228,27,21156,16,4072,5008.00076,9.866912,17153.0870043224,3301.5395292873
172.30.15.199,51639,18.211.245.141,443,23,6094,12,1939,11,4155,5013.287481,4.585245,3383.0253345246,7249.3400025528
172.30.15.199,51640,192.168.45.1,7680,3,198,3,198,0,0,5016.444649,9.040181,175.2177307069,0
172.30.15.199,51641,52.55.184.84,443,162,123082,71,17820,91,105262,5034.107179,13.736414,10378.2544701987,61303.9181841783
172.30.15.199,51642,52.55.184.84,443,127,100819,54,6221,73,94598,5034.107774,3.721025,13374.8093603247,203380.520152387
172.30.15.199,51643,52.55.184.84,443,6,348,4,228,2,120,5034.313846,3.5191,518.314341735,272.7970219658
172.30.15.199,51645,52.55.184.84,443,101,84907,37,4095,64,80812,5039.098544,8.747338,3745.1393784032,73907.7419896268
172.30.15.199,51646,52.55.184.84,443,108,91878,42,8513,66,83365,5039.10251,4.22711,16111.2438521799,157772.094882765
172.30.15.199,51647,52.55.184.84,443,97,84679,32,3813,65,80866,5039.289361,8.553513,3566.2540058103,75633.0176852496
172.30.15.199,51648,52.84.108.208,443,73,52087,32,4819,41,47268,5040.853543,6.830162,5644.3756385279,55363.8405648342
172.30.15.199,51649,52.84.108.208,443,56,34928,26,5008,30,29920,5040.854138,6.835757,5860.9456128993,35015.8731505485
172.30.15.199,51650,52.55.184.84,443,12,1416,6,904,6,512,5041.268992,6.575781,1099.7933173262,622.891790344
172.30.15.199,51651,52.4.148.116,443,83,13179,37,4268,46,8911,5041.8157,454.015977,75.2044018927,157.0165007651
172.30.15.199,51652,52.84.108.208,443,12,1931,7,1481,5,450,5042.113127,5.563012,2129.7814924719,647.1314460583
172.30.15.199,51653,52.84.108.208,443,35,18415,17,3496,18,14919,5042.115726,5.579815,5012.3525600759,21389.9564770515
172.30.15.199,51654,52.84.108.208,443,16,3038,9,2117,7,921,5042.116833,5.564602,3043.5240471823,1324.0839147166
172.30.15.199,51656,52.55.184.84,443,22,5398,11,2697,11,2701,5074.846023,3.04385,7088.3913464855,7098.9043481117
172.30.15.199,51657,52.55.184.84,443,6,348,4,228,2,120,5075.105063,2.775839,657.0986285588,345.841383452
172.30.15.199,51660,52.55.184.84,443,17,4594,9,2437,8,2157,5081.413743,6.640825,2935.779816514,2598.472328363
172.30.15.199,51661,52.55.184.84,443,12,1416,6,904,6,512,5081.447177,6.786722,1065.6101723336,603.5314250385
172.30.15.199,51662,52.55.184.84,443,6,348,4,228,2,120,5081.665017,6.568743,277.6786974312,146.1466828585
172.30.15.199,51663,52.84.108.208,443,1805,1641465,683,40919,1122,1600546,5082.37348,15.381585,21282.0720361392,832447.891423409
172.30.15.199,51664,52.229.170.171,443,34,11993,19,2643,15,9350,5109.95209,141.730591,149.1844481196,527.7618577065
172.30.15.199,51665,172.25.10.224,7680,3,198,3,198,0,0,5110.011677,9.000465,175.9909071365,0
172.30.15.199,51666,52.175.23.79,443,27,10025,14,2175,13,7850,5110.063498,158.902925,109.5008163003,395.2098427389
172.30.15.199,51667,172.25.10.224,7680,3,198,3,198,0,0,5110.772349,9.006354,175.8758316628,0
172.30.15.199,51668,162.125.82.3,443,6,348,4,228,2,120,5135.362979,0.320672,5688.0550843259,2993.7132022768
172.30.15.199,51669,162.125.248.4,443,6,348,4,228,2,120,5135.50899,0.260838,6992.8461343783,3680.4453338833
172.30.15.199,51671,34.232.42.95,443,27,10535,14,3481,13,7054,5220.713832,7.339191,3794.4236633166,7689.1308592459
172.30.15.199,51672,34.232.42.95,443,6,348,4,228,2,120,5220.844326,7.221475,252.579978467,132.9368307721
172.30.15.199,51673,52.229.168.53,443,31,10753,18,2416,13,8337,5223.570866,86.857663,222.5249832015,767.8769805262
172.30.15.199,51674,111.221.29.253,443,33,8907,17,3578,16,5329,5306.5625,2.909418,9838.393795597,14653.1024417933
172.30.15.199,51675,192.168.121.37,443,175,141320,75,7013,100,134307,5310.995057,6.967551,8052.1836151615,154208.559076215
172.30.15.199,51676,192.168.121.37,443,236,201536,95,8027,141,193509,5310.995992,6.905239,9299.6057051758,224188.040413962
172.30.15.199,51677,139.59.82.147,443,18,6891,10,1174,8,5717,5311.051504,6.716208,1398.4081493605,6809.7950510171
172.30.15.199,51678,139.59.82.147,443,18,6891,10,1174,8,5717,5311.052329,6.71511,1398.6368056517,6810.9085331438
172.30.15.199,51679,192.168.121.37,443,158,131901,63,4944,95,126957,5313.049536,4.934309,8015.7120277643,205835.508072183
172.30.15.199,51680,192.168.121.37,443,19,6208,10,2390,9,3818,5313.050123,4.850721,3941.6820715932,6296.7958783862
172.30.15.199,51681,192.168.121.37,443,11,1879,7,1483,4,396,5313.06116,4.944069,2399.6428852429,640.7677562752
172.30.15.199,51682,192.168.121.37,443,95,82309,34,3046,61,79263,5313.78717,4.092096,5954.8945088283,154958.241448869
172.30.15.199,51683,192.168.121.37,443,22,9290,11,1936,11,7354,5321.472252,6.298604,2458.9575721856,9340.4824307093
172.30.15.199,51684,192.168.121.37,443,13,1529,7,1013,6,516,5321.476785,6.374678,1271.2798983729,647.5621200004
172.30.15.199,51685,139.59.82.147,443,18,6891,10,1174,8,5717,5321.478199,6.292215,1492.6381250483,7268.6645322837
172.30.15.199,51686,139.59.82.147,443,18,6891,10,1174,8,5717,5321.479151,6.2903,1493.0925393064,7270.8773826361
172.30.15.199,51687,192.168.121.37,443,8,480,5,294,3,186,5321.724087,6.12786,383.8207791953,242.8253909195
172.30.15.199,51688,139.59.82.147,443,6,348,4,228,2,120,5321.730401,6.18302,295.0014717727,155.2639325119
172.30.15.199,51689,139.59.82.147,443,6,348,4,228,2,120,5321.73112,6.178323,295.2257432964,155.381970156
172.30.15.199,51690,52.114.88.20,443,20,7926,11,3232,9,4694,5321.899151,1.848427,13988.109890187,20315.6521734337
172.30.15.199,51691,14.139.45.128,80,49,39906,18,1404,31,38502,5332.440976,0.203458,55205.4969576152,1513904.58964537
172.30.15.199,51692,14.139.45.128,80,161,150328,55,3357,106,146971,5332.441989,0.879492,30535.8093080996,1336871.73959509
172.30.15.199,51693,14.139.45.128,80,132,128330,41,2593,91,125737,5332.70672,0.636346,32598.6177331082,1580737.5232965
172.30.15.199,51694,14.139.45.128,80,27,18566,10,924,17,17642,5332.709495,0.262441,28166.3307181581,537781.825248642
172.30.15.199,51695,14.139.45.128,80,16,7920,7,759,9,7161,5332.710812,0.261125,23253.2312111064,219389.181426526
172.30.15.199,51696,104.19.199.151,443,35,10920,17,1993,18,8927,5332.796697,5.588625,2852.9378872261,12778.8141090153
172.30.15.199,51697,14.139.45.128,80,17,8733,7,769,10,7964,5332.881449,0.438803,14019.9588425783,145194.996387898
172.30.15.199,51698,14.139.45.128,80,10,1612,5,656,5,956,5332.882196,0.438054,11980.258141685,17459.0347308702
172.30.15.199,51699,14.139.45.128,80,13,4400,6,689,7,3711,5332.900278,0.421893,13064.9240447307,70368.5531639994
172.30.15.199,51700,205.185.208.52,80,56,42642,21,1469,35,41173,5332.943266,11.558044,1016.7810401138,28498.2476273681
172.30.15.199,51701,14.139.45.128,80,21,13249,8,834,13,12415,5333.087619,0.339501,19652.3721579391,292547.002806732
172.30.15.199,51702,14.139.45.128,80,122,104430,48,3319,74,101111,5333.096742,0.662772,40062.0424519692,1220461.93864449
172.30.15.199,51703,205.185.208.52,80,6,348,4,228,2,120,5333.132335,4.890134,372.9959138135,196.3136388492
172.30.15.199,51704,14.139.45.128,80,10,1390,5,660,5,730,5334.507326,0.167796,31466.7810913766,34804.1669647045
172.30.15.199,51705,14.139.45.128,80,10,1382,5,656,5,726,5334.54515,0.144865,36226.8318779031,40092.4999136549
172.30.15.199,51706,14.139.45.128,80,10,1380,5,655,5,725,5334.545776,0.163785,31993.1617670025,35412.2782917203
172.30.15.199,51707,14.139.45.128,80,10,1406,5,668,5,738,5334.5473,0.187435,28511.2172219972,31498.9196254999
172.30.15.199,51708,14.139.45.128,80,10,1372,5,651,5,721,5334.548072,0.186661,27900.8469899022,30900.9380640852
172.30.15.199,51709,14.139.45.128,80,10,1390,5,660,5,730,5334.549053,0.186403,28325.7243712962,31329.9678652216
172.30.15.199,51710,14.139.45.128,80,10,1400,5,665,5,735,5334.622321,0.246267,21602.5695687624,23876.5242602111
172.30.15.199,51711,14.139.45.128,80,11,1442,6,713,5,729,5334.650224,0.460148,12396.0117179658,12674.183088916
172.30.15.199,51712,14.139.45.128,80,12,1930,6,1120,6,810,5334.669566,2.353098,3807.7462137141,2753.8164581325
172.30.15.199,51713,14.139.45.128,80,10,1384,5,657,5,727,5334.676948,0.32246,16299.6960863661,18036.3455932849
172.30.15.199,51714,14.139.45.128,80,11,1837,6,1094,5,743,5334.678148,0.940883,9301.9004488316,6317.4698660712
172.30.15.199,51715,14.139.45.128,80,11,1432,5,654,6,778,5334.681715,2.339891,2236.0015915266,2659.9529636204
172.30.15.199,51716,14.139.45.128,80,10,1379,5,647,5,732,5334.740175,1.483834,3488.2608162377,3946.5331027604
172.30.15.199,51717,14.139.45.128,80,10,1382,5,656,5,726,5334.750195,0.346557,15143.2520479706,16759.1478457723
172.30.15.199,51718,14.139.45.128,80,11,1450,5,663,6,787,5334.872006,2.291901,2314.2360861132,2747.0645547075
172.30.15.199,51719,14.139.45.128,80,49,39245,19,1408,30,37837,5335.038435,4.956047,2272.7790918853,61076.095525329
172.30.15.199,51720,14.139.45.128,80,10,1376,5,653,5,723,5335.567339,0.317486,16454.2688496544,18218.1261535989
172.30.15.199,51721,14.139.45.128,80,133,112911,53,3562,80,109349,5336.176061,1.489491,19131.3676954039,587309.3560148
172.30.15.199,51722,14.139.45.128,80,66,51525,28,2009,38,49516,5336.313252,1.086558,14791.6632154017,364571.426467811
172.30.15.199,51723,14.139.45.128,80,52,32712,26,2144,26,30568,5337.354064,2.251639,7617.5621402896,108607.107977785
172.30.15.199,51724,14.139.45.128,80,41,32811,16,1260,25,31551,5337.606326,2.848537,3538.6586166866,88609.6968373636
172.30.15.199,51725,14.139.45.128,80,39,25824,18,1472,21,24352,5339.496748,0.465485,25298.3447371755,418522.616195448
172.30.15.199,51726,14.139.45.128,80,33,25599,13,1079,20,24520,5339.901489,0.204117,42289.4712345886,961017.455673877
172.30.15.199,51727,14.139.45.128,80,55,44065,22,1621,33,42444,5340.085555,0.369304,35114.70225065,919437.644865263
172.30.15.199,51728,14.139.45.128,80,11,2707,5,640,6,2067,5340.416678,0.104229,49122.6050329187,158650.663442255
172.30.15.199,51729,14.139.45.128,80,46,40859,15,1174,31,39685,5340.43953,0.146068,64298.8197277919,2173508.2290438
172.30.15.199,51730,14.139.45.128,80,313,269322,127,7827,186,261495,5340.500338,2.94596,21254.8710776792,710111.474697549
172.30.15.199,51731,14.139.45.128,80,48,32307,23,1749,25,30558,5340.553381,2.891787,4838.5306386666,84537.3466302877
172.30.15.199,51732,14.139.45.128,80,16,7783,7,738,9,7045,5343.449915,0.037298,158292.669847436,1511072.97977667
172.30.15.199,51733,14.139.45.128,80,23,14691,9,849,14,13842,5343.451017,0.031962,212502.34653637,3464614.22939509
172.30.15.199,51734,14.139.45.128,80,35,27479,13,1064,22,26415,5343.481855,0.092863,91661.9105565571,2275610.30766114
172.30.15.199,51735,14.139.45.128,80,81,74919,27,1860,54,73059,5343.485318,0.126791,117358.487590105,4609727.8198094
172.30.15.199,51736,14.139.45.128,80,10,1813,5,676,5,1137,5343.578805,0.042252,127993.941114639,215279.750070037
172.30.15.199,51737,14.139.45.128,80,628,565093,241,14428,387,550665,5343.606958,10.405412,11092.6890737243,423368.147267977
172.30.15.199,51738,14.139.45.128,80,163,144739,62,4175,101,140564,5343.615855,0.938717,35580.4784615599,1197924.40107083
172.30.15.199,51739,14.139.45.128,80,238,209519,93,5873,145,203646,5344.425821,11.452524,4102.5017716618,142254.056834979
172.30.15.199,51740,14.139.45.128,80,167,139098,70,4571,97,134527,5344.430015,2.2725,16091.529152915,473582.398239816
172.30.15.199,51741,14.139.45.128,80,218,176787,96,6267,122,170520,5344.430826,7.243838,6921.1928814529,188320.059062605
172.30.15.199,51742,14.139.45.128,80,313,280056,120,7555,193,272501,5344.431745,6.609201,9144.8270373375,329844.409331768
172.30.15.199,51743,14.139.45.128,80,309,261787,129,8065,180,253722,5344.465197,6.556426,9840.7272498779,309585.74076795
172.30.15.199,51744,104.19.199.151,443,133,91772,63,4961,70,86811,5344.776663,3.075111,12906.2007842964,225841.60376649
172.30.15.199,51745,172.217.166.234,443,73,39412,38,3970,35,35442,5345.571731,2.60499,12191.9853819025,108843.412066849
172.30.15.199,51746,172.217.166.195,443,118,78798,50,4546,68,74252,5345.67473,12.177371,2986.5231173459,48780.315554151
172.30.15.199,51747,14.139.45.128,80,29,20305,11,1035,18,19270,5346.672887,0.454288,18226.3233895716,339344.204557532
172.30.15.199,51748,14.139.45.128,80,10,1379,5,647,5,732,5347.018652,0.393613,13149.9721807906,14877.5573977415
172.30.15.199,51749,14.139.45.128,80,257,221694,104,6531,153,215163,5347.245003,4.841387,10791.9486709069,355539.435289899
172.30.15.199,51750,172.217.161.10,443,44,20803,22,2725,22,18078,5348.29987,9.55068,2282.5599852575,15142.7961150406
172.30.15.199,51751,14.139.45.128,80,170,154244,62,4012,108,150232,5350.986836,1.02153,31419.5373606262,1176525.4079665
172.30.15.199,51752,14.139.45.128,80,486,444388,180,10803,306,433585,5351.022668,4.196041,20596.5575646179,826655.411612965
172.30.15.199,51753,14.139.45.128,80,638,597831,227,13375,411,584456,5351.628968,3.820352,28007.8903724075,1223878.84676604
172.30.15.199,51754,14.139.45.128,80,10,1424,5,694,5,730,5351.997531,0.070167,79125.5148433225,83230.0084086822
172.30.15.199,51755,14.139.45.128,80,10,1422,5,693,5,729,5352.049857,0.087655,63247.9607550402,66533.5691059514
172.30.15.199,51756,14.139.45.128,80,10,1399,5,675,5,724,5355.91887,0.099894,54057.3007388105,57981.4603479983
172.30.15.199,51757,14.139.45.128,443,3,198,3,198,0,0,5364.710779,9.001667,175.9674069258,0
172.30.15.199,51758,14.139.45.128,443,3,198,3,198,0,0,5364.716237,9.000174,175.9965973991,0
172.30.15.199,51759,14.139.45.128,443,3,198,3,198,0,0,5364.963118,9.002884,175.9436198445,0
172.30.15.199,51760,14.139.45.128,443,3,198,3,198,0,0,5386.613056,9.000834,175.9836921779,0
172.30.15.199,51761,14.139.45.128,443,3,198,3,198,0,0,5386.613654,9.001226,175.9760281544,0
172.30.15.199,51762,14.139.45.128,443,3,198,3,198,0,0,5386.864107,9.001707,175.9666249968,0
172.30.15.199,51763,52.55.184.84,443,20,9658,10,2562,10,7096,5402.765333,5.291521,3873.3664668438,10728.1063422027
172.30.15.199,51764,52.55.184.84,443,6,348,4,228,2,120,5402.843151,5.213967,349.8296019135,184.1208431124
172.30.15.199,51765,14.139.45.128,443,3,198,3,198,0,0,5407.722548,9.022538,175.5603578505,0
172.30.15.199,51766,14.139.45.128,443,3,198,3,198,0,0,5407.723202,9.021716,175.5763537668,0
172.30.15.199,51767,14.139.45.128,443,3,198,3,198,0,0,5412.894115,9.002078,175.9593729359,0
172.30.15.199,51768,14.139.45.128,80,50,39964,19,1462,31,38502,5418.293309,0.447923,26111.6307936489,687653.904799637
172.30.15.199,51769,14.139.45.128,80,158,150174,52,3203,106,146971,5418.299633,1.883811,13602.2138101921,624143.292506319
172.30.15.199,51770,14.139.45.128,80,137,128608,46,2871,91,125737,5418.721203,1.473848,15583.6965548725,682496.431111112
172.30.15.199,51771,14.139.45.128,80,28,18628,10,932,18,17696,5418.724273,1.274805,5848.7376500719,111050.709716387
172.30.15.199,51772,14.139.45.128,80,17,8741,7,777,10,7964,5418.725054,0.327193,18997.9614478259,194722.992240007
172.30.15.199,51773,14.139.45.128,80,16,7928,7,767,9,7161,5418.726647,0.326581,18788.6006840943,175417.430898043
172.30.15.199,51774,14.139.45.128,80,10,1620,5,664,5,956,5418.727384,0.325843,16302.3296495285,23471.4264231164
172.30.15.199,51775,14.139.45.128,80,24,7340,10,1298,14,6042,5418.869669,1.275679,8139.9787877652,37890.4097347282
172.30.15.199,51776,14.139.45.128,80,119,106178,42,3501,77,102677,5418.964423,1.428707,19603.739605111,574936.638512993
172.30.15.199,51777,14.139.45.128,80,44,22542,16,1744,28,20798,5418.965522,1.216812,11466.0276197176,136737.63901083
172.30.15.199,51778,14.139.45.128,80,95,76079,41,3020,54,73059,5420.359781,0.686149,35211.0110194666,851814.984791792
172.30.15.199,51779,14.139.45.128,80,12,2294,7,1548,5,746,5420.417922,2.070328,5981.6608769218,2882.6350220825
172.30.15.199,51780,14.139.45.128,80,10,1394,5,664,5,730,5420.423135,0.212944,24945.5255842053,27425.0507175751
172.30.15.199,51781,14.139.45.128,80,10,1392,5,663,5,729,5420.423932,0.212793,24925.6319521084,27406.9165808251
172.30.15.199,51782,14.139.45.128,80,11,1438,6,713,5,725,5420.426238,0.514588,11084.5958320053,11271.1528446057
172.30.15.199,51783,14.139.45.128,80,11,1484,6,730,5,754,5420.427,2.088703,2795.993494527,2887.9165683197
172.30.15.199,51784,14.139.45.128,80,10,1402,5,668,5,734,5420.574061,0.225039,23746.9949653251,26093.2549469291
172.30.15.199,51785,14.139.45.128,80,10,1412,5,673,5,739,5420.575302,0.227151,23702.2949491697,26026.7399218966
172.30.15.199,51786,14.139.45.128,80,138,113209,58,3860,80,109349,5420.580547,2.559184,12066.3461478316,341824.581585295
172.30.15.199,51787,14.139.45.128,80,10,1391,5,655,5,736,5420.58188,1.170142,4478.0889840723,5031.8679271407
172.30.15.199,51788,14.139.45.128,80,9,1346,5,667,4,679,5420.752946,0.158701,33622.9765407287,34227.8876629007
172.30.15.199,51789,14.139.45.128,80,10,1430,5,682,5,748,5420.754682,0.157728,34591.1949685241,37938.7299654781
172.30.15.199,51790,14.139.45.128,80,10,1396,5,665,5,731,5420.866791,0.153138,34739.9077956576,38187.778343798
172.30.15.199,51791,14.139.45.128,80,10,1404,5,669,5,735,5420.868192,0.155123,34501.6535264545,37905.4040985711
172.30.15.199,51792,14.139.45.128,80,10,1390,5,662,5,728,5420.972649,0.100019,52949.9395117469,58228.936502344
172.30.15.199,51793,14.139.45.128,80,10,1394,5,664,5,730,5420.973914,0.152782,34768.4936706941,38224.3981620582
172.30.15.199,51794,14.139.45.128,80,10,1408,5,671,5,737,5421.032498,0.23406,22934.2903528342,25190.1221908179
172.30.15.199,51795,14.139.45.128,80,10,1388,5,661,5,727,5421.048555,0.218269,24226.9859668614,26646.0193614346
172.30.15.199,51796,14.139.45.128,80,47,39133,17,1296,30,37837,5421.734505,0.317624,32642.3695943049,953001.032669533
172.30.15.199,51797,14.139.45.128,80,64,51425,26,1909,38,49516,5422.002728,1.900095,8037.4928621992,208477.997152778
172.30.15.199,51798,14.139.45.128,80,45,31338,21,1654,24,29684,5422.524891,1.74617,7577.7272545041,135995.922504655
172.30.15.199,51799,14.139.45.128,80,47,33667,22,2104,25,31563,5422.535142,1.735916,9696.3217114162,145458.651225014
172.30.15.199,51800,14.139.45.128,80,39,25880,19,1582,20,24298,5422.544802,0.378584,33429.833273457,513450.119392199
172.30.15.199,51801,14.139.45.128,80,40,26490,20,1958,20,24532,5422.545621,1.662943,9419.4449238525,118017.27419405
172.30.15.199,51802,14.139.45.128,80,30,20371,12,1101,18,19270,5422.874925,0.225238,39105.3019472752,684431.579040866
172.30.15.199,51803,14.139.45.128,80,54,44340,20,1830,34,42510,5423.027379,0.99336,14737.8593863329,342353.225416945
172.30.15.199,51804,14.139.45.128,80,13,3201,6,1068,7,2133,5423.045472,0.826501,10337.5555504412,20646.0730234936
172.30.15.199,51805,14.139.45.128,80,10,1821,5,684,5,1137,5423.706444,0.502118,10897.8367634824,18115.2637428062
172.30.15.199,51806,14.139.45.128,80,149,143575,48,3011,101,140564,5423.735478,2.963174,8129.1210033553,379495.770413696
172.30.15.199,51807,14.139.45.128,80,10,1391,5,655,5,736,5423.912008,0.370453,14144.8442852574,15894.0540365641
172.30.15.199,51808,14.139.45.128,80,57,43225,25,2094,32,41131,5423.991626,8.452094,1981.9940478655,38930.9442133502
172.30.15.199,51809,14.139.45.128,80,298,269728,111,6799,187,262929,5424.010852,10.672645,5096.3936306325,197086.289293804
172.30.15.199,51810,14.139.45.128,80,41,31805,16,1247,25,30558,5424.24044,0.614419,16236.4770620581,397878.320819864
172.30.15.199,51811,14.139.45.128,80,16,7791,7,746,9,7045,5424.241997,0.268736,22207.6684924991,209722.552988815
172.30.15.199,51812,14.139.45.128,80,24,14753,10,911,14,13842,5424.243168,0.280495,25982.637836684,394787.785878573
172.30.15.199,51813,14.139.45.128,80,36,27541,14,1126,22,26415,5424.375749,0.724797,12428.3075123129,291557.498168512
172.30.15.199,51814,14.139.45.128,80,592,558369,208,12006,384,546363,5424.384547,9.910282,9691.7524647627,441047.388964277
172.30.15.199,51815,14.139.45.128,80,235,209141,90,5495,145,203646,5424.714544,7.636911,5756.2540665987,213328.137515297
172.30.15.199,51816,14.139.45.128,80,176,172475,55,3389,121,169086,5424.978268,5.569573,4867.8776631532,242871.042358195
172.30.15.199,51817,14.139.45.128,80,147,136266,51,3173,96,133093,5425.940777,1.972316,12870.1485968759,539844.527955879
172.30.15.199,51818,14.139.45.128,80,293,278440,100,5939,193,272501,5427.480994,7.549724,6293.2101888754,288753.337208072
172.30.15.199,51819,14.139.45.128,80,269,256211,90,5291,179,250920,5429.359967,4.883301,8667.9072209559,411066.202963951
172.30.15.199,51820,14.139.45.128,80,162,153568,54,3336,108,150232,5432.328986,2.017228,13230.0364658848,595795.814850962
172.30.15.199,51821,14.139.45.128,80,224,218036,72,4307,152,213729,5432.335212,2.420612,14234.4167508058,706363.514681443
172.30.15.199,51822,14.139.45.128,80,478,444036,172,10451,306,433585,5434.180063,2.956613,28278.303585891,1173193.78626816
172.30.15.199,51823,14.139.45.128,80,647,598337,236,13881,411,584456,5434.287429,4.470072,24842.5528716312,1045989.41583042
172.30.15.199,51824,14.139.45.128,80,10,1436,5,702,5,734,5434.520008,0.564545,9947.8340964976,10401.2966194149
172.30.15.199,51825,14.139.45.128,80,10,1434,5,701,5,733,5434.713359,0.383131,14637.2911615242,15305.4699306666
172.30.15.199,51826,14.139.45.128,80,10,1411,5,683,5,728,5438.879299,0.06939,78743.3347748519,83931.4022197543
172.30.15.199,51827,14.139.45.128,80,38,29953,14,1237,24,28716,5475.068982,0.619232,15981.0862487724,370988.579401575
172.30.15.199,51828,14.139.45.128,80,10,1401,5,665,5,736,5475.083348,0.712717,7464.3933005632,8261.3435627286
172.30.15.199,51829,104.19.199.151,443,12,2073,7,1007,5,1066,5475.086094,2.706342,2976.7117385761,3151.1168950567
172.30.15.199,51830,205.185.208.52,80,6,348,4,228,2,120,5475.187457,2.814484,648.076166004,341.0927189495
172.30.15.199,51831,14.139.45.128,80,10,1412,5,678,5,734,5475.718447,0.181214,29931.4622490236,32403.6774200344
172.30.15.199,51832,14.139.45.128,80,10,1402,5,673,5,729,5475.719346,0.201927,26663.1010216473,28881.7245836268
172.30.15.199,51833,14.139.45.128,80,10,1404,5,674,5,730,5475.720178,0.182957,29471.4058494639,31920.0686500128
172.30.15.199,51834,14.139.45.128,80,10,1394,5,669,5,725,5475.722134,0.184528,29003.7284313503,31431.5442641689
172.30.15.199,51835,14.139.45.128,80,10,1428,5,686,5,742,5475.723042,0.198234,27684.4537263467,29944.4091325791
172.30.15.199,51836,14.139.45.128,80,10,1412,5,678,5,734,5475.731014,0.185826,29188.5957831667,31599.4532519828
172.30.15.199,51837,14.139.45.128,80,10,1422,5,683,5,739,5475.8508,0.146654,37257.7631704236,40312.5724494042
172.30.15.199,51838,14.139.45.128,80,10,1410,5,677,5,733,5475.852881,0.145868,37129.459511207,40200.7294264619
172.30.15.199,51839,14.139.45.128,80,10,1440,5,692,5,748,5475.857309,0.145924,37937.556536181,41007.6478165656
172.30.15.199,51840,14.139.45.128,80,10,1406,5,675,5,731,5475.870778,0.153999,35065.1627609786,37974.2725604079
172.30.15.199,51841,14.139.45.128,80,10,1414,5,679,5,735,5475.873827,0.153781,35322.9592732566,38236.193027752
172.30.15.199,51842,14.139.45.128,80,10,1400,5,672,5,728,5475.875743,0.149037,36071.5795406183,39077.5445023365
172.30.15.199,51843,14.139.45.128,80,10,1418,5,681,5,737,5475.952565,0.148747,36625.9487585849,39637.7742071616
172.30.15.199,51844,14.139.45.128,80,10,1398,5,671,5,727,5475.954372,0.148841,36065.331461047,39075.2548020583
172.30.15.199,51845,14.139.45.128,80,10,1404,5,674,5,730,5475.958367,0.147718,36501.9835090772,39534.7892605732
172.30.15.199,51846,14.139.45.128,80,10,1434,5,701,5,733,5476.219678,0.044374,126380.312795606,132149.456888986
172.30.15.199,51847,14.139.45.128,80,10,1401,5,665,5,736,5476.326483,0.080881,65775.6457018214,72798.3086263767
172.30.15.199,51848,54.251.147.241,80,6,348,4,228,2,120,5483.469852,4.687651,389.1074655515,204.7934029218
172.30.15.199,51849,54.251.147.241,80,10,2015,6,765,4,1250,5483.489255,4.668152,1311.0112952622,2142.1753190559
172.30.15.199,51850,52.221.28.239,443,167,130672,73,6181,94,124491,5483.897002,4.260578,11605.9370348333,233754.199547554
172.30.15.199,51851,151.139.104.1,443,6,348,4,228,2,120,5487.595511,10.393579,175.4929654164,92.3647186402
172.30.15.199,51852,151.139.104.1,443,30,14885,13,1802,17,13083,5487.728489,10.263729,1404.5577391998,10197.4633196178
172.30.15.199,51853,23.61.93.124,443,13,5033,7,1033,6,4000,5488.072866,0.25869,31945.5719201007,123700.181684804
172.30.15.199,51854,23.61.93.124,443,13,5033,7,1033,6,4000,5488.073311,0.246302,33552.3057060632,129921.803314862
172.30.15.199,51855,23.61.93.124,443,761,701919,274,17441,487,684478,5488.073693,9.805943,14228.9221954491,558418.909838691
172.30.15.199,51856,23.61.93.124,443,13,5033,7,1033,6,4000,5488.095251,0.236598,34928.4440273611,135250.509302463
172.30.15.199,51857,104.19.199.151,443,7,402,4,228,3,174,5489.040234,8.844466,206.2306531565,157.3865510931
172.30.15.199,51858,104.19.199.151,443,30,11732,13,1805,17,9927,5489.291763,8.594356,1680.172429441,9240.4829401998
172.30.15.199,51859,23.61.93.124,443,118,97473,43,3730,75,93743,5490.921985,6.958553,4288.2478584267,107772.980963134
172.30.15.199,51860,46.105.202.39,443,51,25773,27,2673,24,23100,5491.440147,6.565571,3256.9901384053,28146.8283565889
172.30.15.199,51861,52.221.28.239,443,15,3533,8,1697,7,1836,5492.158149,5.788484,2345.3463808487,2537.4519476949
172.30.15.199,51862,52.221.28.239,443,63,49350,25,2908,38,46442,5492.264564,2.786102,8350.0173360486,133353.337386785
172.30.15.199,51863,188.125.66.33,443,29,8115,15,1997,14,6118,5492.594423,5.435915,2938.9716358699,9003.8199640723
172.30.15.199,51864,54.254.246.72,443,31,10063,15,2571,16,7492,5493.849084,4.091807,5026.6300438904,14647.8071912979
172.30.15.199,51865,149.202.77.192,443,19,7793,10,1207,9,6586,5494.477948,3.521929,2741.679346744,14959.9835771798
172.30.15.199,51866,192.168.121.37,443,77,61291,30,5123,47,56168,5499.875393,3.505028,11692.9165758461,128199.831784526
172.30.15.199,51867,192.168.121.37,443,8,1165,4,800,4,365,5499.878114,0.390638,16383.4547586318,7474.9512336258
172.30.15.199,51868,139.59.61.230,443,15,6717,7,1000,8,5717,5499.971617,0.404104,19796.8839704538,113178.785659084
172.30.15.199,51869,139.59.61.230,443,15,6717,7,1000,8,5717,5499.980861,0.424621,18840.3305535944,107710.169774899
172.30.15.199,51870,192.168.121.146,80,138,123631,50,4101,88,119530,5500.380787,3.348301,9798.4022344467,285589.616943041
172.30.15.199,51871,192.168.121.146,80,236,206012,93,7084,143,198928,5500.381574,3.223589,17580.4049461631,493680.801119471
172.30.15.199,51872,192.168.121.146,80,140,132215,48,3035,92,129180,5501.840265,2.690382,9024.7407245522,384123.890213393
172.30.15.199,51873,192.168.121.146,80,385,344870,149,9877,236,334993,5501.856057,2.195857,35984.128292512,1220454.70174076
172.30.15.199,51874,192.168.121.146,80,225,202359,85,5817,140,196542,5501.85696,1.838163,25316.5796504397,855384.424558486
172.30.15.199,51875,192.168.121.146,80,5,717,3,597,2,120,5501.85766,1.523779,3134.3127842028,630.0126199403
