10.0.2.2,53473,10.0.2.15,5555,9,706,5,362,4,344,0,36789.0159,0.078719148342318,0.074804936546291
10.0.2.15,42409,115.182.31.2,80,10,1663,5,658,5,1005,15.734649,0.825825,6374.23182877728,9735.71882662792
10.0.2.15,55322,115.182.31.2,80,10,1992,5,554,5,1438,17.253281,0.614013,7218.08821637327,18735.7596663263
10.0.2.15,35042,219.234.85.240,80,11,1857,6,795,5,1062,17.853297,1.741375,3652.28626803532,4878.9031656019
10.0.2.15,44296,219.234.85.240,80,11,1631,6,796,5,835,17.884465,3.888854,1637.50040500363,1717.72969620356
10.0.2.15,56461,219.234.85.222,80,11,1631,6,796,5,835,17.886664,3.886574,1638.46101991111,1718.73737641429
10.0.2.15,52614,219.234.85.243,80,11,1344,6,792,5,552,17.888686,2.14441,2954.6588572148,2059.30768836183
10.0.2.15,48881,219.234.85.238,80,11,1344,6,792,5,552,17.889524,3.878653,1633.55680438544,1138.53959093531
10.0.2.15,38387,118.26.228.168,80,15,2019,8,1011,7,1008,18.789748,166.475978,48.5835860354579,48.4394210917325
10.0.2.15,37932,124.95.142.227,80,17,6479,9,730,8,5749,19.465569,33.751141,173.031187301194,1362.67985725283
10.0.2.15,33412,219.234.85.243,80,11,1340,6,788,5,552,19.815445,1.93769,3253.35838033948,2279.00231719212
10.0.2.15,45247,219.234.85.236,80,10,1023,5,593,5,430,21.450934,0.86157,5506.22700419002,3992.71098111587
10.0.2.15,49374,219.234.85.243,80,7,428,4,236,3,192,22.850811,0.743576000000001,2539.08141198747,2065.6933521254
10.0.2.15,36873,219.234.85.243,80,8,1325,4,1069,4,256,22.895649,0.619351000000002,13808.0022475139,3306.68716123813
10.0.2.15,39026,219.234.85.243,80,2,138,1,74,1,64,23.51789,0.326815999999997,1811.41682169785,1566.63076471166
10.0.2.15,49068,219.234.85.216,80,8,1325,4,1069,4,256,23.847623,0.665912000000002,12842.5377527361,3075.48144499572
10.0.2.15,47662,115.182.31.2,80,10,1992,5,554,5,1438,51.607546,0.730012000000002,6071.13307726447,15758.6450633688
10.0.2.15,53070,219.234.85.243,80,11,1631,6,796,5,835,51.670526,1.825759,3487.86449909326,3658.75233259155
10.0.2.15,45657,219.234.85.243,80,11,1344,6,792,5,552,51.675487,1.820714,3479.95346880399,2425.42211462096
10.0.2.15,56374,124.95.142.227,80,19,6587,10,784,9,5803,52.349606,98.408693,63.7342068957262,471.746942112116
10.0.2.15,36862,115.182.31.2,80,8,719,4,463,4,256,53.586832,0.579800999999996,6388.39877820153,3532.24640868162
10.0.2.15,56254,115.182.31.2,80,8,719,4,463,4,256,54.168283,0.594310999999998,6232.42712990339,3446.00722517337
10.0.2.15,41079,115.182.31.2,80,9,773,5,517,4,256,54.764442,62.451775,66.2271008310012,32.7933033128362
10.0.2.15,51378,124.95.142.227,80,44,25147,20,1549,24,23598,59.020414,1.019177,12158.8301148868,185231.80958754
10.0.2.15,40194,219.234.85.243,80,2,138,1,74,1,64,61.04635,0.295051000000001,2006.43278619628,1735.29322049408
10.0.2.15,35061,219.234.85.243,80,8,944,4,688,4,256,61.048489,58.057214,94.8030334352592,35.2755473247476
10.0.2.15,39173,219.234.85.216,80,8,940,4,684,4,256,61.343034,64.308922,85.0892820128442,31.8462809872633
10.0.2.15,52714,124.95.142.228,80,6451,7282386,1695,91824,4756,7190562,62.178113,33.130577,22172.6292300916,1736296.23172576
10.0.2.15,54542,115.182.31.2,80,8,756,4,500,4,256,83.059936,62.161823,64.3481771762067,32.9462667142178
10.0.2.15,57989,219.234.85.243,80,7,428,4,236,3,192,89.555332,0.405202999999986,4659.39294625179,3790.69256644214
10.0.2.15,40725,219.234.85.243,80,8,1325,4,1069,4,256,89.612825,0.309895999999995,27596.3549061625,6608.66871466568
10.0.2.15,40529,219.234.85.243,80,2,138,1,74,1,64,89.924314,0.361669000000006,1636.85579908698,1415.65906948063
10.0.2.15,40190,219.234.85.216,80,9,1379,5,1123,4,256,90.288267,62.142903,144.570008259833,32.9562975196057
10.0.2.15,39365,219.234.85.243,80,11,1631,6,796,5,835,119.108637,31.998601,199.008700411621,208.75912668807
10.0.2.15,42470,219.234.85.243,80,11,1344,6,792,5,552,125.655108,25.45198,248.939375247034,173.503200929751
10.0.2.15,53313,115.182.31.2,80,10,1992,5,554,5,1438,145.224627,0.722476,6134.45982980749,15923.0202802584
10.0.2.15,36013,124.95.142.227,80,17,6479,9,730,8,5749,145.96048,33.937281,172.082141760266,1355.20579860243
10.0.2.15,44723,219.234.85.243,80,9,1379,5,1123,4,256,176.599903,0.602681999999987,14906.7003826233,3398.14363130149
10.0.2.15,36546,219.234.85.243,80,11,1631,6,796,5,835,176.624111,3.545378,1796.1413423336,1884.14324227205
10.0.2.15,49036,219.234.85.243,80,8,940,4,684,4,256,176.632917,0.591815999999994,9246.11703637626,3460.53503115837
10.0.2.15,58415,115.182.31.2,80,10,1992,5,554,5,1438,176.921952,0.662958000000003,6685.18971035869,17352.532136274
10.0.2.15,45149,219.234.85.243,80,8,940,4,684,4,256,177.226358,64.318694,85.0763543177665,31.8414425516787
10.0.2.15,51152,124.95.142.227,80,15,6361,8,676,7,5685,177.596903,6.100382,886.501861686695,7455.27083385926
10.0.2.15,52310,124.95.142.227,80,28,15473,15,1279,13,14194,178.514478,0.738427999999999,13856.4626476786,153775.317295661
10.0.2.15,38496,115.182.31.2,80,9,773,5,517,4,256,178.761432,0.683101999999991,6054.73267535457,2998.088133251
10.0.2.15,40646,115.182.31.2,80,8,719,4,463,4,256,179.446118,0.567708999999979,6524.46940245819,3607.4820022231
10.0.2.15,42670,115.182.31.2,80,9,773,5,517,4,256,180.01534,55.85667,74.0466626456608,36.6652720257044
10.0.2.15,36251,219.234.85.243,80,9,994,5,738,4,256,180.203043,1.80144199999998,3277.37445890573,1136.86702097543
10.0.2.15,43170,219.234.85.243,80,11,1631,6,796,5,835,180.218635,2.69794199999998,2360.3176050486,2475.9613068035
10.0.2.15,50723,219.234.85.243,80,8,940,4,684,4,256,182.006744,0.595230000000015,9193.08502595612,3440.6867933403
10.0.2.15,37309,124.95.142.228,80,6724,7297128,1960,106134,4764,7190994,182.239614,46.357489,18315.7461354302,1240963.50430024
10.0.2.15,36585,219.234.85.243,80,8,943,4,687,4,256,182.564958,64.222145,85.5779575721116,31.889311700816
10.0.2.15,49211,219.234.85.243,80,11,1671,6,803,5,868,182.572999,1.03883099999999,6183.87398912824,6684.43664080113
10.0.2.15,43567,219.234.85.243,80,9,994,5,738,4,256,182.603821,0.656041999999985,8999.42381737775,3121.75135128551
10.0.2.15,52418,219.234.85.243,80,8,940,4,684,4,256,183.262998,64.291879,85.111838152996,31.8547230514137
10.0.2.15,58940,118.26.228.168,80,13,1775,7,906,6,869,185.315453,76.034214,95.3255070145132,91.4325227324636
10.0.2.15,41830,219.234.85.243,80,8,944,4,688,4,256,185.532714,0.62306000000001,8833.82017783186,3287.00285686767
10.0.2.15,42132,115.182.31.2,80,8,860,4,604,4,256,185.757271,57.782135,83.6244628205586,35.4434809305679
10.0.2.15,50853,219.234.85.243,80,11,1344,6,792,5,552,185.771341,5.24159799999998,1208.79167002125,842.491163954202
10.0.2.15,40929,219.234.85.243,80,8,944,4,688,4,256,186.159177,0.601563999999996,9149.48367920958,3404.45904342682
10.0.2.15,33311,219.234.85.243,80,8,944,4,688,4,256,186.424277,64.300733,85.5977800439693,31.8503367605467
10.0.2.15,40570,219.234.85.243,80,11,1631,6,796,5,835,186.789882,4.29405,1482.98226615899,1555.64094502859
10.0.2.15,51703,219.234.85.243,80,2,138,1,74,1,64,187.673817,2.17522,272.156379584594,235.378490451541
10.0.2.15,43536,219.234.85.216,80,11,1344,6,792,5,552,189.927564,57.625987,109.950394428819,76.6320930867527
10.0.2.15,60203,219.234.85.243,80,7,428,4,236,3,192,190.276769,0.65713199999999,2873.09094672003,2337.42992275528
10.0.2.15,47777,219.234.85.243,80,9,1379,5,1123,4,256,190.333112,82.971185,108.278554777782,24.6832680526378
10.0.2.15,52657,219.234.85.243,80,8,940,4,684,4,256,241.548195,0.646975999999995,8457.809872391,3165.49609259078
10.0.2.15,42079,219.234.85.243,80,8,940,4,684,4,256,242.198296,62.169671,88.0171941073968,32.9421077361017
10.0.2.15,39856,115.182.31.2,80,10,1663,5,658,5,1005,243.542,0.86864700000001,6059.99905600312,9255.7736341689
10.0.2.15,55445,219.234.85.243,80,8,943,4,687,4,256,246.790003,0.620024999999998,8864.15870327812,3303.09261723318
10.0.2.15,40049,219.234.85.243,80,8,943,4,687,4,256,247.412897,83.070008,66.1610626063741,24.6539039697697
10.0.2.15,44925,219.234.85.243,80,8,1325,4,1069,4,256,250.656604,0.583007000000009,14668.7775618472,3512.82231602702
10.0.2.15,55303,219.234.85.243,80,8,944,4,688,4,256,250.727829,0.644351999999998,8541.91497814862,3178.38696861344
10.0.2.15,57581,219.234.85.243,80,8,944,4,688,4,256,251.40131,77.348537,71.1584241082672,26.4775531565646
10.0.2.15,35718,219.234.85.243,80,11,1631,6,796,5,835,328.752892,36455.582598,0.174678322116552,0.18323668211975
10.0.2.15,56358,219.234.85.243,80,11,1857,6,795,5,1062,330.486157,36453.848521,0.174467175841151,0.233061812255727
10.0.2.15,39500,219.234.85.243,80,11,1340,6,788,5,552,331.229996,36453.102866,0.172934524206985,0.12114195096733
10.0.2.15,49851,115.182.31.2,80,8,756,4,500,4,256,36784.888989,0.666730000004463,5999.43005410469,3071.7081877016
10.0.2.15,45094,219.234.85.216,80,11,1631,6,796,5,835,36785.373437,2.62870299999486,2422.48743962801,2541.17715086606
10.0.2.15,51679,219.234.85.220,80,7,428,4,236,3,192,36785.376921,0.772622999997111,2443.62386313514,1988.03297339808
10.0.2.15,40002,219.234.85.243,80,6,832,4,704,2,128,36785.401043,3.33943200000067,1686.51435333879,306.638973334326
10.0.2.15,40539,219.234.85.216,80,11,1857,6,795,5,1062,36785.409294,1.8986670000013,3349.7185130387,4474.71831553095
10.0.2.15,59650,115.182.31.2,80,5,574,3,446,2,128,36785.558357,0.527367999995477,6765.67406446846,1941.71811715687
10.0.2.15,49142,219.234.85.216,80,11,1857,6,795,5,1062,36786.265325,1.66076199999952,3829.56739135519,5115.72398694241
10.0.2.15,54945,219.234.85.216,80,11,1857,6,795,5,1062,36786.358961,1.64303500000096,3870.88528241715,5170.91845273839
10.0.2.15,50865,219.234.85.216,80,7,1435,4,695,3,740,36786.928577,0.908039000001736,6123.08502166688,6519.54376407696
10.0.2.15,58426,219.234.85.216,80,7,1104,4,680,3,424,36786.97186,0.954689000005601,5698.19071966691,3552.98950755702
